700-річчя Перегінська вулиця	вулиця 700-річчя Перегінська
1 Грудня вулиця	вулиця 1 Грудня
1 Листопада вулиця	вулиця 1 Листопада
1 Травня вулиця	вулиця 1 Травня
1 Травня провулок	провулок 1 Травня
вулиця Полицька	Полицька вулиця
1-го Листопада вулиця	вулиця 1 Листопада
1-го Травня вулиця	вулиця 1 Травня
100 років Нафтовиків вулиця	вулиця 100 років Нафтовиків
100-річчя Червоного Хреста вулиця	вулиця 100-річчя Червоного Хреста
16 Липня вулиця	вулиця 16 Липня
16-го Липня вулиця	вулиця 16 Липня
17-вересня вулиця	вулиця 17 Вересня
17-го Вересня вулиця	вулиця 17 Вересня
2-й Олени Степанівни провулок	2-й провулок Олени Степанівни
200-річчя Яремча вулиця	вулиця 200-річчя Яремчі
200-річчя Яремче вулиця	вулиця 200-річчя Яремчі
200-річчя Яремчі вулиця	вулиця 200-річчя Яремчі
2000-ліття Різдва Христового вулиця	вулиця 2000-ліття Різдва Христового
2000-річчя Різдва Христового вулиця	вулиця 2000-річчя Різдва Христового
22 Січня вулиця	вулиця 22 Січня
22-го Січня вулиця	вулиця 22 Січня
24 Серпня вулиця	вулиця 24 Серпня
24-го Серпня вулиця	вулиця 24 Серпня
3-й Олени Степанівни провулок	3-й провулок Олени Степанівни
30-річчя Перемоги вулиця	вулиця 30-річчя Перемоги
4-й Олени Степанівни провулок	4-й провулок Олени Степанівни
40-річчя Перемоги вулиця	вулиця 40-річчя Перемоги
400-річчя Надвірної вулиця	вулиця 400-річчя Надвірної
5-ї Річниці Незалежності вулиця	вулиця 5-ї Річниці Незалежності
5-й Олени Степанівни провулок	5-й провулок Олени Степанівни
50-річчя УПА вулиця	вулиця 50-річчя УПА
550-річчя Богородчан вулиця	вулиця 550-річчя Богородчан
600-річчя Голиня вулиця	вулиця 600-річчя Голиня
8 Березня вулиця	вулиця 8 Березня
8 Лютого вулиця	вулиця 8 Лютого
8-го Березня вулиця	вулиця 8 Березня
9 Травня вулиця	вулиця 9 Травня
9-го Травня вулиця	вулиця 9 Травня
Августина Волошина вулиця	вулиця Августина Волошина
Августо Донніні вулиця	вулиця Августо Донніні
Агафії Степаняк вулиця	вулиця Агафії Степаняк
Адама Міцкевича вулиця	вулиця Адама Міцкевича
Академіка Богомольця вулиця	вулиця Академіка Богомольця
Академіка Гнатюка вулиця	вулиця Академіка Гнатюка
Академіка Данилюка вулиця	вулиця Академіка Данилюка
Академіка Корольова вулиця	вулиця Академіка Корольова
Академіка Сахарова вулиця	вулиця Академіка Сахарова
Алея казок	алея Казок
Америка вулиця	вулиця Америка
Анатолія Вахнянина вулиця	вулиця Анатолія Вахнянина
Анатолія Кос-Анатольського вулиця	вулиця Анатолія Кос-Анатольського
Андрея Шептицького вулиця	вулиця Андрея Шептицького
Андрія Войнаровського вулиця	вулиця Андрія Войнаровського
Андрія Красовського вулиця	вулиця Андрія Красовського
Андрія Малишка вулиця	вулиця Андрія Малишка
Андрія Мельника вулиця	вулиця Андрія Мельника
Андрія Палія вулиця	вулиця Андрія Палія
Андрія Сахарова вулиця	вулиця Андрія Сахарова
Андрія Чайковського вулиця	вулиця Андрія Чайковського
Андрія Шептицького вулиця	вулиця Андрія Шептицького
Андрусяка вулиця	вулиця Андрусяка
Антіна Головатого вулиця	вулиця Антіна Головатого
Антіна Лотоцького вулиця	вулиця Антіна Лотоцького
Антіна Онищука вулиця	вулиця Антіна Онищука
Антона Княжинського вулиця	вулиця Антона Княжинського
Антона Лотоцького вулиця	вулиця Антона Лотоцького
Антона Макаренка вулиця	вулиця Антона Макаренка
Антона Онищука вулиця	вулиця Антона Онищука
Антона Петрушевича вулиця	вулиця Антона Петрушевича
Антона Чехова вулиця	вулиця Антона Чехова
Антоненка-Давидовича вулиця	вулиця Антоненка-Давидовича
Антоновича вулиця	вулиця Антоновича
Аркаса вулиця	вулиця Аркаса
Аркаса-Подільського вулиця	вулиця Аркаса-Подільського
Артема Веделя вулиця	вулиця Артема Веделя
Артемовського вулиця	вулиця Артемовського
Архипа Тесленка вулиця	вулиця Архипа Тесленка
Архітектора Романа Грицая вулиця	вулиця Архітектора Романа Грицая
Атаманюка вулиця	вулиця Атаманюка
Бабинського вулиця	вулиця Бабинського
Бабія вулиця	вулиця Бабія
Багряного вулиця	вулиця Багряного
Бажана вулиця	вулиця Бажана
Байди-Вишневецького вулиця	вулиця Байди-Вишневецького
Бандери вулиця	вулиця Бандери
Барабашів вулиця	вулиця Барабашів
Бариш вулиця	вулиця Бариш
Барнича вулиця	вулиця Барнича
Бачинського вулиця	вулиця Бачинського
Башта вулиця	вулиця Башта
Бащенка вулиця	вулиця Бащенка
Бебеля вулиця	вулиця Бебеля
Беляєва вулиця	вулиця Беляєва
Бенцаля вулиця	вулиця Бенцаля
Берегового вулиця	вулиця Берегового
Бережницького вулиця	вулиця Бережницького
Березена вулиця	вулиця Березена
Березовського вулиця	вулиця Березовського
Беринди вулиця	вулиця Беринди
Біласа і Данилишина вулиця	вулиця Біласа і Данилишина
Білозіра вулиця	вулиця Білозіра
Білозора вулиця	вулиця Білозора
Білоуса вулиця	вулиця Білоуса
Блавацького вулиця	вулиця Блавацького
Блонського вулиця	вулиця Блонського
Бобикевича вулиця	вулиця Бобикевича
Бобинського вулиця	вулиця Бобинського
Богдана Лепкого вулиця	вулиця Богдана Лепкого
Богдана Пелеха вулиця	вулиця Богдана Пелеха
Богдана Хмельницького вулиця	вулиця Богдана Хмельницького
Богдана Хмельницького провулок	провулок Богдана Хмельницького
Богдана-Ігора Антонича вулиця	вулиця Богдана-Ігора Антонича
Богуна вулиця	вулиця Богуна
Боднарука вулиця	вулиця Боднарука
Боднарчука вулиця	вулиця Боднарчука
Бойківчанка вулиця	вулиця Бойківчанка
Бойчука вулиця	вулиця Бойчука
Бори вулиця	вулиця Бори
Бориса Грінченка вулиця	вулиця Бориса Грінченка
Бориса Кудрика вулиця	вулиця Бориса Кудрика
Бортнянського вулиця	вулиця Бортнянського
Борців вулиця	вулиця Борців
Братів Білоусів вулиця	вулиця Братів Білоусів
Братів Бойчуків вулиця	вулиця Братів Бойчуків
Братів Василиків вулиця	вулиця Братів Василиків
Братів Гайдичуків вулиця	вулиця Братів Гайдичуків
Братів Довганюків вулиця	вулиця Братів Довганюків
Братів Дяченків вулиця	вулиця Братів Дяченків
Братів Козаків вулиця	вулиця Братів Козаків
Братів Курилюків вулиця	вулиця Братів Курилюків
Братів Лепких вулиця	вулиця Братів Лепких
Братів Микитюків вулиця	вулиця Братів Микитюків
Братів Михайлининих вулиця	вулиця Братів Михайлининих
Братів Морозевичів вулиця	вулиця Братів Морозевичів
Братів Окуневських вулиця	вулиця Братів Окуневських
Братів Пнівчуків вулиця	вулиця Братів Пнівчуків
Братів Приймаків вулиця	вулиця Братів Приймаків
Братів Фільчинських вулиця	вулиця Братів Фільчинських
Бринського вулиця	вулиця Бринського
Бугая вулиця	вулиця Бугая
Будівельників вулиця	вулиця Будівельників
Будьоного вулиця	вулиця Будьоного
Букатчука вулиця	вулиця Букатчука
В'ячеслава Чорновола вулиця	вулиця Вʼячеслава Чорновола
В'ячеслава Чорновола проспект	проспект Вʼячеслава Чорновола
В’ячеслава Липинського вулиця	вулиця Вʼячеслава Липинського
В’ячеслава Розвадовського вулиця	вулиця Вʼячеслава Розвадовського
В’ячеслава Чорновола вулиця	вулиця Вʼячеслава Чорновола
В’ячеслава Чорновола проспект	проспект Вʼячеслава Чорновола
Вавілова вулиця	вулиця Вавілова
Вагилевича вулиця	вулиця Вагилевича
Вайгеля вулиця	вулиця Вайгеля
Валентини Терешкової вулиця	вулиця Валентини Терешкової
Василіянок вулиця	вулиця Василіянок
Василя Авраменка вулиця	вулиця Василя Авраменка
Василя Андрійчука вулиця	вулиця Василя Андрійчука
Василя Атаманюка вулиця	вулиця Василя Атаманюка
Василя Барвінського вулиця	вулиця Василя Барвінського
Василя Верховинця вулиця	вулиця Василя Верховинця
Василя Вишиваного вулиця	вулиця Василя Вишиваного
Василя Дядинюка вулиця	вулиця Василя Дядинюка
Василя Івасюка вулиця	вулиця Василя Івасюка
Василя Кархута вулиця	вулиця Василя Кархута
Василя Касіяна вулиця	вулиця Василя Касіяна
Василя Костащука вулиця	вулиця Василя Костащука
Василя Матієка вулиця	вулиця Василя Матієка
Василя Міліянчука вулиця	вулиця Василя Міліянчука
Василя Нагірного вулиця	вулиця Василя Нагірного
Василя Петрука вулиця	вулиця Василя Петрука
Василя Симоненка вулиця	вулиця Василя Симоненка
Василя Симчича вулиця	вулиця Василя Симчича
Василя Січка вулиця	вулиця Василя Січка
Василя Сліпака вулиця	вулиця Василя Сліпака
Василя Стефаника вулиця	вулиця Василя Стефаника
Василя Стефаника набережна	набережна Василя Стефаника
Василя Стуса вулиця	вулиця Василя Стуса
Василя Стуса провулок	провулок Василя Стуса
Васкула вулиця	вулиця Васкула
Ватутіна вулиця	вулиця Ватутіна
Веделя вулиця	вулиця Веделя
Ведмежий вулиця	вулиця Ведмежий
Велика Царинка вулиця	вулиця Велика Царинка
Великий Берег вулиця	вулиця Великий Берег
Величковича вулиця	вулиця Величковича
Венгриновича вулиця	вулиця Венгриновича
Вербицького вулиця	вулиця Вербицького
Верещинського вулиця	вулиця Верещинського
Верховинця вулиця	вулиця Верховинця
Верховної Ради вулиця	вулиця Верховної Ради
Веселова вулиця	вулиця Веселова
Веселовського вулиця	вулиця Веселовського
Вигін вулиця	вулиця Вигін
Виговського вулиця	вулиця Виговського
Визволення вулиця	вулиця Визволення
Виксюка вулиця	вулиця Виксюка
Винниця вулиця	вулиця Винниця
Винниченка вулиця	вулиця Винниченка
Височана вулиця	вулиця Височана
Височанка вулиця	вулиця Височанка
Височина вулиця	вулиця Височина
Витвицького вулиця	вулиця Витвицького
Вишенського вулиця	вулиця Вишенського
Відоняка вулиця	вулиця Відоняка
Відродження вулиця	вулиця Відродження
Відродження площа	площа Відродження
Військових Ветеранів вулиця	вулиця Військових Ветеранів
Військових Хірургів вулиця	вулиця Військових Хірургів
Вільна Україна вулиця	вулиця Вільна Україна
Віри Левицької вулиця	вулиця Віри Левицької
Вісконта вулиця	вулиця Вісконта
Віталія Кулінича вулиця	вулиця Віталія Кулінича
Віталія Носкевича вулиця	вулиця Віталія Носкевича
Вітовського вулиця	вулиця Вітовського
Вітовського провулок	провулок Вітовського
Вічевий Майдан вулиця	вулиця Вічевий Майдан
Вічевий Майдан площа	площа Вічевий Майдан
Воєводи Коснятина вулиця	вулиця Воєводи Коснятина
Возз’єднання вулиця	вулиця Воззʼєднання
Воїнів УПА вулиця	вулиця Воїнів УПА
Воїнів-Інтернаціоналістів вулиця	вулиця Воїнів-Інтернаціоналістів
Войтул вулиця	вулиця Войтул
Волі площа	площа Волі
Володимира Антоновича вулиця	вулиця Володимира Антоновича
Володимира Блавацького вулиця	вулиця Володимира Блавацького
Володимира Великого вулиця	вулиця Володимира Великого
Володимира Великого провулок	провулок Володимира Великого
Володимира Вернадського вулиця	вулиця Володимира Вернадського
Володимира Винниченка вулиця	вулиця Володимира Винниченка
Володимира Вінниченка вулиця	вулиця Володимира Вінниченка
Володимира Войцюка вулиця	вулиця Володимира Войцюка
Володимира вулиця	вулиця Володимира
Володимира Гнатюка вулиця	вулиця Володимира Гнатюка
Володимира Івасюка вулиця	вулиця Володимира Івасюка
Володимира Кубійовича вулиця	вулиця Володимира Кубійовича
Володимира Маланюка вулиця	вулиця Володимира Маланюка
Володимира Малкоша вулиця	вулиця Володимира Малкоша
Володимира Манюха вулиця	вулиця Володимира Манюха
Володимира Павлусевича вулиця	вулиця Володимира Павлусевича
Володимира Самійленка вулиця	вулиця Володимира Самійленка
Володимира Сосюри вулиця	вулиця Володимира Сосюри
Володимира Тисовського вулиця	вулиця Володимира Тисовського
Володимира Хроновича вулиця	вулиця Володимира Хроновича
Володимира Яновича вулиця	вулиця Володимира Яновича
Воробкевича вулиця	вулиця Воробкевича
Вороного вулиця	вулиця Вороного
Ворошилова вулиця	вулиця Ворошилова
Вояків УПА вулиця	вулиця Вояків УПА
Врубеля вулиця	вулиця Врубеля
вулиця В'ячеслава Чорновола	вулиця Вʼячеслава Чорновола
Вчительска вулиця	Вчительська вулиця
Вячеслава Чорновола вулиця	вулиця Вʼячеслава Чорновола
Вʼячеслава Чорновола вулиця	вулиця Вʼячеслава Чорновола
Гаврилюка вулиця	вулиця Гаврилюка
Гавуки вулиця	вулиця Гавуки
Гагаріна вулиця	вулиця Гагаріна
Газовиків вулиця	вулиця Газовиків
Гай вулиця	вулиця Гай
Гайдамаків вулиця	вулиця Гайдамаків
Гайдея вулиця	вулиця Гайдея
Гайдея провулок	провулок Гайдея
Гайок вулиця	вулиця Гайок
Галагана вулиця	вулиця Галагана
Галагана провулок	провулок Галагана
Галана вулиця	вулиця Галана
Галечко вулиця	вулиця Галечко
Галицького вулиця	вулиця Галицького
Гамалії вулиця	вулиця Гамалії
Ганни Дерев'янко вулиця	вулиця Ганни Деревʼянко
Ганущака вулиця	вулиця Ганущака
Гарасимова вулиця	вулиця Гарасимова
Гаркуші вулиця	вулиця Гаркуші
Гелевана вулиця	вулиця Гелевана
Генерала Григоренка вулиця	вулиця Генерала Григоренка
Генерала Черняховського вулиця	вулиця Генерала Черняховського
Героїв Бреста вулиця	вулиця Героїв Бреста
Героїв Волновахи вулиця	вулиця Героїв Волновахи
Героїв вулиця	вулиця Героїв
Героїв Євромайдану вулиця	вулиця Героїв Євромайдану
Героїв Києва вулиця	вулиця Героїв Києва
Героїв Крут вулиця	вулиця Героїв Крут
Героїв Майдану вулиця	вулиця Героїв Майдану
Героїв Майдану площа	площа Героїв Майдану
Героїв Маріуполя вулиця	вулиця Героїв Маріуполя
Героїв Миколаєва вулиця	вулиця Героїв Миколаєва
Героїв Небесної Сотні вулиця	вулиця Героїв Небесної Сотні
Героїв ОУН вулиця	вулиця Героїв ОУН
Героїв Охтирки вулиця	вулиця Героїв Охтирки
Героїв площа	площа Героїв
Героїв Попасної вулиця	вулиця Героїв Попасної
Героїв України вулиця	вулиця Героїв України
Героїв УПА вулиця	вулиця Героїв УПА
Героїв Харкова вулиця	вулиця Героїв Харкова
Героїв Херсона вулиця	вулиця Героїв Херсона
Героїв Чернігова вулиця	вулиця Героїв Чернігова
Героїв-Пожежників вулиця	вулиця Героїв-Пожежників
Герцена вулиця	вулиця Герцена
Гетьмана Івана Мазепи вулиця	вулиця Гетьмана Івана Мазепи
Гетьмана Кирила Розумовського вулиця	вулиця Гетьмана Кирила Розумовського
Гетьмана Мазепи вулиця	вулиця Гетьмана Мазепи
Гетьмана Павла Полуботка вулиця	вулиця Гетьмана Павла Полуботка
Гетьмана Петра Дорошенка вулиця	вулиця Гетьмана Петра Дорошенка
Гетьмана Петра Сагайдачного вулиця	вулиця Гетьмана Петра Сагайдачного
Гетьмана Сагайдачного вулиця	вулиця Гетьмана Сагайдачного
Глибокий Кінець вулиця	вулиця Глибокий Кінець
Глинського вулиця	вулиця Глинського
Глібова вулиця	вулиця Глібова
Глінки вулиця	вулиця Глінки
Гната Ковцуняка вулиця	вулиця Гната Ковцуняка
Гната Мартинця вулиця	вулиця Гната Мартинця
Гната Стефаніва вулиця	вулиця Гната Стефаніва
Гната Хоткевича вулиця	вулиця Гната Хоткевича
Гнатюка вулиця	вулиця Гнатюка
Гоголя вулиця	вулиця Гоголя
Голинського вулиця	вулиця Голинського
Головацького вулиця	вулиця Головацького
Голуба вулиця	вулиця Голуба
Гонти вулиця	вулиця Гонти
Гончара вулиця	вулиця Гончара
Гончарівка вулиця	вулиця Гончарівка
Гора вулиця	вулиця Гора
Горбаля вулиця	вулиця Горбаля
Горбачевського вулиця	вулиця Горбачевського
Горби Пролісок вулиця	вулиця Горби Пролісок
Горбок вулиця	вулиця Горбок
Гори вулиця	вулиця Гори
Горішнянка вулиця	вулиця Горішнянка
Городецького вулиця	вулиця Городецького
Городище вулиця	вулиця Городище
Горького вулиця	вулиця Горького
Гостинець вулиця	вулиця Гостинець
Грабівського вулиця	вулиця Грабівського
Грабовського вулиця	вулиця Грабовського
Григора Коссака вулиця	вулиця Григора Коссака
Григора Крука вулиця	вулиця Григора Крука
Григорашівка вулиця	вулиця Григорашівка
Григорія Ількевича вулиця	вулиця Григорія Ількевича
Григорія Коссака вулиця	вулиця Григорія Коссака
Григорія Сковороди вулиця	вулиця Григорія Сковороди
Григорія Ступаря вулиця	вулиця Григорія Ступаря
Григорія Тютюнника вулиця	вулиця Григорія Тютюнника
Грималюк вулиця	вулиця Грималюк
Грималюка вулиця	вулиця Грималюка
Гриневичів вулиця	вулиця Гриневичів
Гринчишина вулиця	вулиця Гринчишина
Гринюка вулиця	вулиця Гринюка
Грицишина вулиця	вулиця Грицишина
Грицулівка вулиця	вулиця Грицулівка
Грицюка вулиця	вулиця Грицюка
Грінченка вулиця	вулиця Грінченка
Грома вулиця	вулиця Грома
Грушевського вулиця	вулиця Грушевського
Груші вулиця	вулиця Груші
Гулака вулиця	вулиця Гулака
Гулака-Артемовського вулиця	вулиця Гулака-Артемовського
Гуменівка вулиця	вулиця Гуменівка
Гуцульського повстання вулиця	вулиця Гуцульського Повстання
Давидюка вулиця	вулиця Давидюка
Далибогова вулиця	вулиця Далибогова
Данила галицького вулиця	вулиця Данила Галицького
Данила Галицького вулиця	вулиця Данила Галицького
Данила Галицького площа	площа Данила Галицького
Данила Нечая вулиця	вулиця Данила Нечая
Данилевського вулиця	вулиця Данилевського
Данилюка вулиця	вулиця Данилюка
Данкевича вулиця	вулиця Данкевича
Дарвіна вулиця	вулиця Дарвіна
Дарії Цвєк вулиця	вулиця Дарії Цвєк
Двір вулиця	вулиця Двір
Двір площа	площа Двір
Дебенка вулиця	вулиця Дебенка
Девдюка вулиця	вулиця Девдюка
Дем’янів Лаз вулиця	вулиця Демʼянів Лаз
Дем’янчука вулиця	вулиця Демʼянчука
Демка вулиця	вулиця Демка
Демчука вулиця	вулиця Демчука
Дениса Січинського вулиця	вулиця Дениса Січинського
Денисівка вулиця	вулиця Денисівка
Джохара Дудаєва вулиця	вулиця Джохара Дудаєва
Дзівінського вулиця	вулиця Дзівінського
Дмитра Бортнянського вулиця	вулиця Дмитра Бортнянського
Дмитра Вітовського вулиця	вулиця Дмитра Вітовського
Дмитра Донцова вулиця	вулиця Дмитра Донцова
Дмитра Николишина вулиця	вулиця Дмитра Николишина
Дмитра Рудика вулиця	вулиця Дмитра Рудика
Дмитра Синяка вулиця	вулиця Дмитра Синяка
Дмитра Циганкова вулиця	вулиця Дмитра Циганкова
Дмитра Яворницького вулиця	вулиця Дмитра Яворницького
Дмитрова вулиця	вулиця Дмитрова
Добролюбова вулиця	вулиця Добролюбова
Довбуша вулиця	вулиця Довбуша
Довбуша провулок	провулок Довбуша
Довбуша Сотенного вулиця	вулиця Довбуша Сотенного
Довганюка вулиця	вулиця Довганюка
Довженка вулиця	вулиця Довженка
Довжинець вулиця	вулиця Довжинець
Доктора Володимира Білозора вулиця	вулиця Доктора Володимира Білозора
Доктора Олександра Козакевича вулиця	вулиця Доктора Олександра Козакевича
Доктора Пирогова вулиця	вулиця Доктора Пирогова
Докучаєва вулиця	вулиця Докучаєва
Долішнянка вулиця	вулиця Долішнянка
Дорошенка вулиця	вулиця Дорошенка
Достоєвського вулиця	вулиця Достоєвського
Драгоманова вулиця	вулиця Драгоманова
Дрогобича вулиця	вулиця Дрогобича
Друга церковна вулиця	2-га Церковна вулиця
Дружби вулиця	вулиця Дружби
Дубина вулиця	вулиця Дубина
Дубовецького вулиця	вулиця Дубовецького
Дубовиця вулиця	вулиця Дубовиця
Дубок вулиця	вулиця Дубок
Дурбака вулиця	вулиця Дурбака
Дучимінської вулиця	вулиця Дучимінської
Дядинюка вулиця	вулиця Дядинюка
Едельвейсів вулиця	вулиця Едельвейсів
Енергетиків вулиця	вулиця Енергетиків
Євгена Гребінки вулиця	вулиця Євгена Гребінки
Євгена Коновальця вулиця	вулиця Євгена Коновальця
Євгена Мельничука вулиця	вулиця Євгена Мельничука
Євгена Озаркевича вулиця	вулиця Євгена Озаркевича
Євгена Петрушевича вулиця	вулиця Євгена Петрушевича
Євгенія Петрушевича вулиця	вулиця Євгенія Петрушевича
Євстахія Джанджаласа вулиця	вулиця Євстахія Джанджаласа
Євшана вулиця	вулиця Євшана
Єдності площа	площа Єдності
Єсеніна вулиця	вулиця Єсеніна
Єфремова вулиця	вулиця Єфремова
Жаб’євська вулиця	Жабʼєвська вулиця
Жаб’євський Потік вулиця	вулиця Жабʼєвський Потік
Желехівського вулиця	вулиця Желехівського
Жибчина вулиця	вулиця Жибчина
Жолоби вулиця	вулиця Жолоби
За городами вулиця	вулиця За Городами
За Городами вулиця	вулиця За Городами
За двором вулиця	вулиця За Двором
За Парканом урочище	урочище За Парканом
Заболотного вулиця	вулиця Заболотного
Заболоття вулиця	вулиця Заболоття
Завода вулиця	вулиця Завода
Заговда вулиця	вулиця Заговда
Загороднього вулиця	вулиця Загороднього
Загребельки вулиця	вулиця Загребельки
Загребля вулиця	вулиця Загребля
Заклинських вулиця	вулиця Заклинських
Залізняка вулиця	вулиця Залізняка
Замлинівка вулиця	вулиця Замлинівка
Замлинських вулиця	вулиця Замлинських
Замори вулиця	вулиця Замори
Занковецької вулиця	вулиця Занковецької
Заньковецької вулиця	вулиця Заньковецької
Заокіп вулиця	вулиця Заокіп
Зарінок вулиця	вулиця Зарінок
Зачорного вулиця	вулиця Зачорного
Зашкапії вулиця	вулиця Зашкапії
Зв’язкова вулиця	Звʼязкова вулиця
Згари вулиця	вулиця Згари
Здоров'я вулиця	вулиця Здоровʼя
Зелена Долина вулиця	вулиця Зелена Долина
Зеновія Красівського вулиця	вулиця Зеновія Красівського
Зеновія Човгана вулиця	вулиця Зеновія Човгана
Зіньковецької вулиця	вулиця Зіньковецької
Злуки вулиця	вулиця Злуки
Зузука вулиця	вулиця Зузука
Івана Богуна вулиця	вулиця Івана Богуна
Івана Богуна провулок	провулок Івана Богуна
Івана Бодруга вулиця	вулиця Івана Бодруга
Івана Борковського вулиця	вулиця Івана Борковського
Івана Вавшківа вулиця	вулиця Івана Вавшківа
Івана Вагилевича вулиця	вулиця Івана Вагилевича
Івана Виговського вулиця	вулиця Івана Виговського
Івана Вишенського вулиця	вулиця Івана Вишенського
Івана Гонти вулиця	вулиця Івана Гонти
Івана Гонти провулок	провулок Івана Гонти
Івана Демушки вулиця	вулиця Івана Демушки
Івана Драча вулиця	вулиця Івана Драча
Івана Іскри вулиця	вулиця Івана Іскри
Івана Карпенка-Карого вулиця	вулиця Івана Карпенка-Карого
Івана Котлярвського вулиця	вулиця Івана Котляревського
Івана Котляревського вулиця	вулиця Івана Котляревського
Івана Кривого вулиця	вулиця Івана Кривого
Івана Крип’якевича вулиця	вулиця Івана Крипʼякевича
Івана Куровця вулиця	вулиця Івана Куровця
Івана Левинського вулиця	вулиця Івана Левинського
Івана Мазепи вулиця	вулиця Івана Мазепи
Івана Мазепи провулок	провулок Івана Мазепи
Івана Майданського вулиця	вулиця Івана Майданського
Івана Макуха вулиця	вулиця Івана Макуха
Івана Матлюка вулиця	вулиця Івана Матлюка
Івана Миколайчука вулиця	вулиця Івана Миколайчука
Івана Мирона вулиця	вулиця Івана Мирона
Івана Мічуріна вулиця	вулиця Івана Мічуріна
Івана Мухи вулиця	вулиця Івана Мухи
Івана Нечуя-Левицького вулиця	вулиця Івана Нечуя-Левицького
Івана Новодворського вулиця	вулиця Івана Новодворського
Івана Огієнка вулиця	вулиця Івана Огієнка
Івана Озаркевича вулиця	вулиця Івана Озаркевича
Івана Ощипка вулиця	вулиця Івана Ощипка
Івана Павла II вулиця	вулиця Івана Павла II
Івана Паторжинського вулиця	вулиця Івана Паторжинського
Івана Петраша вулиця	вулиця Івана Петраша
Івана Підкови вулиця	вулиця Івана Підкови
Івана Підкови провулок	провулок Івана Підкови
Івана Пулюя вулиця	вулиця Івана Пулюя
Івана Рубчака вулиця	вулиця Івана Рубчака
Івана Сапіжака вулиця	вулиця Івана Сапіжака
Івана Сірка вулиця	вулиця Івана Сірка
Івана Ткачука вулиця	вулиця Івана Ткачука
Івана Труша вулиця	вулиця Івана Труша
Івана Федика вулиця	вулиця Івана Федика
Івана Франка вулиця	вулиця Івана Франка
Івана Франка площа	площа Івана Франка
Івана Франка провулок	провулок Івана Франка
Івана Чав’яка вулиця	вулиця Івана Чавʼяка
Івана Чупрея вулиця	вулиця Івана Чупрея
Івана Шарлая вулиця	вулиця Івана Шарлая
Іваника вулиця	вулиця Іваника
Іванцева вулиця	вулиця Іванцева
Іванціва вулиця	вулиця Іванціва
Івасюка вулиця	вулиця Івасюка
Ігора Білозіра вулиця	вулиця Ігора Білозіра
Ігоря Білозіра вулиця	вулиця Ігоря Білозіра
Іллі Рєпіна вулиця	вулиця Іллі Рєпіна
Ірини Вільде вулиця	вулиця Ірини Вільде
Ірчана вулиця	вулиця Ірчана
Ірчана провулок	провулок Ірчана
Йосафата Кобринського вулиця	вулиця Йосафата Кобринського
Йосипа Гірняка вулиця	вулиця Йосипа Гірняка
Йосипа Сліпого вулиця	вулиця Йосипа Сліпого
Йосипа Стадника вулиця	вулиця Йосипа Стадника
Йосифа Сліпого вулиця	вулиця Йосифа Сліпого
Каденюка вулиця	вулиця Каденюка
Калина вулиця	вулиця Калина
Калініна вулиця	вулиця Калініна
Калнишевського вулиця	вулиця Калнишевського
Калуське Шосе вулиця	вулиця Калуське Шосе
Кам'яниста вулиця	Камʼяниста вулиця
Кам'янка вулиця	вулиця Камʼянка
Кам’янецька вулиця	Камʼянецька вулиця
Кам’яниста вулиця	Камʼяниста вулиця
Кам’янка вулиця	вулиця Камʼянка
Кам’янка провулок	провулок Камʼянка
Каменець вулиця	вулиця Каменець
Каменярів вулиця	вулиця Каменярів
Каракая вулиця	вулиця Каракая
Кардашівка вулиця	вулиця Кардашівка
Кардинала Йосифа Сліпого вулиця	вулиця Кардинала Йосифа Сліпого
Кардинала Любачівського вулиця	вулиця Кардинала Любачівського
Кардинала Любомира Гузара вулиця	вулиця Кардинала Любомира Гузара
Карла Вишневського вулиця	вулиця Карла Вишневського
Кармалюка вулиця	вулиця Кармалюка
Карманського вулиця	вулиця Карманського
Кармелюка вулиця	вулиця Кармелюка
Карпатської Січі вулиця	вулиця Карпатської Січі
Карпенка-Карого вулиця	вулиця Карпенка-Карого
Карпенко-Карого вулиця	вулиця Карпенко-Карого
Кархута вулиця	вулиця Кархута
Касіяна вулиця	вулиця Касіяна
Катерини Зарицької вулиця	вулиця Катерини Зарицької
Каштанів вулиця	вулиця Каштанів
Квітки-Основ’яненка вулиця	вулиця Квітки-Основʼяненка
Керамиків вулиця	вулиця Керамиків
Кибальчича вулиця	вулиця Кибальчича
Кирила Блонського вулиця	вулиця Кирила Блонського
Кирила Стеценка вулиця	вулиця Кирила Стеценка
Кирила Трильовського вулиця	вулиця Кирила Трильовського
Кисилевської вулиця	вулиця Кисилевської
Кіндрата вулиця	вулиця Кіндрата
Климпуші вулиця	вулиця Климпуші
Княгинин вулиця	вулиця Княгинин
Княгиницького вулиця	вулиця Княгиницького
Княгині Ольги вулиця	вулиця Княгині Ольги
Князя Володимира вулиця	вулиця Князя Володимира
Князя Лева вулиця	вулиця Князя Лева
Князя Осьмомисла вулиця	вулиця Князя Осьмомисла
Князя Святослава вулиця	вулиця Князя Святослава
Кобзаря вулиця	вулиця Кобзаря
Кобиляка вулиця	вулиця Кобиляка
Кобилянського вулиця	вулиця Кобилянського
Кобилянської вулиця	вулиця Кобилянської
Кобринських вулиця	вулиця Кобринських
Кобринського вулиця	вулиця Кобринського
Кобринської вулиця	вулиця Кобринської
Ковалева вулиця	вулиця Ковалева
Ковалевської вулиця	вулиця Ковалевської
Ковалівка вулиця	вулиця Ковалівка
Коваля вулиця	вулиця Коваля
Ковбуза вулиця	вулиця Ковбуза
Ковжуна вулиця	вулиця Ковжуна
Ковпака вулиця	вулиця Ковпака
Козака вулиця	вулиця Козака
Козакевича вулиця	вулиця Козакевича
Козланюка вулиця	вулиця Козланюка
Козоріса вулиця	вулиця Козоріса
Козьменка вулиця	вулиця Козьменка
Колесси вулиця	вулиця Колесси
Колодзінського вулиця	вулиця Колодзінського
Коломийчука вулиця	вулиця Коломийчука
Колюшки вулиця	вулиця Колюшки
Комарова вулиця	вулиця Комарова
Коника вулиця	вулиця Коника
Коновальця вулиця	вулиця Коновальця
Коновальця провулок	провулок Коновальця
Конституції України вулиця	вулиця Конституції України
Констянтина Федирко вулиця	вулиця Констянтина Федирко
Коперника вулиця	вулиця Коперника
Коперніка вулиця	вулиця Коперніка
Корбутяка вулиця	вулиця Корбутяка
Коритовського вулиця	вулиця Коритовського
Корнила Устияновича вулиця	вулиця Корнила Устияновича
Корнійчука вулиця	вулиця Корнійчука
Короленка вулиця	вулиця Короленка
Королівка вулиця	вулиця Королівка
Корольова вулиця	вулиця Корольова
Корольова провулок	провулок Корольова
Короля Данила вулиця	вулиця Короля Данила
Космонавтів вулиця	вулиця Космонавтів
Коссака вулиця	вулиця Коссака
Кості Левицького вулиця	вулиця Кості Левицького
Костомарова вулиця	вулиця Костомарова
Костя Левицького вулиця	вулиця Костя Левицького
Костянтини Малицької вулиця	вулиця Костянтини Малицької
Котляревського вулиця	вулиця Котляревського
Котляревського провулок	провулок Котляревського
Коцорина вулиця	вулиця Коцорина
Коцюбинського вулиця	вулиця Коцюбинського
Кошового Костя Гордієнка вулиця	вулиця Кошового Костя Гордієнка
Країще вулиця	вулиця Країще
Крайківського вулиця	вулиця Крайківського
Красінського вулиця	вулиця Красінського
Краснодонців вулиця	вулиця Краснодонців
Кривенького вулиця	вулиця Кривенького
Кривець вулиця	вулиця Кривець
Кривня Горішня вулиця	вулиця Кривня Горішня
Кривня Долішня вулиця	вулиця Кривня Долішня
Кривоноса вулиця	вулиця Кривоноса
Кривоноса провулок	провулок Кривоноса
Кривуля вулиця	вулиця Кривуля
Кринички вулиця	вулиця Кринички
Крип’якевича вулиця	вулиця Крипʼякевича
Кропивницького вулиця	вулиця Кропивницького
Крушельницьких вулиця	вулиця Крушельницьких
Крушельницького вулиця	вулиця Крушельницького
Крушельницької вулиця	вулиця Крушельницької
Крушина вулиця	вулиця Крушина
Кубалівка вулиця	вулиця Кубалівка
Кубійовичів вулиця	вулиця Кубійовичів
Куйбишева вулиця	вулиця Куйбишева
Куліша вулиця	вулиця Куліша
Кульчицької вулиця	вулиця Кульчицької
Купчинського вулиця	вулиця Купчинського
Курбаса вулиця	вулиця Курбаса
Курінного Скуби вулиця	вулиця Курінного Скуби
Курінного Чорноти вулиця	вулиця Курінного Чорноти
Кут вулиця	вулиця Кут
Кути вулиця	вулиця Кути
Лаврищева вулиця	вулиця Лаврищева
Ламана вулиця	вулиця Ламана
Лани вулиця	вулиця Лани
Ласійчука Василя вулиця	вулиця Василя Ласійчука
Лебедя вулиця	вулиця Лебедя
Лева Ребета вулиця	вулиця Лева Ребета
Левада вулиця	вулиця Левада
Левади вулиця	вулиця Левади
Левицького вулиця	вулиця Левицького
Левицької-Бесараб вулиця	вулиця Левицької-Бесараб
Левка Бачинського вулиця	вулиця Левка Бачинського
Левка Дольницького вулиця	вулиця Левка Дольницького
Левка Лук’яненка вулиця	вулиця Левка Лукʼяненка
Левка Семиренка вулиця	вулиця Левка Семиренка
Леніна вулиця	вулиця Леніна
Ленкавського вулиця	вулиця Ленкавського
Ленкавського провулок	провулок Ленкавського
Леона Куленія вулиця	вулиця Леона Куленія
Леонтовича вулиця	вулиця Леонтовича
Лепкого вулиця	вулиця Лепкого
Лермонтова вулиця	вулиця Лермонтова
Лесі Українки бульвар	бульвар Лесі Українки
Лесі Українки вулиця	вулиця Лесі Українки
Лесі Українки провулок	провулок Лесі Українки
Лесі Українки проспект	проспект Лесі Українки
Лесіва вулиця	вулиця Лесіва
Леся Гринюка вулиця	вулиця Леся Гринюка
Леся Курбаса вулиця	вулиця Леся Курбаса
Леся Мартовича вулиця	вулиця Леся Мартовича
Леся Мартовича площа	площа Леся Мартовича
Липова-Осада вулиця	вулиця Липова-Осада
Лисенка вулиця	вулиця Лисенка
Литвина вулиця	вулиця Литвина
Ліни Костенко вулиця	вулиця Ліни Костенко
Лісорубів вулиця	вулиця Лісорубів
Ломоносова вулиця	вулиця Ломоносова
Лопушанського вулиця	вулиця Лопушанського
Луги вулиця	вулиця Луги
Луги провулок	провулок Луги
Лукача вулиця	вулиця Лукача
Луки Данкевича вулиця	вулиця Луки Данкевича
Луки Загірські вулиця	вулиця Луки Загірські
Лукіяновича вулиця	вулиця Лукіяновича
Лучка вулиця	вулиця Лучка
Любомира Гузара вулиця	вулиця Любомира Гузара
Людвіга ван Бетховена вулиця	вулиця Людвіга ван Бетховена
Людкевича вулиця	вулиця Людкевича
Люкляна вулиця	вулиця Люкляна
Мазепи вулиця	вулиця Мазепи
Мазепи провулок	провулок Мазепи
Мазурика вулиця	вулиця Мазурика
Майора Прута вулиця	вулиця Майора Прута
Макаренка вулиця	вулиця Макаренка
Маковея вулиця	вулиця Маковея
Маковея провулок	провулок Маковея
Макогона вулиця	вулиця Макогона
Максима Березовського вулиця	вулиця Максима Березовського
Максима Залізняка вулиця	вулиця Максима Залізняка
Максима Рильського вулиця	вулиця Максима Рильського
Максимовича вулиця	вулиця Максимовича
Макуха вулиця	вулиця Макуха
Малицької вулиця	вулиця Малицької
Малишка вулиця	вулиця Малишка
Мандрика вулиця	вулиця Мандрика
Маргарити Сельської вулиця	вулиця Маргарити Сельської
Марії Заньковецької вулиця	вулиця Марії Заньковецької
Марії Підгірянки вулиця	вулиця Марії Підгірянки
Марії Слободівни вулиця	вулиця Марії Слободівни
Марійки Підгір’янки вулиця	вулиця Марійки Підгірʼянки
Марійки Підгірянки вулиця	вулиця Марійки Підгірянки
Марка Боєслава вулиця	вулиця Марка Боєслава
Марка Вовчка вулиця	вулиця Марка Вовчка
Марка Кропивницького вулиця	вулиця Марка Кропивницького
Марка Черемшини вулиця	вулиця Марка Черемшини
Марка Черемшини провулок	провулок Марка Черемшини
Маркіяна Шашкевича вулиця	вулиця Маркіяна Шашкевича
Мартина Королюка вулиця	вулиця Мартина Королюка
Мартовича вулиця	вулиця Мартовича
Марусі Чурай вулиця	вулиця Марусі Чурай
Марченича вулиця	вулиця Марченича
Марченка вулиця	вулиця Марченка
Матейки вулиця	вулиця Матейки
Матієва-Мельника вулиця	вулиця Матієва-Мельника
Матійчука вулиця	вулиця Матійчука
Медведівка вулиця	вулиця Медведівка
Межева-сад вулиця	вулиця Межева-Сад
Межигороди вулиця	вулиця Межигороди
Мелетія Кічури вулиця	вулиця Мелетія Кічури
Мельника вулиця	вулиця Мельника
Мельничука вулиця	вулиця Мельничука
Менделєєва вулиця	вулиця Менделєєва
Мендичевського вулиця	вулиця Мендичевського
Механізаторів вулиця	вулиця Механізаторів
Мечникова вулиця	вулиця Мечникова
Микитюка вулиця	вулиця Микитюка
Миколайчука вулиця	вулиця Миколайчука
Миколи Аркаса вулиця	вулиця Миколи Аркаса
Миколи Арсенича вулиця	вулиця Миколи Арсенича
Миколи Арсенича-Березовського вулиця	вулиця Миколи Арсенича-Березовського
Миколи Бенцаля вулиця	вулиця Миколи Бенцаля
Миколи Биха вулиця	вулиця Миколи Биха
Миколи Верещинського вулиця	вулиця Миколи Верещинського
Миколи Вороного вулиця	вулиця Миколи Вороного
Миколи Гоголя вулиця	вулиця Миколи Гоголя
Миколи Костомарова вулиця	вулиця Миколи Костомарова
Миколи Лебедя вулиця	вулиця Миколи Лебедя
Миколи Леонтовича вулиця	вулиця Миколи Леонтовича
Миколи Лисенка вулиця	вулиця Миколи Лисенка
Миколи Міхновського вулиця	вулиця Миколи Міхновського
Миколи Рибчука вулиця	вулиця Миколи Рибчука
Миколи Сабата вулиця	вулиця Миколи Сабата
Миколи Садовського вулиця	вулиця Миколи Садовського
Миколи Саєвича вулиця	вулиця Миколи Саєвича
Миколи Сарма-Соколовського вулиця	вулиця Миколи Сарма-Соколовського
Миколи Хвильового вулиця	вулиця Миколи Хвильового
Милого вулиця	вулиця Милого
Мира вулиця	вулиця Мира
Мирона Забарила вулиця	вулиця Мирона Забарила
Мирона Левицького вулиця	вулиця Мирона Левицького
Мирона Тарнавського вулиця	вулиця Мирона Тарнавського
Мирослава Ірчана вулиця	вулиця Мирослава Ірчана
Мирослава Лущака вулиця	вулиця Мирослава Лущака
Мирослави Кобилянської вулиці	вулиця Мирослави Кобилянської
Миру вулиця	вулиця Миру
Миру провулок	провулок Миру
Митрополита Андрея Шептицького вулиця	вулиця Митрополита Андрея Шептицького
Михайла Бажанського вулиця	вулиця Михайла Бажанського
Михайла Бойчука вулиця	вулиця Михайла Бойчука
Михайла Вербицького вулиця	вулиця Михайла Вербицького
Михайла Галущинського вулиця	вулиця Михайла Галущинського
Михайла Глінки вулиця	вулиця Михайла Глінки
Михайла Голинського вулиця	вулиця Михайла Голинського
Михайла Грушевського вулиця	вулиця Михайла Грушевського
Михайла Грушевського проспект	проспект Михайла Грушевського
Михайла Драгоманова вулиця	вулиця Михайла Драгоманова
Михайла Зорія вулиця	вулиця Михайла Зорія
Михайла Коцюбинського вулиця	вулиця Михайла Коцюбинського
Михайла Коцюбинського площа	площа Михайла Коцюбинського
Михайла Коцюбинського провулок	провулок Михайла Коцюбинського
Михайла Лермонтова вулиця	вулиця Михайла Лермонтова
Михайла Мочульського вулиця	вулиця Михайла Мочульського
Михайла Мулика вулиця	вулиця Михайла Мулика
Михайла Павлика вулиця	вулиця Михайла Павлика
Михайла Саведчука вулиця	вулиця Михайла Саведчука
Михайла Старицького вулиця	вулиця Михайла Старицького
Михайла Фіголя вулиця	вулиця Михайла Фіголя
Михайла Хромея вулиця	вулиця Михайла Хромея
Михайлевичів вулиця	вулиця Михайлевичів
Михайлюка вулиця	вулиця Михайлюка
Міхлі вулиця	вулиця Міхлі
Міцкевича вулиця	вулиця Міцкевича
Міцкевича площа	площа Міцкевича
Мічуріна вулиця	вулиця Мічуріна
Млинівка вулиця	вулиця Млинівка
Могильницького вулиця	вулиця Могильницького
Модеста Сосенка вулиця	вулиця Модеста Сосенка
Молодіжка вулиця	вулиця Молодіжка
Морозенка вулиця	вулиця Морозенка
Моцарта вулиця	вулиця Моцарта
Мочарки вулиця	вулиця Мочарки
Мочернюка вулиця	вулиця Мочернюка
Мошури вулиця	вулиця Мошури
Мусійовича вулиця	вулиця Мусійовича
Мухи вулиця	вулиця Мухи
Над Гуком вулиця	вулиця Над Гуком
Над Потоком вулиця	вулиця Над Потоком
Над Рудкою вулиця	вулиця Над Рудкою
Надії провулок	провулок Надії
Надій вулиця	вулиця Надій
Назарева вулиця	вулиця Назарева
Назаренка вулиця	вулиця Назаренка
Назарія Яремчука вулиця	вулиця Назарія Яремчука
Наливайка вулиця	вулиця Наливайка
Народного Артиста Василя Попадюка вулиця	вулиця Народного Артиста Василя Попадюка
Нафтовиків вулиця	вулиця Нафтовиків
Національної Гвардії вулиця	вулиця Національної Гвардії
Небесної Сотні вулиця	вулиця Небесної Сотні
Незалежності бульвар	бульвар Незалежності
Незалежності вулиця	вулиця Незалежності
Незалежності майдан	майдан Незалежності
Незалежності площа	площа Незалежності
Незалежності провулок	провулок Незалежності
Незалежності проспект	проспект Незалежності
Некрасова вулиця	вулиця Некрасова
Нескорених вулиця	вулиця Нескорених
Нестайка вулиця	вулиця Нестайка
Нестора Гаморака вулиця	вулиця Нестора Гаморака
Нестора Нижанківського вулиця	вулиця Нестора Нижанківського
Нечая вулиця	вулиця Нечая
Нечуя-Левицького вулиця	вулиця Нечуя-Левицького
Нижанківського вулиця	вулиця Нижанківського
Никифоряка вулиця	вулиця Никифоряка
Новаківського вулиця	вулиця Новаківського
Новгородського вулиця	вулиця Новгородського
Новий Світ вулиця	вулиця Новий Світ
Новоселиця вулиця	вулиця Новоселиця
Новоселів вулиця	вулиця Новоселів
Об’їздна вулиця	Обʼїздна вулиця
Об’їзна вулиця	Обʼїзна вулиця
Обліски вулиця	вулиця Обліски
Обозище вулиця	вулиця Обозище
Огарьова вулиця	вулиця Огарьова
Озаркевичів вулиця	вулиця Озаркевичів
Оксани Грицей вулиця	вулиця Оксани Грицей
Олега Ольжича вулиця	вулиця Олега Ольжича
Олександра Довженка вулиця	вулиця Олександра Довженка
Олександра Кукурби вулиця	вулиця Олександра Кукурби
Олександра Олеся вулиця	вулиця Олександра Олеся
Олександра Пархоменка вулиця	вулиця Олександра Пархоменка
Олександра Пушкіна вулиця	вулиця Олександра Пушкіна
Олександра Русина вулиця	вулиця Олександра Русина
Олександра Савицького вулиця	вулиця Олександра Савицького
Олександра Тисовського вулиця	вулиця Олександра Тисовського
Олекси Гірника вулиця	вулиця Олекси Гірника
Олекси Довбуша вулиця	вулиця Олекси Довбуша
Олекси Ковбуза вулиця	вулиця Олекси Ковбуза
Олекси Новаківського вулиця	вулиця Олекси Новаківського
Олекси Скалозуба вулиця	вулиця Олекси Скалозуба
Олексюка вулиця	вулиця Олексюка
Олени Кисілевської вулиця	вулиця Олени Кисілевської
Олени Кульчицької вулиця	вулиця Олени Кульчицької
Олени Михнюк вулиця	вулиця Олени Михнюк
Олени Пчілки вулиця	вулиця Олени Пчілки
Олени Степанівни вулиця	вулиця Олени Степанівни
Олени Степанівни провулок	провулок Олени Степанівни
Олеся вулиця	вулиця Олеся
Олеся Гончара вулиця	вулиця Олеся Гончара
Олійника вулиця	вулиця Олійника
Ольги Барчинської вулиця	вулиця Ольги Барчинської
Ольги Басараб вулиця	вулиця Ольги Басараб
Ольги Дучимінської вулиця	вулиця Ольги Дучимінської
Ольги Кисілевської вулиця	вулиця Ольги Кисілевської
Ольги Кобилянської вулиця	вулиця Ольги Кобилянської
Ольги Рошкевич вулиця	вулиця Ольги Рошкевич
Ольги Щерби вулиця	вулиця Ольги Щерби
Ольжича вулиця	вулиця Ольжича
Омнога вулиця	вулиця Омнога
Опанаса Заливахи вулиця	вулиця Опанаса Заливахи
Опільського вулиця	вулиця Опільського
Опришків вулиця	вулиця Опришків
Орищака вулиця	вулиця Орищака
Осада Червона вулиця	вулиця Осада Червона
Осередок вулиця	вулиця Осередок
Осипа Куриласа вулиця	вулиця Осипа Куриласа
Осипа Маковея вулиця	вулиця Осипа Маковея
Осипа Назарука провулок	провулок Осипа Назарука
Осипа Сорохтея вулиця	вулиця Осипа Сорохтея
Осипа Турянського вулиця	вулиця Осипа Турянського
Осмомисла вулиця	вулиця Осмомисла
Остапа Вишні вулиця	вулиця Остапа Вишні
Остапа Терлецького вулиця	вулиця Остапа Терлецького
Островського вулиця	вулиця Островського
Отамана Семена Горука вулиця	вулиця Отамана Семена Горука
Отця Бабина вулиця	вулиця Отця Бабина
Отця Володимира Сухого вулиця	вулиця Отця Володимира Сухого
Отця Івана Блавацького вулиця	вулиця Отця Івана Блавацького
Отця Миколи Капустинського вулиця	вулиця Отця Миколи Капустинського
Отця Михайла Косила вулиця	вулиця Отця Михайла Косила
Отця Поповича вулиця	вулиця Отця Поповича
П’ядицька вулиця	Пʼядицька вулиця
Павла Бабійчука вулиця	вулиця Павла Бабійчука
Павла Полуботка вулиця	вулиця Павла Полуботка
Павла Скоропадського вулиця	вулиця Павла Скоропадського
Павла Тичини вулиця	вулиця Павла Тичини
Павла Чубинського вулиця	вулиця Павла Чубинського
Павлика вулиця	вулиця Павлика
Павлика провулок	провулок Павлика
Павлова вулиця	вулиця Павлова
Павлусевича вулиця	вулиця Павлусевича
Павлюка вулиця	вулиця Павлюка
Палія вулиця	вулиця Палія
Пам'яті вулиця	вулиця Памʼяті
Панаса Мирного вулиця	вулиця Панаса Мирного
Пароха Костянтина Балицького вулиця	вулиця Пароха Костянтина Балицького
Пархоменка вулиця	вулиця Пархоменка
Патона вулиця	вулиця Патона
Патріарха Володимира вулиця	вулиця Патріарха Володимира
Патріарха Йосипа Сліпого вулиця	вулиця Патріарха Йосипа Сліпого
Патрієва вулиця	вулиця Патрієва
Патрійчука вулиця	вулиця Патрійчука
Пачовського вулиця	вулиця Пачовського
Пашницького вулиця	вулиця Пашницького
Перемоги вулиця	вулиця Перемоги
Перемоги провулок	провулок Перемоги
Перуцького вулиця	вулиця Перуцького
Петлюри вулиця	вулиця Петлюри
Петра Андрусіва вулиця	вулиця Петра Андрусіва
Петра Василишина вулиця	вулиця Петра Василишина
Петра Васкула вулиця	вулиця Петра Васкула
Петра Васкули вулиця	вулиця Петра Васкули
Петра Дорошенка вулиця	вулиця Петра Дорошенка
Петра Калнишевського вулиця	вулиця Петра Калнишевського
Петра Калнишевського провулок	провулок Петра Калнишевського
Петра Козланюка вулиця	вулиця Петра Козланюка
Петра Майстра вулиця	вулиця Петра Майстра
Петра Могили вулиця	вулиця Петра Могили
Петра Ніщинського вулиця	вулиця Петра Ніщинського
Петра Сагайдачного вулиця	вулиця Петра Сагайдачного
Петра Чайковського вулиця	вулиця Петра Чайковського
Петраша вулиця	вулиця Петраша
Петрушевича вулиця	вулиця Петрушевича
Пилипа Орлика вулиця	вулиця Пилипа Орлика
Пирогова вулиця	вулиця Пирогова
Підберег вулиця	вулиця Підберег
Підгір’я вулиця	вулиця Підгірʼя
Підгірка вулиця	вулиця Підгірка
Підгірянки вулиця	вулиця Підгірянки
Підгора вулиця	вулиця Підгора
Підгребінь вулиця	вулиця Підгребінь
Підділ вулиця	вулиця Підділ
Підзамок вулиця	вулиця Підзамок
Підзамче вулиця	вулиця Підзамче
Підкова вулиця	вулиця Підкова
Підкови вулиця	вулиця Підкови
Підлісся вулиця	вулиця Підлісся
Підмарика вулиця	вулиця Підмарика
Підріг вулиця	вулиця Підріг
Пінки вулиця	вулиця Пінки
Пісецького вулиця	вулиця Пісецького
Плав’юка вулиця	вулиця Плавʼюка
Плебанія вулиця	вулиця Плебанія
Плешкана вулиця	вулиця Плешкана
Площа Івана Франка	площа Івана Франка
Площа Ринок вулиця	вулиця Площа Ринок
Площа Роксолани	площа Роксолани
Повстанців вулиця	вулиця Повстанців
Покрова вулиця	вулиця Покрова
Полідовича вулиця	вулиця Полідовича
Полковника Василя Андрусяка вулиця	вулиця Полковника Василя Андрусяка
Полковника Грома вулиця	вулиця Полковника Грома
Полковника Морозенка вулиця	вулиця Полковника Морозенка
Полковника Різуна-Грегіта вулиця	вулиця Полковника Різуна-Грегіта
Полковника Семена Палія вулиця	вулиця Полковника Семена Палія
Полковника Топоровського вулиця	вулиця Полковника Топоровського
Полотнюків вулиця	вулиця Полотнюків
Полуботка вулиця	вулиця Полуботка
Поляна вулиця	вулиця Поляна
Помаранчевої революції вулиця	вулиця Помаранчевої Революції
Помірки вулиця	вулиця Помірки
Попадюка вулиця	вулиця Попадюка
Попереччина вулиця	вулиця Попереччина
Попова вулиця	вулиця Попова
Поповича вулиця	вулиця Поповича
Потоцького вулиця	вулиця Потоцького
Правди вулиця	вулиця Правди
Пржевальського вулиця	вулиця Пржевальського
Прийми вулиця	вулиця Прийми
Причіл вулиця	вулиця Причіл
Пріски вулиця	вулиця Пріски
Прокіпчука вулиця	вулиця Прокіпчука
Прокопа Мостовича вулиця	вулиця Прокопа Мостовича
Прокопівка вулиця	вулиця Прокопівка
Прокоповича вулиця	вулиця Прокоповича
Просвіти вулиця	вулиця Просвіти
Професора Богдана Левицького вулиця	вулиця Професора Богдана Левицького
Професора Івана Горбачевського вулиця	вулиця Професора Івана Горбачевського
Професора Пулюя вулиця	вулиця Професора Пулюя
Проценка вулиця	вулиця Проценка
Прошака вулиця	вулиця Прошака
Прут вулиця	вулиця Прут
Пстрака вулиця	вулиця Пстрака
Пулюя вулиця	вулиця Пулюя
Пушкіна вулиця	вулиця Пушкіна
Пчілки вулиця	вулиця Пчілки
Радіщева вулиця	вулиця Радіщева
Радова Ліва вулиця	вулиця Радова Ліва
Радова Права вулиця	вулиця Радова Права
Рамішвіллі вулиця	вулиця Рамішвіллі
Рафайловець вулиця	вулиця Рафайловець
Реміснича вулиця	вулиця Реміснича
Решетів провулок	провулок Решетів
Рєпіна вулиця	вулиця Рєпіна
Рилєєва вулиця	вулиця Рилєєва
Рильського вулиця	вулиця Рильського
Римика вулиця	вулиця Римика
Ринок вулиця	вулиця Ринок
Ринок площа	площа Ринок
Різдва майдан	майдан Різдва
Річки вулиця	вулиця Річки
Робітнича вулиця	вулиця Робітнича
Роговиця вулиця	вулиця Роговиця
Родини Крушельницьких вулиця	вулиця Родини Крушельницьких
Родини Кузьми вулиця	вулиця Родини Кузьми
Родини Окуневських вулиця	вулиця Родини Окуневських
Рожанського вулиця	вулиця Рожанського
Роксолани вулиця	вулиця Роксолани
Роксолани площа	площа Роксолани
Романа Гурика вулиця	вулиця Романа Гурика
Романа Іваничука вулиця	вулиця Романа Іваничука
Романа Купчинського вулиця	вулиця Романа Купчинського
Романа Левицького вулиця	вулиця Романа Левицького
Романа Рубінгера вулиця	вулиця Романа Рубінгера
Романа Ставничого вулиця	вулиця Романа Ставничого
Романа Шипайла вулиця	вулиця Романа Шипайла
Романа Шухевича вулиця	вулиця Романа Шухевича
Романа Яросевича вулиця	вулиця Романа Яросевича
Ромена Роллана вулиця	вулиця Ромена Роллана
Ропша вулиця	вулиця Ропша
Рубінгера вулиця	вулиця Рубінгера
Рубчака вулиця	вулиця Рубчака
Руданського вулиця	вулиця Руданського
Рудика вулиця	вулиця Рудика
Руднева вулиця	вулиця Руднева
Руднєва вулиця	вулиця Руднєва
Рудннєва вулиця	вулиця Рудннєва
Савчукова вулиця	вулиця Савчукова
Сагайдачних вулиця	вулиця Сагайдачних
Сагайдачного вулиця	вулиця Сагайдачного
Садівнича вулиця	вулиця Садівнича
Садовиченка вулиця	вулиця Садовиченка
Салатрук вулиця	вулиця Салатрук
Самійленка вулиця	вулиця Самійленка
Сахарова вулиця	вулиця Сахарова
Свободи вулиця	вулиця Свободи
Свободи площа	площа Свободи
Святого Володимира вулиця	вулиця Святого Володимира
Святого Миколая вулиця	вулиця Святого Миколая
Святої Варвари вулиця	вулиця Святої Варвари
Святослава Гординського вулиця	вулиця Святослава Гординського
Святослава Пахолківа вулиця	вулиця Святослава Пахолківа
Северина Наливайка вулиця	вулиця Северина Наливайка
Северина Наливайка провулок	провулок Северина Наливайка
Северина Снігуровича вулиця	вулиця Северина Снігуровича
Семена Височана вулиця	вулиця Семена Височана
Семена Горука вулиця	вулиця Семена Горука
Семена Гулака-Артемовського вулиця	вулиця Семена Гулака-Артемовського
Семена Палія вулиця	вулиця Семена Палія
Семена Соломчака вулиця	вулиця Семена Соломчака
Семенюка вулиця	вулиця Семенюка
Семчука вулиця	вулиця Семчука
Серафимовича вулиця	вулиця Серафимовича
Сергія Городецького вулиця	вулиця Сергія Городецького
Сергія Дідича вулиця	вулиця Сергія Дідича
Сєченова вулиця	вулиця Сєченова
Сиглова вулиця	вулиця Сиглова
Сидора Воробкевича вулиця	вулиця Сидора Воробкевича
Сильвестра Яричевського вулиця	вулиця Сильвестра Яричевського
Симиренка вулиця	вулиця Симиренка
Симиренків вулиця	вулиця Симиренків
Симона Петлюри вулиця	вулиця Симона Петлюри
Симоненка вулиця	вулиця Симоненка
Синенкова вулиця	вулиця Синенкова
Синяка вулиця	вулиця Синяка
Сільвестра Сембратовича вулиця	вулиця Сільвестра Сембратовича
Сірика вулиця	вулиця Сірика
Сірка вулиця	вулиця Сірка
Сірка провулок	провулок Сірка
Січинського вулиця	вулиця Січинського
Січових стрільців вулиця	вулиця Січових Стрільців
Січових Стрільців вулиця	вулиця Січових Стрільців
Січових Стрільців майдан	майдан Січових Стрільців
Січових Стрільців провулок	провулок Січових Стрільців
Сковороди вулиця	вулиця Сковороди
Скородинського вулиця	вулиця Скородинського
Скрипника вулиця	вулиця Скрипника
Скульського вулиця	вулиця Скульського
Слави вулиця	вулиця Слави
Слави Стецько вулиця	вулиця Слави Стецько
Слобода вулиця	вулиця Слобода
Слов’янська вулиця	Словʼянська вулиця
Смеречанського вулиця	вулиця Смеречанського
Смольського вулиця	вулиця Смольського
Соколовської вулиця	вулиця Соколовської
Солов'їна вулиця	Соловʼїна вулиця
Солоджука вулиця	вулиця Солоджука
Сороханка вулиця	вулиця Сороханка
Сосюри вулиця	вулиця Сосюри
Сотника Орлика вулиця	вулиця Сотника Орлика
Сотника Павлюка вулиця	вулиця Сотника Павлюка
Сотника Палієва вулиця	вулиця Сотника Палієва
Сотника Сергія Дідича вулиця	вулиця Сотника Сергія Дідича
Сотника Теодора Мартинця вулиця	вулиця Сотника Теодора Мартинця
Сотні Білого вулиця	вулиця Сотні Білого
Сотні Гамалії вулиця	вулиця Сотні Гамалії
Сотні Кривоноса вулиця	вулиця Сотні Кривоноса
Сотні Мороза вулиця	вулиця Сотні Мороза
Сотні Спартака вулиця	вулиця Сотні Спартака
Сотні Спартана вулиця	вулиця Сотні Спартана
Софії Галечко вулиця	вулиця Софії Галечко
Софіївка вулиця	вулиця Софіївка
Софрона Дмитерка вулиця	вулиця Софрона Дмитерка
Софрона Недільського вулиця	вулиця Софрона Недільського
Сохацького вулиця	вулиця Сохацького
Спартака вулиця	вулиця Спартака
Спартана вулиця	вулиця Спартана
Срібняка вулиця	вулиця Срібняка
Ставничого вулиця	вулиця Ставничого
Станіслава Людкевича вулиця	вулиця Станіслава Людкевича
Станіславського вулиця	вулиця Станіславського
Стара Дорога вулиця	вулиця Стара Дорога
Старицьких вулиця	вулиця Старицьких
Старицького вулиця	вулиця Старицького
Степана Бандери вулиця	вулиця Степана Бандери
Степана Бурдина вулиця	вулиця Степана Бурдина
Степана Васильченка вулиця	вулиця Степана Васильченка
Степана Воробця вулиця	вулиця Степана Воробця
Степана Ленкавського вулиця	вулиця Степана Ленкавського
Степана Радиша вулиця	вулиця Степана Радиша
Степана Руданського вулиця	вулиця Степана Руданського
Степана Стефурака вулиця	вулиця Степана Стефурака
Степана Сулятицького вулиця	вулиця Степана Сулятицького
Степана Тарабалки вулиця	вулиця Степана Тарабалки
Степанюка вулиця	вулиця Степанюка
Стефаника вулиця	вулиця Стефаника
Стефановичів вулиця	вулиця Стефановичів
Стефініних вулиця	вулиця Стефініних
Стефурака вулиця	вулиця Стефурака
Стеценка вулиця	вулиця Стеценка
Страчених вулиця	вулиця Страчених
Страчених Націоналістів вулиця	вулиця Страчених Націоналістів
Стрілецької Слави вулиця	вулиця Стрілецької Слави
Стуса вулиця	вулиця Стуса
Сухомлинського вулиця	вулиця Сухомлинського
Сушинського вулиця	вулиця Сушинського
Тадань вулиця	вулиця Тадань
Танкістів вулиця	вулиця Танкістів
Тараса Мельничука вулиця	вулиця Тараса Мельничука
Тараса Чупринки вулиця	вулиця Тараса Чупринки
Тараса Шевченка вулиця	вулиця Тараса Шевченка
Тараса Шевченка майдан	майдан Тараса Шевченка
Тараса Шевченка площа	площа Тараса Шевченка
Тараса Шевченка провулок	провулок Тараса Шевченка
Тарнавського вулиця	вулиця Тарнавського
Творимір вулиця	вулиця Творимір
Телев’яка вулиця	вулиця Телевʼяка
Теліщука вулиця	вулиця Теліщука
Теодора Примака вулиця	вулиця Теодора Примака
Теодора Цьоклера вулиця	вулиця Теодора Цьоклера
Теофіла Бедрія вулиця	вулиця Теофіла Бедрія
Теофіла Грушкевича вулиця	вулиця Теофіла Грушкевича
Терешкової вулиця	вулиця Терешкової
Терпеливця вулиця	вулиця Терпеливця
Тесленка вулиця	вулиця Тесленка
Тирси вулиця	вулиця Тирси
Титаренка вулиця	вулиця Титаренка
Титова вулиця	вулиця Титова
Тихого вулиця	вулиця Тихого
Тичини вулиця	вулиця Тичини
Тіниста вулиця	вулиця Тіниста
Ткачука вулиця	вулиця Ткачука
Тобілевича вулиця	вулиця Тобілевича
Толстого вулиця	вулиця Толстого
Томашівського вулиця	вулиця Томашівського
Томинових вулиця	вулиця Томинових
Топоровського вулиця	вулиця Топоровського
Торговиця вулиця	вулиця Торговиця
Трачів вулиця	вулиця Трачів
Трублаїні вулиця	вулиця Трублаїні
Труша вулиця	вулиця Труша
Трушкевича вулиця	вулиця Трушкевича
Тур’янська вулиця	Турʼянська вулиця
Турковичі вулиця	вулиця Турковичі
Тушкова вулиця	вулиця Тушкова
Тютюнника вулиця	вулиця Тютюнника
Угрина Безгрішного вулиця	вулиця Угрина Безгрішного
Українських Героїв вулиця	вулиця Українських Героїв
Українських Декабристів вулиця	вулиця Українських Декабристів
Української Дивізії вулиця	вулиця Української Дивізії
Української Перемоги вулиця	вулиця Української Перемоги
Уляни Кравченко вулиця	вулиця Уляни Кравченко
УПА вулиця	вулиця УПА
Урочище Береги	урочище Береги
урочище водоканал	урочище Водоканал
Урочище Женець	урочище Женець
Урочище Кам'янка	урочище Камʼянка
Устима Кармелюка вулиця	вулиця Устима Кармелюка
Ушинського вулиця	вулиця Ушинського
Фегонівка вулиця	вулиця Фегонівка
Федика вулиця	вулиця Федика
Федора Достоєвського вулиця	вулиця Федора Достоєвського
Федорченка вулиця	вулиця Федорченка
Федченка вулиця	вулиця Федченка
Федьковича вулиця	вулиця Федьковича
Федяя вулиця	вулиця Федяя
Філатова вулиця	вулиця Філатова
Фільварки вулиця	вулиця Фільварки
Франка вулиця	вулиця Франка
Франка Івана вулиця	вулиця Івана Франка
Францішека Карпіньського вулиця	вулиця Францішека Карпіньського
Фредеріка Шопена вулиця	вулиця Фредеріка Шопена
Хвильового вулиця	вулиця Хвильового
Хіміків вулиця	вулиця Хіміків
Хліборобів вулиця	вулиця Хліборобів
Хмельницького вулиця	вулиця Хмельницького
Хмельова друга вулиця	2-га Хмельова вулиця
Хмельова П’ята вулиця	5-та Хмельова вулиця
Хмельова перша вулиця	1-ша Хмельова вулиця
Хмельова третя вулиця	3-тя Хмельова вулиця
Хмельова четверта вулиця	4-та Хмельова вулиця
Хомишина вулиця	вулиця Хомишина
Хоткевича вулиця	вулиця Хоткевича
Храпливого вулиця	вулиця Храпливого
Царицина вулиця	вулиця Царицина
Цеглинського вулиця	вулиця Цеглинського
Центр вулиця	вулиця Центр
Циганівка вулиця	вулиця Циганівка
Цикалівка вулиця	вулиця Цикалівка
Ципки вулиця	вулиця Ципки
Ціолковського вулиця	вулиця Ціолковського
Чабанівка вулиця	вулиця Чабанівка
Чайки вулиця	вулиця Чайки
Чайковського вулиця	вулиця Чайковського
Чайковського провулок	провулок Чайковського
Чапаєва вулиця	вулиця Чапаєва
Чатового Бурі вулиця	вулиця Чатового Бурі
Челюскінців вулиця	вулиця Челюскінців
Чепаш вулиця	вулиця Чепаш
Черемшини вулиця	вулиця Черемшини
Черепкова вулиця	вулиця Черепкова
Черниша вулиця	вулиця Черниша
Чернишевського вулиця	вулиця Чернишевського
Чертіж вулиця	вулиця Чертіж
Чехова вулиця	вулиця Чехова
Чигри вулиця	вулиця Чигри
Чкалова вулиця	вулиця Чкалова
Чорнобривого вулиця	вулиця Чорнобривого
Чорновола вулиця	вулиця Чорновола
Чорновола провулок	провулок Чорновола
Чорновола проспект	проспект Чорновола
Чотового Бурі вулиця	вулиця Чотового Бурі
Чубинського вулиця	вулиця Чубинського
Чумака вулиця	вулиця Чумака
Чупрея вулиця	вулиця Чупрея
Шандарівка вулиця	вулиця Шандарівка
Шанковських вулиця	вулиця Шанковських
Шарлая вулиця	вулиця Шарлая
Шашкевича вулиця	вулиця Шашкевича
Шевченка Бічна вулиця	бічна вулиця Шевченка
Шевченка вулиця	вулиця Шевченка
Шевченка майдан	майдан Шевченка
Шевченка провулок	провулок Шевченка
Шепаровича вулиця	вулиця Шепаровича
Шептицького вулиця	вулиця Шептицького
Шептицького майдан	майдан Шептицького
Шеремети вулиця	вулиця Шеремети
Шеремети Петра вулиця	вулиця Петра Шеремети
Шеші вулиця	вулиця Шеші
Шкрібляка вулиця	вулиця Шкрібляка
Шкрумеляка вулиця	вулиця Шкрумеляка
Шопена вулиця	вулиця Шопена
Шота Руставелі вулиця	вулиця Шота Руставелі
Шуткова вулиця	вулиця Шуткова
Шухевича вулиця	вулиця Шухевича
Шухевичів вулиця	вулиця Шухевичів
Щорса вулиця	вулиця Щорса
Юліана Панькевича вулиця	вулиця Юліана Панькевича
Юліана Целевича вулиця	вулиця Юліана Целевича
Юлії Бачинської вулиця	вулиця Юлії Бачинської
Юлії Солдак вулиця	вулиця Юлії Солдак
Юлія Олесницького вулиця	вулиця Юлія Олесницького
Юності вулиця	вулиця Юності
Юрія Бундзяка вулиця	вулиця Юрія Бундзяка
Юрія Гагаріна вулиця	вулиця Юрія Гагаріна
Юрія Дрогобича вулиця	вулиця Юрія Дрогобича
Юрія Іллєнка вулиця	вулиця Юрія Іллєнка
Юрія Кибальчича вулиця	вулиця Юрія Кибальчича
Юрія Неміша вулиця	вулиця Юрія Неміша
Юрія Рогатинця вулиця	вулиця Юрія Рогатинця
Юрія Федьковича вулиця	вулиця Юрія Федьковича
Юрія Шкрібляка вулиця	вулиця Юрія Шкрібляка
Юрія Шкрумеляка вулиця	вулиця Юрія Шкрумеляка
Юрківка вулиця	вулиця Юрківка
Юрчишина вулиця	вулиця Юрчишина
Юхвітова вулиця	вулиця Юхвітова
Яворницького вулиця	вулиця Яворницького
Яківчика вулиця	вулиця Яківчика
Якіра вулиця	вулиця Якіра
Якова Головацького вулиця	вулиця Якова Головацького
Якова Оренштайна вулиця	вулиця Якова Оренштайна
Ялинка вулиця	вулиця Ялинка
Яремчука вулиця	вулиця Яремчука
Ярицького вулиця	вулиця Ярицького
Яричевського вулиця	вулиця Яричевського
Ярослава Барнича вулиця	вулиця Ярослава Барнича
Ярослава Веселовського вулиця	вулиця Ярослава Веселовського
Ярослава Винничука вулиця	вулиця Ярослава Винничука
Ярослава Галана вулиця	вулиця Ярослава Галана
Ярослава Карпінця вулиця	вулиця Ярослава Карпінця
Ярослава Косарчина вулиця	вулиця Ярослава Косарчина
Ярослава Лукавецького вулиця	вулиця Ярослава Лукавецького
Ярослава Мартинця вулиця	вулиця Ярослава Мартинця
Ярослава Мудрого вулиця	вулиця Ярослава Мудрого
Ярослава Осмомисла вулиця	вулиця Ярослава Осмомисла
Ярослава Осьмомисла вулиця	вулиця Ярослава Осьмомисла
Ярослава Пстрака вулиця	вулиця Ярослава Пстрака
Ярослава Стецько вулиця	вулиця Ярослава Стецько
Ярослава Фенка вулиця	вулиця Ярослава Фенка
Ярослави Стецько вулиця	вулиця Ярослави Стецько
Яршиця вулиця	вулиця Яршиця
Ясінських вулиця	вулиця Ясінських
Яцишина вулиця	вулиця Яцишина
Яцука вулиця	вулиця Яцука
XXV з'їзду КПРС вулиця	вулиця XXV Зʼїзду КПРС