провулок Крилова 1-й                      	1-й провулок Крилова
Лермонтова 1-й провулок                   	1-й провулок Лермонтова
1-й Чехова провулок                       	1-й провулок Чехова
1-й Східно-дальній провулок               	1-й Східно-Дальній провулок
Перша вулиця                              	1-ша вулиця
1-а Ентузіастів вулиця                    	1-ша вулиця Ентузіастів
1-а Газопровідна вулиця                   	1-ша Газопровідна вулиця
1-а Дамбова вулиця                        	1-ша Дамбова вулиця
1-а Залізнична вулиця                     	1-ша Залізнична вулиця
1-а Канальна вулиця                       	1-ша Канальна вулиця
1-а лінія                                 	1-ша лінія
1-а «А» лінія                             	1-ша лінія А
1-а Лугова вулиця                         	1-ша Лугова вулиця
1-а Набережна вулиця                      	1-ша Набережна вулиця
1-а Нова вулиця                           	1-ша Нова вулиця
1-а Озерна вулиця                         	1-ша Озерна вулиця
1-а Південна вулиця                       	1-ша Південна вулиця
1-а Північна вулиця                       	1-ша Північна вулиця
1-а Поперечна вулиця                      	1-ша Поперечна вулиця
1-а Приозерна вулиця                      	1-ша Приозерна вулиця
1-а Продольна вулиця                      	1-ша Продольна вулиця
1-а Садова вулиця                         	1-ша Садова вулиця
1-а Синьоозерна вулиця                    	1-ша Синьоозерна вулиця
1-а Східна вулиця                         	1-ша Східна вулиця
10-а Абрикосова вулиця                    	10-та Абрикосова вулиця
10-а Ентузіастів вулиця                   	10-та вулиця Ентузіастів
10-а Канальна вулиця                      	10-та Канальна вулиця
10-а лінія                                	10-та лінія
10-а Лугова вулиця                        	10-та Лугова вулиця
10-а Набережна вулиця                     	10-та Набережна вулиця
10-а Садова вулиця                        	10-та Садова вулиця
100-а Садова вулиця                       	100-та Садова вулиця
101-а Садова вулиця                       	101-ша Садова вулиця
102-а Садова вулиця                       	102-га Садова вулиця
103-я Садова вулиця                       	103-тя Садова вулиця
104-а Садова вулиця                       	104-та Садова вулиця
105-а Садова вулиця                       	105-та Садова вулиця
106-а Садова вулиця                       	106-та Садова вулиця
107-а Садова вулиця                       	107-ма Садова вулиця
108-а Садова вулиця                       	108-ма Садова вулиця
109-а Садова вулиця                       	109-та Садова вулиця
11-а Абрикосова вулиця                    	11-та Абрикосова вулиця
11-а Ентузіастів вулиця                   	11-та вулиця Ентузіастів
11-а Канальна вулиця                      	11-та Канальна вулиця
11-а лінія                                	11-та лінія
11-а Лугова вулиця                        	11-та Лугова вулиця
11-а Набережна вулиця                     	11-та Набережна вулиця
11-а Садова вулиця                        	11-та Садова вулиця
110-а Садова вулиця                       	110-та Садова вулиця
111-а Садова вулиця                       	111-та Садова вулиця
112-а Садова вулиця                       	112-та Садова вулиця
113-а Садова вулиця                       	113-та Садова вулиця
114-а Садова вулиця                       	114-та Садова вулиця
115-а Садова вулиця                       	115-та Садова вулиця
116-а Садова вулиця                       	116-та Садова вулиця
117-а Садова вулиця                       	117-та Садова вулиця
118-а Садова вулиця                       	118-та Садова вулиця
119-а Садова вулиця                       	119-та Садова вулиця
12-а Абрикосова вулиця                    	12-та Абрикосова вулиця
12-а Ентузіастів вулиця                   	12-та вулиця Ентузіастів
12-а лінія                                	12-та лінія
12-а Лугова вулиця                        	12-та Лугова вулиця
12-а Набережна вулиця                     	12-та Набережна вулиця
12-а Садова вулиця                        	12-та Садова вулиця
120-а Садова вулиця                       	120-та Садова вулиця
121-а Садова вулиця                       	121-ша Садова вулиця
122-а Садова вулиця                       	122-га Садова вулиця
123-я Садова вулиця                       	123-тя Садова вулиця
124-а Садова вулиця                       	124-та Садова вулиця
125-а Садова вулиця                       	125-та Садова вулиця
126-а Садова вулиця                       	126-та Садова вулиця
127-а Садова вулиця                       	127-ма Садова вулиця
128-а Садова вулиця                       	128-ма Садова вулиця
129-а Садова вулиця                       	129-та Садова вулиця
13-а Ентузіастів вулиця                   	13-та вулиця Ентузіастів
13-а лінія                                	13-та лінія
13-а Лугова вулиця                        	13-та Лугова вулиця
13-а Набережна вулиця                     	13-та Набережна вулиця
13-а Садова вулиця                        	13-та Садова вулиця
130-а Садова вулиця                       	130-та Садова вулиця
131-а Садова вулиця                       	131-ша Садова вулиця
132-а Садова вулиця                       	132-га Садова вулиця
133-я Садова вулиця                       	133-тя Садова вулиця
134-а Садова вулиця                       	134-та Садова вулиця
135-а Садова вулиця                       	135-та Садова вулиця
136-а Садова вулиця                       	136-та Садова вулиця
137-а Садова вулиця                       	137-ма Садова вулиця
138-а Садова вулиця                       	138-ма Садова вулиця
139-а Садова вулиця                       	139-та Садова вулиця
14-а Ентузіастів вулиця                   	14-та вулиця Ентузіастів
14-а лінія                                	14-та лінія
14-а Лугова вулиця                        	14-та Лугова вулиця
14-а Набережна вулиця                     	14-та Набережна вулиця
14-а Садова вулиця                        	14-та Садова вулиця
15-а Ентузіастів вулиця                   	15-та вулиця Ентузіастів
15-а лінія                                	15-та лінія
15-а Набережна вулиця                     	15-та Набережна вулиця
15-а Садова вулиця                        	15-та Садова вулиця
150-а Садова вулиця                       	150-та Садова вулиця
153-я Садова вулиця                       	153-тя Садова вулиця
154-а Садова вулиця                       	154-та Садова вулиця
155-а Садова вулиця                       	155-та Садова вулиця
156-а Садова вулиця                       	156-та Садова вулиця
157-а Садова вулиця                       	157-ма Садова вулиця
158-а Садова вулиця                       	158-ма Садова вулиця
159-а Садова вулиця                       	159-та Садова вулиця
16-а Ентузіастів вулиця                   	16-та вулиця Ентузіастів
16-а Набережна вулиця                     	16-та Набережна вулиця
16-а Садова вулиця                        	16-та Садова вулиця
160-а Садова вулиця                       	160-та Садова вулиця
161-а Садова вулиця                       	161-ша Садова вулиця
162-а Садова вулиця                       	162-га Садова вулиця
163-я Садова вулиця                       	163-тя Садова вулиця
164-а Садова вулиця                       	164-та Садова вулиця
165-а Садова вулиця                       	165-та Садова вулиця
166-а Садова вулиця                       	166-та Садова вулиця
167-а Садова вулиця                       	167-ма Садова вулиця
168-а Садова вулиця                       	168-ма Садова вулиця
169-а Садова вулиця                       	169-та Садова вулиця
17-а Набережна вулиця                     	17-та Набережна вулиця
17-а Садова вулиця                        	17-та Садова вулиця
18-а Набережна вулиця                     	18-та Набережна вулиця
18-а Садова вулиця                        	18-та Садова вулиця
182-а Садова вулиця                       	182-га Садова вулиця
183-я Садова вулиця                       	183-тя Садова вулиця
19-а Садова вулиця                        	19-та Садова вулиця
191-а Садова вулиця                       	191-ша Садова вулиця
192-а Садова вулиця                       	192-га Садова вулиця
193-я Садова вулиця                       	193-тя Садова вулиця
2-а Абрикосова вулиця                     	2-га Абрикосова вулиця
Друга вулиця                              	2-га вулиця
2-а Ентузіастів вулиця                    	2-га вулиця Ентузіастів
2-а Газопровідна вулиця                   	2-га Газопровідна вулиця
2-а Дамбова вулиця                        	2-га Дамбова вулиця
2-а Залізнична вулиця                     	2-га Залізнична вулиця
2-а Канальна вулиця                       	2-га Канальна вулиця
2-а лінія                                 	2-га лінія
2-а Лугова вулиця                         	2-га Лугова вулиця
2-а Набережна вулиця                      	2-га Набережна вулиця
2-а Нова вулиця                           	2-га Нова вулиця
2-а Озерна вулиця                         	2-га Озерна вулиця
2-а Південна вулиця                       	2-га Південна вулиця
2-а Північна вулиця                       	2-га Північна вулиця
2-а Поперечна вулиця                      	2-га Поперечна вулиця
2-а Приозерна вулиця                      	2-га Приозерна вулиця
2-а Продольна вулиця                      	2-га Продольна вулиця
2-а Садова вулиця                         	2-га Садова вулиця
2-а Синьоозерна вулиця                    	2-га Синьоозерна вулиця
2-а Східна вулиця                         	2-га Східна вулиця
провулок Крилова 2-й                      	2-й провулок Крилова
2-й Лермонтова провулок                   	2-й провулок Лермонтова
2-й Чехова провулок                       	2-й провулок Чехова
2-й Східно-дальній провулок               	2-й Східно-Дальній провулок
20-а Садова вулиця                        	20-та Садова вулиця
200-а Садова вулиця                       	200-та Садова вулиця
201-а Садова вулиця                       	201-ша Садова вулиця
202-а Садова вулиця                       	202-га Садова вулиця
203-я Садова вулиця                       	203-тя Садова вулиця
204-а Садова вулиця                       	204-та Садова вулиця
205-а Садова вулиця                       	205-та Садова вулиця
206-а Садова вулиця                       	206-та Садова вулиця
207-а Садова вулиця                       	207-ма Садова вулиця
208-а Садова вулиця                       	208-ма Садова вулиця
209-а Садова вулиця                       	209-та Садова вулиця
21-а Садова вулиця                        	21-ша Садова вулиця
213-а Садова вулиця                       	213-тя Садова вулиця
22-а Садова вулиця                        	22-га Садова вулиця
23-я Садова вулиця                        	23-тя Садова вулиця
24-а Садова вулиця                        	24-та Садова вулиця
25-а Садова вулиця                        	25-та Садова вулиця
26-а Садова вулиця                        	26-та Садова вулиця
27-а Садова вулиця                        	27-ма Садова вулиця
28-а Садова вулиця                        	28-ма Садова вулиця
29-а Садова вулиця                        	29-та Садова вулиця
провулок Крилова 3-й                      	3-й провулок Крилова
3-й Лермонтова провулок                   	3-й провулок Лермонтова
3-й Маршака провулок                      	3-й провулок Маршака
3-й Східно-дальній провулок               	3-й Східно-Дальній провулок
Третя вулиця                              	3-тя вулиця
3-я Ентузіастів вулиця                    	3-тя вулиця Ентузіастів
3-я Газопровідна вулиця                   	3-тя Газопровідна вулиця
3-я Дамбова вулиця                        	3-тя Дамбова вулиця
3-а Дачна вулиця                          	3-тя Дачна вулиця
3-я Залізнична вулиця                     	3-тя Залізнична вулиця
3-я Канальна вулиця                       	3-тя Канальна вулиця
3-я лінія                                 	3-тя лінія
3-я Лугова вулиця                         	3-тя Лугова вулиця
3-я Набережна вулиця                      	3-тя Набережна вулиця
3-я Нова вулиця                           	3-тя Нова вулиця
3-я Озерна вулиця                         	3-тя Озерна вулиця
3-я Поперечна вулиця                      	3-тя Поперечна вулиця
3-я Приозерна вулиця                      	3-тя Приозерна вулиця
3-я Садова вулиця                         	3-тя Садова вулиця
3-я Синьоозерна вулиця                    	3-тя Синьоозерна вулиця
3-я Східна вулиця                         	3-тя Східна вулиця
30-а Садова вулиця                        	30-та Садова вулиця
31-а Садова вулиця                        	31-ша Садова вулиця
32-а Садова вулиця                        	32-га Садова вулиця
33-я Садова вулиця                        	33-тя Садова вулиця
34-а Садова вулиця                        	34-та Садова вулиця
35-а Садова вулиця                        	35-та Садова вулиця
36-а Садова вулиця                        	36-та Садова вулиця
37-а Садова вулиця                        	37-ма Садова вулиця
39-а Садова вулиця                        	39-та Садова вулиця
4-й Східно-дальній провулок               	4-й Східно-Дальній провулок
4-а Абрикосова вулиця                     	4-та Абрикосова вулиця
Четверта вулиця                           	4-та вулиця
4-а Газопровідна вулиця                   	4-та Газопровідна вулиця
4-а Ентузіастів вулиця                    	4-та Ентузіастів вулиця
4-а Залізнична вулиця                     	4-та Залізнична вулиця
4-а Канальна вулиця                       	4-та Канальна вулиця
4-а лінія                                 	4-та лінія
4-а Лугова вулиця                         	4-та Лугова вулиця
4-а Набережна вулиця                      	4-та Набережна вулиця
4-а Нова вулиця                           	4-та Нова вулиця
4-а Озерна вулиця                         	4-та Озерна вулиця
4-а Поперечна вулиця                      	4-та Поперечна вулиця
4-а Приозерна вулиця                      	4-та Приозерна вулиця
4-а Садова вулиця                         	4-та Садова вулиця
4-а Синьоозерна вулиця                    	4-та Синьоозерна вулиця
40-а Садова вулиця                        	40-ва Садова вулиця
41-а Садова вулиця                        	41-ша Садова вулиця
42-а Садова вулиця                        	42-га Садова вулиця
43-я Садова вулиця                        	43-тя Садова вулиця
44-а Садова вулиця                        	44-та Садова вулиця
45-а Садова вулиця                        	45-та Садова вулиця
46-а Садова вулиця                        	46-та Садова вулиця
47-а Садова вулиця                        	47-ма Садова вулиця
48-а Садова вулиця                        	48-ма Садова вулиця
49-а Садова вулиця                        	49-та Садова вулиця
49-а А Садова вулиця                      	49-та Садова вулиця А
49А Садова вулиця                         	49-та Садова вулиця А
5-а Абрикосова вулиця                     	5-та Абрикосова вулиця
П’ята вулиця                              	5-та вулиця
5-а Ентузіастів вулиця                    	5-та вулиця Ентузіастів
5-а Газопровідна вулиця                   	5-та Газопровідна вулиця
5-а Канальна вулиця                       	5-та Канальна вулиця
5-а лінія                                 	5-та лінія
5-а Лугова вулиця                         	5-та Лугова вулиця
5-а Набережна вулиця                      	5-та Набережна вулиця
5-а Приозерна вулиця                      	5-та Приозерна вулиця
5-а Садова вулиця                         	5-та Садова вулиця
5-а Синьоозерна вулиця                    	5-та Синьоозерна вулиця
50-а Садова вулиця                        	50-та Садова вулиця
50-а А Садова вулиця                      	50-та Садова вулиця А
51-а Садова вулиця                        	51-ша Садова вулиця
52-а Садова вулиця                        	52-га Садова вулиця
53-я Садова вулиця                        	53-тя Садова вулиця
54-а Садова вулиця                        	54-та Садова вулиця
55-а Садова вулиця                        	55-та Садова вулиця
56-а Садова вулиця                        	56-та Садова вулиця
57-а Садова вулиця                        	57-ма Садова вулиця
58-а Садова вулиця                        	58-ма Садова вулиця
59-а Садова вулиця                        	59-та Садова вулиця
6-а Абрикосова вулиця                     	6-та Абрикосова вулиця
Шоста вулиця                              	6-та вулиця
6-а Ентузіастів вулиця                    	6-та вулиця Ентузіастів
6-а Канальна вулиця                       	6-та Канальна вулиця
6-а лінія                                 	6-та лінія
6-а Лугова вулиця                         	6-та Лугова вулиця
6-а Набережна вулиця                      	6-та Набережна вулиця
6-а Приозерна вулиця                      	6-та Приозерна вулиця
6-а Садова вулиця                         	6-та Садова вулиця
6-а Синьоозерна вулиця                    	6-та Синьоозерна вулиця
60-а Садова вулиця                        	60-та Садова вулиця
61-а Садова вулиця                        	61-ша Садова вулиця
62-а Садова вулиця                        	62-га Садова вулиця
63-я Садова вулиця                        	63-тя Садова вулиця
64-а Садова вулиця                        	64-та Садова вулиця
65-а Садова вулиця                        	65-та Садова вулиця
66-а Садова вулиця                        	66-та Садова вулиця
67-а Садова вулиця                        	67-ма Садова вулиця
68-а Садова вулиця                        	68-ма Садова вулиця
69-а Садова вулиця                        	69-та Садова вулиця
7-а Абрикосова вулиця                     	7-ма Абрикосова вулиця
7-а Ентузіастів вулиця                    	7-ма вулиця Ентузіастів
7-а Канальна вулиця                       	7-ма Канальна вулиця
7-а лінія                                 	7-ма лінія
7-а Лугова вулиця                         	7-ма Лугова вулиця
7-а Набережна вулиця                      	7-ма Набережна вулиця
7-а Садова вулиця                         	7-ма Садова вулиця
70-а Садова вулиця                        	70-та Садова вулиця
71-а Садова вулиця                        	71-ша Садова вулиця
72-а Садова вулиця                        	72-га Садова вулиця
73-я Садова вулиця                        	73-тя Садова вулиця
75-а Садова вулиця                        	75-та Садова вулиця
76-а Садова вулиця                        	76-та Садова вулиця
77-а Садова вулиця                        	77-ма Садова вулиця
78-а Садова вулиця                        	78-ма Садова вулиця
79-а Садова вулиця                        	79-та Садова вулиця
8-а Абрикосова вулиця                     	8-ма Абрикосова вулиця
8-а Ентузіастів вулиця                    	8-ма вулиця Ентузіастів
8-а Канальна вулиця                       	8-ма Канальна вулиця
8-а лінія                                 	8-ма лінія
8-а Лугова вулиця                         	8-ма Лугова вулиця
8-а Набережна вулиця                      	8-ма Набережна вулиця
8-а Садова вулиця                         	8-ма Садова вулиця
8-а Синьоозерна вулиця                    	8-ма Синьоозерна вулиця
80-а Садова вулиця                        	80-та Садова вулиця
81-а Садова вулиця                        	81-ша Садова вулиця
82-а Садова вулиця                        	82-га Садова вулиця
83-я Садова вулиця                        	83-тя Садова вулиця
84-а Садова вулиця                        	84-та Садова вулиця
85-а Садова вулиця                        	85-та Садова вулиця
86-а Садова вулиця                        	86-та Садова вулиця
87-а Садова вулиця                        	87-ма Садова вулиця
88-а Садова вулиця                        	88-ма Садова вулиця
89-а Садова вулиця                        	89-та Садова вулиця
9-а Абрикосова вулиця                     	9-та Абрикосова вулиця
9-а Ентузіастів вулиця                    	9-та вулиця Ентузіастів
9-а Канальна вулиця                       	9-та Канальна вулиця
9-а лінія                                 	9-та лінія
9-а Лугова вулиця                         	9-та Лугова вулиця
9-а Набережна вулиця                      	9-та Набережна вулиця
9-а Садова вулиця                         	9-та Садова вулиця
90-а Садова вулиця                        	90-та Садова вулиця
91-а Садова вулиця                        	91-ша Садова вулиця
92-а Садова вулиця                        	92-га Садова вулиця
93-я Садова вулиця                        	93-тя Садова вулиця
94-а Садова вулиця                        	94-та Садова вулиця
95-а Садова вулиця                        	95-та Садова вулиця
96-а Садова вулиця                        	96-та Садова вулиця
97-а Садова вулиця                        	97-ма Садова вулиця
98-а Садова вулиця                        	98-ма Садова вулиця
99-а Садова вулиця                        	99-та Садова вулиця
1941 Року алея                            	алея 1941 року
Каштанова алея                            	Каштанова алея
алея Магдебурзького права                 	алея Магдебурзького Права
Алея муз                                  	алея Муз
Алея мучеників                            	алея Мучеників
Алея праведників                          	алея Праведників
Алея художників                           	алея Художників
узвіз Боричів                             	Боричів узвіз
вул. Амвросія Бучми                       	бульвар Амвросія Бучми
Жуля Верна бульвар                        	бульвар Жуля Верна
Кольцова бульвар                          	бульвар Кольцова
Леоніда Бикова бульвар                    	бульвар Леоніда Бикова
Перова бульвар                            	бульвар Перова
Ромена Роллана бульвар                    	бульвар Ромена Роллана
Юр’єва бульвар                            	бульвар Юрʼєва
провулок Бутишів                          	Бутишів провулок
вулиця Володарська                        	Володарська вулиця
4-а Алея вулиця                           	вулиця 4-та Алея
5-а Алея вулиця                           	вулиця 5-та Алея
Восьмого Березня вулиця                   	вулиця 8 Березня
Августина Волошина вулиця                 	вулиця Августина Волошина
Авіаконструктора Антонова вулиця          	вулиця Авіаконструктора Антонова
Авіаконструктора Ігоря Сікорського вулиця 	вулиця Авіаконструктора Ігоря Сікорського
Авіаконструктора Петра Балабуєва вулиця   	вулиця Авіаконструктора Петра Балабуєва
Адмірала Ушакова вулиця                   	вулиця Адмірала Ушакова
Академіка Горбунова вулиця                	вулиця Академіка Горбунова
Академіка Доброхотова вулиця              	вулиця Академіка Доброхотова
вулиця Доброхотова Академіка              	вулиця Академіка Доброхотова
Академіка Кіпріанова вулиця               	вулиця Академіка Кіпріанова
Кіпріанова Академіка вулиця               	вулиця Академіка Кіпріанова
Корольова Академіка вулиця                	вулиця Академіка Корольова
Академіка Костичева вулиця                	вулиця Академіка Костичева
Академіка Навашина вулиця                 	вулиця Академіка Навашина
Академіка Оппокова вулиця                 	вулиця Академіка Оппокова
Академіка Сєркова вулиця                  	вулиця Академіка Сєркова
Академіка Тронька вулиця                  	вулиця Академіка Тронька
Академіка Туполєва вулиця                 	вулиця Академіка Туполєва
Академіка Щусєва вулиця                   	вулиця Академіка Щусєва
Аляб’єва вулиця                           	вулиця Алябʼєва
Анатолія Пантелькіна вулиця               	вулиця Анатолія Пантелькіна
Андрія Іванова вулиця                     	вулиця Андрія Іванова
Архітектора Ніколаєва вулиця              	вулиця Архітектора Ніколаєва
Багратіона вулиця                         	вулиця Багратіона
Бакуніна вулиця                           	вулиця Бакуніна
Баренбойма вулиця                         	вулиця Баренбойма
Бетховена вулиця                          	вулиця Бетховена
Бориса Гаріна вулиця                      	вулиця Бориса Гаріна
Бориса Житкова вулиця                     	вулиця Бориса Житкова
Бориса Патона вулиця                      	вулиця Бориса Патона
Борщаговская вулиця                       	Борщагівська вулиця
Брюсова вулиця                            	вулиця Брюсова
вулиця Валер'яна Підмогильного            	вулиця Валерʼяна Підмогильного
Василя Алексухіна вулиця                  	вулиця Василя Алексухіна
Вулиця Василя Доманицького                	вулиця Василя Доманицького
Василя Кучера вулиця                      	вулиця Василя Кучера
Василя Сурікова вулиця                    	вулиця Василя Сурікова
Васнєцова вулиця                          	вулиця Васнєцова
Вєтрова вулиця                            	вулиця Вєтрова
Володимира Беца вулиця                    	вулиця Володимира Беца
Володимира Винниченка вулиця              	вулиця Володимира Винниченка
Володі Дубініна вулиця                    	вулиця Володі Дубініна
вулиця В’ячеслава Липинського             	вулиця Вʼячеслава Липинського
Гаршина вулиця                            	вулиця Гаршина
Генерала Тупікова вулиця                  	вулиця Генерала Тупікова
Героїв Дніпра вулиця                      	вулиця Героїв Дніпра
Герцена вулиця                            	вулиця Герцена
Гійома де Боплана вулиця                  	вулиця Гійома де Боплана
Глібова вулиця                            	вулиця Глібова
Гната Юри вулиця                          	вулиця Гната Юри
Гончарова вулиця                          	вулиця Гончарова
вулиця Горіхуватський шлях                	вулиця Горіхуватський Шлях
Городище вулиця                           	вулиця Городище
Дежнєва вулиця                            	вулиця Дежнєва
Джона Маккейна вулиця                     	вулиця Джона Маккейна
Димитрова вулиця                          	вулиця Димитрова
Дніпрової Чайки вулиця                    	вулиця Дніпрової Чайки
улиця Добролюбова                         	вулиця Добролюбова
Євгена Маланюка вулиця                    	вулиця Євгена Маланюка
Жданова вулиця                            	вулиця Жданова
Івана Білика вулиця                       	вулиця Івана Білика
Івана Богуна вулиця                       	вулиця Івана Богуна
Пулюя Івана вулиця                        	вулиця Івана Пулюя
Івана Тургенєва вулиця                    	вулиця Івана Тургенєва
Івана Федорова вулиця                     	вулиця Івана Федорова
Івана Фіалека вулиця                      	вулиця Івана Фіалека
Івана Шевцова вулиця                      	вулиця Івана Шевцова
Ігоря Турчина вулиця                      	вулиця Ігоря Турчина
вулиця Інтернаціонального легіону         	вулиця Інтернаціонального Легіону
вулиця Іоана Павла II                     	вулиця Іоана Павла II
Калиновий Ріг вулиця                      	вулиця Калиновий Ріг
Калініна вулиця                           	вулиця Калініна
Качалова вулиця                           	вулиця Качалова
Кірова вулиця                             	вулиця Кірова
Клари Цеткін вулиця                       	вулиця Клари Цеткін
Кленова Долина вулиця                     	вулиця Кленова Долина
Кленовий Узвіз вулиця                     	вулиця Кленовий Узвіз
Клима Чурюмова вулиця                     	вулиця Клима Чурюмова
Коллонтай вулиця                          	вулиця Коллонтай
Комісара Рикова вулиця                    	вулиця Комісара Рикова
Космонавта Волкова вулиця                 	вулиця Космонавта Волкова
Костянтина Ареф’єва вулиця                	вулиця Костянтина Арефʼєва
Костянтина Заслонова вулиця               	вулиця Костянтина Заслонова
Костянтина Хохлова вулиця                 	вулиця Костянтина Хохлова
Крейсера «Аврора» вулиця                  	вулиця Крейсера «Аврора»
Крилова вулиця                            	вулиця Крилова
Кудряшова вулиця                          	вулиця Кудряшова
Купріна вулиця                            	вулиця Купріна
Кутузова вулиця                           	вулиця Кутузова
Леніна вулиця                             	вулиця Леніна
Леоніда Бикова вулиця                     	вулиця Леоніда Бикова
Леонтовича вулиця                         	вулиця Леонтовича
Лермонтова вулиця                         	вулиця Лермонтова
Лисенка вулиця                            	вулиця Лисенка
Лодигіна вулиця                           	вулиця Лодигіна
Ломоносова вулиця                         	вулиця Ломоносова
Максима Левіна вулиця                     	вулиця Максима Левіна
Марка Черемшини вулиця                    	вулиця Марка Черемшини
Конєва маршала вулиця                     	вулиця Маршала Конєва
Маслівка вулиця                           	вулиця Маслівка
Менделєєва вулиця                         	вулиця Менделєєва
Миколи Василенка вулиця                   	вулиця Миколи Василенка
Миколи Гайцана вулиця                     	вулиця Миколи Гайцана
Миколи Кузнєцова вулиця                   	вулиця Миколи Кузнєцова
Миколи Лаврухіна вулиця                   	вулиця Миколи Лаврухіна
Миколи Лебедєва вулиця                    	вулиця Миколи Лебедєва
Миколи Ушакова вулиця                     	вулиця Миколи Ушакова
Миколи Юнкерова вулиця                    	вулиця Миколи Юнкерова
Митрополита Володимира Сабодана вулиця    	вулиця Митрополита Володимира Сабодана
Михайла Булгакова вулиця                  	вулиця Михайла Булгакова
Михайла Котельникова вулиця               	вулиця Михайла Котельникова
Михайла Майорова вулиця                   	вулиця Михайла Майорова
Михайла Чалого вулиця                     	вулиця Михайла Чалого
Мічуріна вулиця                           	вулиця Мічуріна
Нахімова вулиця                           	вулиця Нахімова
Некрасова вулиця                          	вулиця Некрасова
Оборони Києва вулиця                      	вулиця Оборони Києва
Огарьова вулиця                           	вулиця Огарьова
Олега Рябова вулиця                       	вулиця Олега Рябова
Олександра Бестужева вулиця               	вулиця Олександра Бестужева
Олександра Богомазова вулиця              	вулиця Олександра Богомазова
Олександра Сабурова вулиця                	вулиця Олександра Сабурова
Олексія Терьохіна вулиця                  	вулиця Олексія Терьохіна
Омеляна Горбачова вулиця                  	вулиця Омеляна Горбачова
Опанаса Сластіона вулиця                  	вулиця Опанаса Сластіона
Павлика Морозова вулиця                   	вулиця Павлика Морозова
Паторжинського вулиця                     	вулиця Паторжинського
Петра Красикова вулиця                    	вулиця Петра Красикова
Петра Радченка вулиця                     	вулиця Петра Радченка
Підлипка вулиця                           	вулиця Підлипка
Пілот вулиця                              	вулиця Пілот
Плещеєва вулиця                           	вулиця Плещеєва
Ползунова вулиця                          	вулиця Ползунова
Полковника Затєвахіна вулиця              	вулиця Полковника Затєвахіна
Полковника Шутова вулиця                  	вулиця Полковника Шутова
Полупанова вулиця                         	вулиця Полупанова
Профінтерна вулиця                        	вулиця Профінтерну
Пушкіна вулиця                            	вулиця Пушкіна
Рахманінова вулиця                        	вулиця Рахманінова
Римського-Корсакова вулиця                	вулиця Римського-Корсакова
Ріхарда Зорге вулиця                      	вулиця Ріхарда Зорге
Родини Кістяківських вулиця               	вулиця Родини Кістяківських
Саврасова вулиця                          	вулиця Саврасова
Сажина вулиця                             	вулиця Сажина
Свердлова вулиця                          	вулиця Свердлова
Сергія Єсеніна вулиця                     	вулиця Сергія Єсеніна
Сергія Струтинського вулиця               	вулиця Сергія Струтинського
Сєдова вулиця                             	вулиця Сєдова
Сєченова вулиця                           	вулиця Сєченова
вулиця Сім’ї Прахових                     	вулиця Сімʼї Прахових
вулиця Сім'ї Холодних                     	вулиця Сімʼї Холодних
Січневого повстання вулиця                	вулиця Січневого Повстання
Смирнова-Ласточкіна вулиця                	вулиця Смирнова-Ласточкіна
Степана Голованьова вулиця                	вулиця Степана Голованьова
Столєтова вулиця                          	вулиця Столєтова
Суворова вулиця                           	вулиця Суворова
Тельмана вулиця                           	вулиця Тельмана
Тешебаєва вулиця                          	вулиця Тешебаєва
Тропініна вулиця                          	вулиця Тропініна
Тургенєва вулиця                          	вулиця Тургенєва
Українського Відродження вулиця           	вулиця Українського Відродження
Урочище Дубки вулиця                      	вулиця Урочище Дубки
Федосєєва вулиця                          	вулиця Федосєєва
Фрунзе вулиця                             	вулиця Фрунзе
Чапаєва вулиця                            	вулиця Чапаєва
Чехова вулиця                             	вулиця Чехова
Чкалова вулиця                            	вулиця Чкалова
вулиця Ю. Глушка                          	вулиця Юрія Глушка
вулиця Ю.Іллєнка                          	вулиця Юрія Іллєнка
Юрія Лаврова вулиця                       	вулиця Юрія Лаврова
Якіра вулиця                              	вулиця Якіра
вулиця Дорогожицька                       	Дорогожицька вулиця
Західно-кільцева вулиця                   	Західно-Кільцева вулиця
Знам’янська вулиця                        	Знамʼянська вулиця
Кам’янець-Подільська вулиця               	Камʼянець-Подільська вулиця
Кам’янець-Подільський провулок            	Камʼянець-Подільський провулок
Кам'янська вулиця                         	Камʼянська вулиця
Кам’янська вулиця                         	Камʼянська вулиця
Кар’єрна вулиця                           	Карʼєрна вулиця
Кар'єрний провулок                        	Карʼєрний провулок
Кожум’яцька вулиця                        	Кожумʼяцька вулиця
Куп’янська вулиця                         	Купʼянська вулиця
Куп’янський провулок                      	Купʼянський провулок
Лук’янівська вулиця                       	Лукʼянівська вулиця
Лук’янівська площа                        	Лукʼянівська площа
Лук’янівський провулок                    	Лукʼянівський провулок
МІжозерна вулиця                          	Міжозерна вулиця
М’ятна вулиця                             	Мʼятна вулиця
Над’ярна вулиця                           	Надʼярна вулиця
вулиця Пантелеймонівська                  	Пантелеймонівська вулиця
Фрунзе площа                              	площа Фрунзе
Приозерная улица                          	Приозерна вулиця
Прип’ятська вулиця                        	Припʼятська вулиця
Аскольдів провулок                        	провулок Аскольдів
Бабушкіна провулок                        	провулок Бабушкіна
Василя Кука провулок                      	провулок Василя Кука
Ватутіна провулок                         	провулок Ватутіна
Гористий провулок                         	провулок Гористий
Гречаний провулок                         	провулок Гречаний
Дежньова провулок                         	провулок Дежньова
Добролюбова провулок                      	провулок Добролюбова
Дубровицький провулок                     	провулок Дубровицький
Жданова провулок                          	провулок Жданова
провулок Івана Мар’яненка                 	провулок Івана Марʼяненка
провулок Квітки-Основ’яненка              	провулок Квітки-Основʼяненка
Кудряшова провулок                        	провулок Кудряшова
Кулібіна провулок                         	провулок Кулібіна
Лермонтова провулок                       	провулок Лермонтова
Лодигіна провулок                         	провулок Лодигіна
Михайла Булгакова провулок                	провулок Михайла Булгакова
Мічуріна провулок                         	провулок Мічуріна
Попова провулок                           	провулок Попова
Радищева провулок                         	провулок Радищева
Свердлова провулок                        	провулок Свердлова
Сергія Параджанова провулок               	провулок Сергія Параджанова
Суворова провулок                         	провулок Суворова
Толбухіна провулок                        	провулок Толбухіна
Тропініна провулок                        	провулок Тропініна
Тургенєва провулок                        	провулок Тургенєва
Фадєєва провулок                          	провулок Фадєєва
Федосєєва провулок                        	провулок Федосєєва
Чаплигіна провулок                        	провулок Чаплигіна
Шаумяна провулок                          	провулок Шаумяна
Яблочкова провулок                        	провулок Яблочкова
Якова Щоголева провулок                   	провулок Якова Щоголева
Калиновий Ріг проїзд                      	проїзд Калиновий Ріг
40-річчя Жовтня проспект                  	проспект 40-річчя Жовтня
Академіка Глушкова проспект               	проспект Академіка Глушкова
Академіка Палладіна проспект              	проспект Академіка Палладіна
Проспект Алишера Навои                    	проспект Алішера Навої
проспект Возз’єднання                     	проспект Воззʼєднання
проспект Героїв Сталінграда               	проспект Героїв Сталінграду
Космонавта Комарова проспект              	проспект Космонавта Комарова
Миколи Бажана проспект                    	проспект Миколи Бажана
Юрія Гагаріна проспект                    	проспект Юрія Гагаріна
вул. Пухiвська                            	Пухівська вулиця
вулиця Пушкінська                         	Пушкінська вулиця
П’ятигорська вулиця                       	Пʼятигорська вулиця
П’ятигорський провулок                    	Пʼятигорський провулок
Слов’янська вулиця                        	Словʼянська вулиця
Солов’їна вулиця                          	Соловʼїна вулиця
Солом’янська вулиця                       	Соломʼянська вулиця
Солом’янська площа                        	Соломʼянська площа
вулиця Спартаківська                      	Спартаківська вулиця
Тираспольська вулиц                       	Тираспольська вулиця
Колпитська казарма урочище                	урочище Колпитська Казарма