1 Махнівський провулок                                               	1-й Махнівський провулок
1 Травня вулиця                                                      	вулиця 1 Травня
1-а Вінницька вулиця                                                 	1-ша Вінницька вулиця
1-а Польова вулиця                                                   	1-ша Польова вулиця
1-а Садова вулиця                                                    	1-ша Садова вулиця
1-а вулиця                                                           	1-ша вулиця
1-го Грудня вулиця                                                   	вулиця 1 Грудня
1-го Травня вулиця                                                   	вулиця 1 Травня
1-го Травня провулок                                                 	провулок 1 Травня
1-й 12-го Грудня провулок                                            	1-й провулок 12 Грудня
1-й Євгена Чикаленка провулок                                        	1-й провулок Євгена Чикаленка
1-й Івана Пулюя проїзд                                               	1-й проїзд Івана Пулюя
1-й Івана Хоменка провулок                                           	1-й провулок Івана Хоменка
1-й Ігоря Костецького провулок                                       	1-й провулок Ігоря Костецького
1-й Автомобілістів проїзд                                            	1-й проїзд Автомобілістів
1-й Академіка Вернадського проїзд                                    	1-й проїзд Академіка Вернадського
1-й Антона Турчановича провулок                                      	1-й провулок Антона Турчановича
1-й Аріадни Стебельської провулок                                    	1-й провулок Аріадни Стебельської
1-й Бестужева провулок                                               	1-й провулок Бестужева
1-й Блюхера провулок                                                 	1-й провулок Блюхера
1-й Бориса Гмирі провулок                                            	1-й провулок Бориса Гмирі
1-й Бориса Грінченка провулок                                        	1-й провулок Бориса Грінченка
1-й Бориса Шкляра провулок                                           	1-й провулок Бориса Шкляра
1-й Василя Сліпака провулок                                          	1-й провулок Василя Сліпака
1-й Василя Стефаника провулок                                        	1-й провулок Василя Стефаника
1-й Ватутіна провулок                                                	1-й провулок Ватутіна
1-й Високовича провулок                                              	1-й провулок Високовича
1-й Вишневського провулок                                            	1-й провулок Вишневського
1-й Володимира Івасюка провулок                                      	1-й провулок Володимира Івасюка
1-й Володимира Свідзінського провулок                                	1-й провулок Володимира Свідзінського
1-й Ворошилова провулок                                              	1-й провулок Ворошилова
1-й Віктора Блащука проїзд                                           	1-й проїзд Віктора Блащука
1-й Г.Морозової провулок                                             	1-й провулок Г. Морозової
1-й Г.Морозової проїзд                                               	1-й проїзд Г. Морозової
1-й Генерала Арабея проїзд                                           	1-й проїзд Генерала Арабея
1-й Гетьмана Сагайдачного провулок                                   	1-й провулок Гетьмана Сагайдачного
1-й Глінки провулок                                                  	1-й провулок Глінки
1-й Гната Танцюри провулок                                           	1-й провулок Гната Танцюри
1-й Гната Юри проїзд                                                 	1-й проїзд Гната Юри
1-й Гніванське шосе провулок                                         	1-й провулок Гніванське Шосе
1-й Григорія Чупринки провулок                                       	1-й провулок Григорія Чупринки
1-й Громова провулок                                                 	1-й провулок Громова
1-й Данила Нечая провулок                                            	1-й провулок Данила Нечая
1-й Дзержинського провулок                                           	1-й провулок Дзержинського
1-й Дружби провулок                                                  	1-й провулок Дружби
1-й Дубініна провулок                                                	1-й провулок Дубініна
1-й Енергетиків проїзд                                               	1-й проїзд Енергетиків
1-й Журналістів проїзд                                               	1-й проїзд Журналістів
1-й Затонського провулок                                             	1-й провулок Затонського
1-й Зорге провулок                                                   	1-й провулок Зорге
1-й Карбишева провулок                                               	1-й провулок Карбишева
1-й Карбишева проїзд                                                 	1-й проїзд Карбишева
1-й Кар’єрний провулок                                               	1-й Карʼєрний провулок
1-й Кибальчича провулок                                              	1-й провулок Кибальчича
1-й Комарова провулок                                                	1-й провулок Комарова
1-й Константиновича провулок                                         	1-й провулок Константиновича
1-й Константиновича проїзд                                           	1-й проїзд Константиновича
1-й Корольова провулок                                               	1-й провулок Корольова
1-й Коцюбинського провулок                                           	1-й провулок Коцюбинського
1-й Кропоткіна провулок                                              	1-й провулок Кропоткіна
1-й Кушніра провулок                                                 	1-й провулок Кушніра
1-й Леонтовича провулок                                              	1-й провулок Леонтовича
1-й Леоніда Каденюка провулок                                        	1-й провулок Леоніда Каденюка
1-й Леоніда Мосендза провулок                                        	1-й провулок Леоніда Мосендза
1-й Лермонтова провулок                                              	1-й провулок Лермонтова
1-й Леся Курбаса провулок                                            	1-й провулок Леся Курбаса
1-й Литвиненка провулок                                              	1-й провулок Литвиненка
1-й Литвиненка тупик                                                 	1-й тупик Литвиненка
1-й Ломоносова провулок                                              	1-й провулок Ломоносова
1-й Макаренка провулок                                               	1-й провулок Макаренка
1-й Максима Шаповала провулок                                        	1-й провулок Максима Шаповала
1-й Максимовича проїзд                                               	1-й проїзд Максимовича
1-й Марії Литвиненко-Вольгемут провулок                              	1-й провулок Марії Литвиненко-Вольгемут
1-й Марії Литвиненко-Вольгемут тупик                                 	1-й тупик Марії Литвиненко-Вольгемут
1-й Матросова провулок                                               	1-й провулок Матросова
1-й Маяковського провулок                                            	1-й провулок Маяковського
1-й Механізаторів провулок                                           	1-й провулок Механізаторів
1-й Миколи Костомарова провулок                                      	1-й провулок Миколи Костомарова
1-й Миколи Леонтовича провулок                                       	1-й провулок Миколи Леонтовича
1-й Миколи Хвильового провулок                                       	1-й провулок Миколи Хвильового
1-й Мирослава Скорика провулок                                       	1-й провулок Мирослава Скорика
1-й Миру провулок                                                    	1-й провулок Миру
1-й Москвіна провулок                                                	1-й провулок Москвіна
1-й Насті Присяжнюк провулок                                         	1-й провулок Насті Присяжнюк
1-й Нахімова провулок                                                	1-й провулок Нахімова
1-й Нахімова тупик                                                   	1-й тупик Нахімова
1-й Немирівське шосе провулок                                        	1-й провулок Немирівське Шосе
1-й Олександра Лотоцького провулок                                   	1-й провулок Олександра Лотоцького
1-й Олексія Миргородського провулок                                  	1-й провулок Олексія Миргородського
1-й Олексія Миргородського проїзд                                    	1-й проїзд Олексія Миргородського
1-й Омеляна Грабця провулок                                          	1-й провулок Омеляна Грабця
1-й Павленка провулок                                                	1-й провулок Павленка
1-й Пестеля провулок                                                 	1-й провулок Пестеля
1-й Петра Волинця провулок                                           	1-й провулок Петра Волинця
1-й Петровського провулок                                            	1-й провулок Петровського
1-й Пилипа Орлика провулок                                           	1-й провулок Пилипа Орлика
1-й Пирогова провулок                                                	1-й провулок Пирогова
1-й Полубудкіна провулок                                             	1-й провулок Полубудкіна
1-й Постишева провулок                                               	1-й провулок Постишева
1-й Постишева проїзд                                                 	1-й проїзд Постишева
1-й Праведників світу проїзд                                         	1-й проїзд Праведників Світу
1-й Рилєєва провулок                                                 	1-й провулок Рилєєва
1-й Романа Балаби провулок                                           	1-й провулок Романа Балаби
1-й Руданського провулок                                             	1-й провулок Руданського
1-й Сагайдачного провулок                                            	1-й провулок Сагайдачного
1-й Софії Русової провулок                                           	1-й провулок Софії Русової
1-й Стеценка провулок                                                	1-й провулок Стеценка
1-й Тараса Шевченка провулок                                         	1-й провулок Тараса Шевченка
1-й Тетяни Яблонської провулок                                       	1-й провулок Тетяни Яблонської
1-й Топольського провулок                                            	1-й провулок Топольського
1-й Тропініна провулок                                               	1-й провулок Тропініна
1-й Трублаїні провулок                                               	1-й провулок Трублаїні
1-й Тухачевського провулок                                           	1-й провулок Тухачевського
1-й Франка провулок                                                  	1-й провулок Франка
1-й Харчовиків проїзд                                                	1-й проїзд Харчовиків
1-й Хмельницького шосе провулок                                      	1-й провулок Хмельницького Шосе
1-й Хіміків проїзд                                                   	1-й проїзд Хіміків
1-й Цукровиків проїзд                                                	1-й проїзд Цукровиків
1-й Черняховського провулок                                          	1-й провулок Черняховського
1-й Черняховського проїзд                                            	1-й проїзд Черняховського
1-й Шевченка провулок                                                	1-й провулок Шевченка
1-й Юності провулок                                                  	1-й провулок Юності
1-й Юрія Левади проїзд                                               	1-й проїзд Юрія Левади
10-а вулиця                                                          	10-та вулиця
11-а вулиця                                                          	11-та вулиця
12-а вулиця                                                          	12-та вулиця
12-го Грудня вулиця                                                  	вулиця 12 Грудня
13-а вулиця                                                          	13-та вулиця
14-а вулиця                                                          	14-та вулиця
15-а вулиця                                                          	15-та вулиця
15-ї Стрілецької Дивізії вулиця                                      	вулиця 15-ї Стрілецької Дивізії
16-а вулиця                                                          	16-та вулиця
18-ї Армії вулиця                                                    	вулиця 18-ї Армії
19 Березня вулиця                                                    	вулиця 19 Березня
1905 року вулиця                                                     	вулиця 1905 року
1905 року провулок                                                   	провулок 1905 року
2 Махнівський провулок                                               	2-й Махнівський провулок
2-а Вінницька вулиця                                                 	2-га Вінницька вулиця
2-а Садова вулиця                                                    	2-га Садова вулиця
2-а вулиця                                                           	2-га вулиця
2-й 12-го Грудня провулок                                            	2-й провулок 12 Грудня
2-й Євгена Чикаленка провулок                                        	2-й провулок Євгена Чикаленка
2-й Івана Пулюя проїзд                                               	2-й проїзд Івана Пулюя
2-й Івана Хоменка провулок                                           	2-й провулок Івана Хоменка
2-й Ігоря Костецького провулок                                       	2-й провулок Ігоря Костецького
2-й Автомобілістів проїзд                                            	2-й проїзд Автомобілістів
2-й Академіка Вернадського проїзд                                    	2-й проїзд Академіка Вернадського
2-й Антона Турчановича провулок                                      	2-й провулок Антона Турчановича
2-й Аріадни Стебельської провулок                                    	2-й провулок Аріадни Стебельської
2-й Бестужева провулок                                               	2-й провулок Бестужева
2-й Блюхера провулок                                                 	2-й провулок Блюхера
2-й Бориса Гмирі провулок                                            	2-й провулок Бориса Гмирі
2-й Бориса Грінченка провулок                                        	2-й провулок Бориса Грінченка
2-й Бориса Шкляра провулок                                           	2-й провулок Бориса Шкляра
2-й Василя Сліпака провулок                                          	2-й провулок Василя Сліпака
2-й Ватутіна провулок                                                	2-й провулок Ватутіна
2-й Вишневського провулок                                            	2-й провулок Вишневського
2-й Володимира Івасюка провулок                                      	2-й провулок Володимира Івасюка
2-й Володимира Свідзінського провулок                                	2-й провулок Володимира Свідзінського
2-й Віктора Блащука проїзд                                           	2-й проїзд Віктора Блащука
2-й Г.Морозової провулок                                             	2-й провулок Г. Морозової
2-й Генерала Арабея проїзд                                           	2-й проїзд Генерала Арабея
2-й Глінки провулок                                                  	2-й провулок Глінки
2-й Гната Танцюри провулок                                           	2-й провулок Гната Танцюри
2-й Гната Юри проїзд                                                 	2-й проїзд Гната Юри
2-й Гніванське шосе провулок                                         	2-й провулок Гніванське Шосе
2-й Григорія Чупринки провулок                                       	2-й провулок Григорія Чупринки
2-й Громова провулок                                                 	2-й провулок Громова
2-й Данила Нечая провулок                                            	2-й провулок Данила Нечая
2-й Дружби провулок                                                  	2-й провулок Дружби
2-й Дубініна провулок                                                	2-й провулок Дубініна
2-й Енгельса провулок                                                	2-й провулок Енгельса
2-й Енергетиків проїзд                                               	2-й проїзд Енергетиків
2-й Журналістів проїзд                                               	2-й проїзд Журналістів
2-й Зорге провулок                                                   	2-й провулок Зорге
2-й Карбишева провулок                                               	2-й провулок Карбишева
2-й Карбишева проїзд                                                 	2-й проїзд Карбишева
2-й Кар’єрний провулок                                               	2-й Карʼєрний провулок
2-й Комарова провулок                                                	2-й провулок Комарова
2-й Корольова провулок                                               	2-й провулок Корольова
2-й Коцюбинського провулок                                           	2-й провулок Коцюбинського
2-й Леоніда Каденюка провулок                                        	2-й провулок Леоніда Каденюка
2-й Леоніда Мосендза провулок                                        	2-й провулок Леоніда Мосендза
2-й Лермонтова провулок                                              	2-й провулок Лермонтова
2-й Ломоносова провулок                                              	2-й провулок Ломоносова
2-й Макаренка провулок                                               	2-й провулок Макаренка
2-й Максима Шаповала провулок                                        	2-й провулок Максима Шаповала
2-й Максимовича проїзд                                               	2-й проїзд Максимовича
2-й Марії Литвиненко-Вольгемут провулок                              	2-й провулок Марії Литвиненко-Вольгемут
2-й Матросова провулок                                               	2-й провулок Матросова
2-й Маяковського провулок                                            	2-й провулок Маяковського
2-й Механізаторів провулок                                           	2-й провулок Механізаторів
2-й Миколи Костомарова провулок                                      	2-й провулок Миколи Костомарова
2-й Миколи Хвильового провулок                                       	2-й провулок Миколи Хвильового
2-й Мирослава Скорика провулок                                       	2-й провулок Мирослава Скорика
2-й Москвіна провулок                                                	2-й провулок Москвіна
2-й Насті Присяжнюк провулок                                         	2-й провулок Насті Присяжнюк
2-й Нахімова провулок                                                	2-й провулок Нахімова
2-й Нахімова тупик                                                   	2-й тупик Нахімова
2-й Незалежності провулок                                            	2-й провулок Незалежності
2-й Олександра Лотоцького провулок                                   	2-й провулок Олександра Лотоцького
2-й Олексія Миргородського провулок                                  	2-й провулок Олексія Миргородського
2-й Олексія Миргородського проїзд                                    	2-й проїзд Олексія Миргородського
2-й Омеляна Грабця провулок                                          	2-й провулок Омеляна Грабця
2-й Павленка проїзд                                                  	2-й проїзд Павленка
2-й Пестеля провулок                                                 	2-й провулок Пестеля
2-й Петровського провулок                                            	2-й провулок Петровського
2-й Пилипа Орлика провулок                                           	2-й провулок Пилипа Орлика
2-й Пирогова провулок                                                	2-й провулок Пирогова
2-й Полубудкіна провулок                                             	2-й провулок Полубудкіна
2-й Постишева провулок                                               	2-й провулок Постишева
2-й Постишева проїзд                                                 	2-й проїзд Постишева
2-й Праведників світу проїзд                                         	2-й проїзд Праведників Світу
2-й Рилєєва провулок                                                 	2-й провулок Рилєєва
2-й Романа Балаби провулок                                           	2-й провулок Романа Балаби
2-й Сагайдачного провулок                                            	2-й провулок Сагайдачного
2-й Северина Наливайка провулок                                      	2-й провулок Северина Наливайка
2-й Софії Русової провулок                                           	2-й провулок Софії Русової
2-й Стеценка провулок                                                	2-й провулок Стеценка
2-й Тараса Шевченка провулок                                         	2-й провулок Тараса Шевченка
2-й Тетяни Яблонської провулок                                       	2-й провулок Тетяни Яблонської
2-й Топольського провулок                                            	2-й провулок Топольського
2-й Тропініна провулок                                               	2-й провулок Тропініна
2-й Трублаїні провулок                                               	2-й провулок Трублаїні
2-й Тухачевського провулок                                           	2-й провулок Тухачевського
2-й Франка провулок                                                  	2-й провулок Франка
2-й Харчовиків проїзд                                                	2-й проїзд Харчовиків
2-й Хмельницького шосе провулок                                      	2-й провулок Хмельницького Шосе
2-й Хіміків проїзд                                                   	2-й проїзд Хіміків
2-й Цукровиків проїзд                                                	2-й проїзд Цукровиків
2-й Чайковського провулок                                            	2-й провулок Чайковського
2-й Черняховського провулок                                          	2-й провулок Черняховського
2-й Черняховського проїзд                                            	2-й проїзд Черняховського
2-й Шевченка провулок                                                	2-й провулок Шевченка
2-й Ширшова провулок                                                 	2-й провулок Ширшова
2-й Юності провулок                                                  	2-й провулок Юності
2-й Юрія Левади проїзд                                               	2-й проїзд Юрія Левади
20-го Березня вулиця                                                 	вулиця 20 Березня
22 Січня вулиця                                                      	вулиця 22 Січня
25 років Жовтня вулиця                                               	вулиця 25 років Жовтня
276-ї Стрілецької Дивізії вулиця                                     	вулиця 276-ї Стрілецької Дивізії
28 Червня вулиця                                                     	вулиця 28 Червня
28-го Червня вулиця                                                  	вулиця 28 Червня
3 Махнівський провулок                                               	3-й Махнівський провулок
3-й Євгена Чикаленка провулок                                        	3-й провулок Євгена Чикаленка
3-й Івана Пулюя проїзд                                               	3-й проїзд Івана Пулюя
3-й Автомобілістів проїзд                                            	3-й проїзд Автомобілістів
3-й Антона Турчановича провулок                                      	3-й провулок Антона Турчановича
3-й Аріадни Стебельської провулок                                    	3-й провулок Аріадни Стебельської
3-й Блюхера провулок                                                 	3-й провулок Блюхера
3-й Бориса Гмирі провулок                                            	3-й провулок Бориса Гмирі
3-й Василя Стефаника провулок                                        	3-й провулок Василя Стефаника
3-й Вишневського провулок                                            	3-й провулок Вишневського
3-й Володимира Свідзінського провулок                                	3-й провулок Володимира Свідзінського
3-й Г.Морозової провулок                                             	3-й провулок Г. Морозової
3-й Генерала Арабея проїзд                                           	3-й проїзд Генерала Арабея
3-й Глінки провулок                                                  	3-й провулок Глінки
3-й Гніванське шосе провулок                                         	3-й провулок Гніванське Шосе
3-й Григорія Чупринки провулок                                       	3-й провулок Григорія Чупринки
3-й Данила Нечая провулок                                            	3-й провулок Данила Нечая
3-й Енгельса провулок                                                	3-й провулок Енгельса
3-й Карбишева провулок                                               	3-й провулок Карбишева
3-й Карбишева проїзд                                                 	3-й проїзд Карбишева
3-й Комарова провулок                                                	3-й провулок Комарова
3-й Леоніда Каденюка провулок                                        	3-й провулок Леоніда Каденюка
3-й Лермонтова провулок                                              	3-й провулок Лермонтова
3-й Лікаря Маєвського провулок                                       	3-й провулок Лікаря Маєвського
3-й Максима Шаповала провулок                                        	3-й провулок Максима Шаповала
3-й Максимовича проїзд                                               	3-й проїзд Максимовича
3-й Насті Присяжнюк провулок                                         	3-й провулок Насті Присяжнюк
3-й Нахімова провулок                                                	3-й провулок Нахімова
3-й Незалежності провулок                                            	3-й провулок Незалежності
3-й Олександра Лотоцького провулок                                   	3-й провулок Олександра Лотоцького
3-й Олексія Миргородського проїзд                                    	3-й проїзд Олексія Миргородського
3-й Пестеля провулок                                                 	3-й провулок Пестеля
3-й Постишева провулок                                               	3-й провулок Постишева
3-й Праведників світу проїзд                                         	3-й проїзд Праведників Світу
3-й Руданського провулок                                             	3-й провулок Руданського
3-й Сагайдачного провулок                                            	3-й провулок Сагайдачного
3-й Тухачевського провулок                                           	3-й провулок Тухачевського
3-й Харчовиків проїзд                                                	3-й проїзд Харчовиків
3-й Хіміків проїзд                                                   	3-й проїзд Хіміків
3-й Цукровиків проїзд                                                	3-й проїзд Цукровиків
3-й Черняховського проїзд                                            	3-й проїзд Черняховського
3-й Шевченка провулок                                                	3-й провулок Шевченка
3-й Ширшова провулок                                                 	3-й провулок Ширшова
3-й Юрія Левади проїзд                                               	3-й проїзд Юрія Левади
3-я Садова вулиця                                                    	3-тя Садова вулиця
3-я вулиця                                                           	3-тя вулиця
30 років Перемоги вулиця                                             	вулиця 30 років Перемоги
30-річчя Перемоги вулиця                                             	вулиця 30-річчя Перемоги
35 Років Перемоги вулиця                                             	вулиця 35 років Перемоги
39 років Перемоги вулиця                                             	вулиця 39 років Перемоги
4-а Садова вулиця                                                    	4-та Садова вулиця
4-а вулиця                                                           	4-та вулиця
4-й Євгена Чикаленка провулок                                        	4-й провулок Євгена Чикаленка
4-й Автомобілістів проїзд                                            	4-й проїзд Автомобілістів
4-й Аріадни Стебельської провулок                                    	4-й провулок Аріадни Стебельської
4-й Бориса Гмирі провулок                                            	4-й провулок Бориса Гмирі
4-й Василя Стефаника провулок                                        	4-й провулок Василя Стефаника
4-й Генерала Арабея проїзд                                           	4-й проїзд Генерала Арабея
4-й Гніванське шосе провулок                                         	4-й провулок Гніванське Шосе
4-й Григорія Чупринки провулок                                       	4-й провулок Григорія Чупринки
4-й Енергетиків проїзд                                               	4-й проїзд Енергетиків
4-й Комарова провулок                                                	4-й провулок Комарова
4-й Леоніда Каденюка провулок                                        	4-й провулок Леоніда Каденюка
4-й Максима Шаповала провулок                                        	4-й провулок Максима Шаповала
4-й Руданського провулок                                             	4-й провулок Руданського
4-й Цукровиків проїзд                                                	4-й проїзд Цукровиків
4-й Черняховського проїзд                                            	4-й проїзд Черняховського
4-й Юрія Левади проїзд                                               	4-й проїзд Юрія Левади
40 років Перемоги вулиця                                             	вулиця 40 років Перемоги
40-річчя Перемоги вулиця                                             	вулиця 40-річчя Перемоги
40-річчя Перемоги провулок                                           	провулок 40-річчя Перемоги
5-а вулиця                                                           	5-та вулиця
5-й Євгена Чикаленка провулок                                        	5-й провулок Євгена Чикаленка
5-й Автомобілістів проїзд                                            	5-й проїзд Автомобілістів
5-й Бориса Гмирі провулок                                            	5-й провулок Бориса Гмирі
5-й Василя Стефаника провулок                                        	5-й провулок Василя Стефаника
5-й Генерала Арабея проїзд                                           	5-й проїзд Генерала Арабея
5-й Гніванське шосе провулок                                         	5-й провулок Гніванське Шосе
5-й Григорія Чупринки провулок                                       	5-й провулок Григорія Чупринки
5-й Комарова провулок                                                	5-й провулок Комарова
5-й Леоніда Каденюка провулок                                        	5-й провулок Леоніда Каденюка
5-й Максима Шаповала провулок                                        	5-й провулок Максима Шаповала
5-й Черняховського проїзд                                            	5-й проїзд Черняховського
5-й Юрія Левади проїзд                                               	5-й проїзд Юрія Левади
50 Років Жовтня вулиця                                               	вулиця 50 років Жовтня
50 років ВЛКСМ вулиця                                                	вулиця 50 років ВЛКСМ
50 років Жовтня вулиця                                               	вулиця 50 років Жовтня
50 років СРСР вулиця                                                 	вулиця 50 років СРСР
50 років СССР вулиця                                                 	вулиця 50 років СРСР
50-річчя Жовтня вулиця                                               	вулиця 50-річчя Жовтня
50-річчя Колгоспу вулиця                                             	вулиця 50-річчя Колгоспу
50-річчя Перемоги вулиця                                             	вулиця 50-річчя Перемоги
50-річчя Перемоги провулок                                           	провулок 50-річчя Перемоги
6-а вулиця                                                           	6-та вулиця
6-й Автомобілістів проїзд                                            	6-й проїзд Автомобілістів
6-й Бориса Гмирі провулок                                            	6-й провулок Бориса Гмирі
6-й Генерала Арабея проїзд                                           	6-й проїзд Генерала Арабея
6-й Григорія Чупринки провулок                                       	6-й провулок Григорія Чупринки
6-й Леоніда Каденюка провулок                                        	6-й провулок Леоніда Каденюка
6-й Максима Шаповала провулок                                        	6-й провулок Максима Шаповала
6-й Черняховського проїзд                                            	6-й проїзд Черняховського
6-й Юрія Левади проїзд                                               	6-й проїзд Юрія Левади
600-річчя Бронниці вулиця                                            	вулиця 600-річчя Бронниці
600-річчя вулиця                                                     	вулиця 600-річчя
7-а вулиця                                                           	7-ма вулиця
7-й Автомобілістів проїзд                                            	7-й проїзд Автомобілістів
7-й Генерала Арабея проїзд                                           	7-й проїзд Генерала Арабея
7-й Григорія Чупринки провулок                                       	7-й провулок Григорія Чупринки
7-й Леоніда Каденюка провулок                                        	7-й провулок Леоніда Каденюка
70-річчя Жовтня вулиця                                               	вулиця 70-річчя Жовтня
8 Березня вулиця                                                     	вулиця 8 Березня
8 Березня площа                                                      	площа 8 Березня
8 Березня провулок                                                   	провулок 8 Березня
8-а Гвардійська вулиця                                               	8-ма Гвардійська вулиця
8-а вулиця                                                           	8-ма вулиця
8-го Березня вулиця                                                  	вулиця 8 Березня
8-го Березня провулок                                                	провулок 8 Березня
8-й Автомобілістів проїзд                                            	8-й проїзд Автомобілістів
9 Травня вулиця                                                      	вулиця 9 Травня
9-а вулиця                                                           	9-та вулиця
9-го Січня вулиця                                                    	вулиця 9 Січня
9-го Січня провулок                                                  	провулок 9 Січня
9-го Травня вулиця                                                   	вулиця 9 Травня
Hезалежності вулиця                                                  	вулиця Незалежності
Євгена Гижі вулиця                                                   	вулиця Євгена Гижі
Євгена Гуцала вулиця                                                 	вулиця Євгена Гуцала
Євгена Гуцала провулок                                               	провулок Євгена Гуцала
Євгена Коновальця вулиця                                             	вулиця Євгена Коновальця
Євгена Патона вулиця                                                 	вулиця Євгена Патона
Євгена Сверстюка вулиця                                              	вулиця Євгена Сверстюка
Євгена Сверстюка провулок                                            	провулок Євгена Сверстюка
Євгена Чикаленка вулиця                                              	вулиця Євгена Чикаленка
Євгена Чикаленка провулок                                            	провулок Євгена Чикаленка
Євгенія Пікуса вулиця                                                	вулиця Євгенія Пікуса
Євдокименка вулиця                                                   	вулиця Євдокименка
Єгоровича вулиця                                                     	вулиця Єгоровича
Єдинача вулиця                                                       	вулиця Єдинача
Єдності вулиця                                                       	вулиця Єдності
Єдності провулок                                                     	провулок Єдності
Єрмака вулиця                                                        	вулиця Єрмака
Єрмака провулок                                                      	провулок Єрмака
Єрусалимка вулиця                                                    	вулиця Єрусалимка
Єсеніна вулиця                                                       	вулиця Єсеніна
І. Богуна вулиця                                                     	вулиця І. Богуна
І. Калашника вулиця                                                  	вулиця І. Калашника
І. Печериці вулиця                                                   	вулиця І. Печериці
І. Прокоповича вулиця                                                	вулиця І. Прокоповича
І. Сікорського вулиця                                                	вулиця І. Сікорського
І. Франка вулиця                                                     	вулиця І. Франка
І.Богуна вулиця                                                      	вулиця І. Богуна
І.Богуна провулок                                                    	провулок І. Богуна
І.Савченка вулиця                                                    	вулиця І. Савченка
ІІІ-Гвардійська вулиця                                               	3-тя Гвардійська вулиця
Івана Багряного вулиця                                               	вулиця Івана Багряного
Івана Бевза вулиця                                                   	вулиця Івана Бевза
Івана Богуна вулиця                                                  	вулиця Івана Богуна
Івана Богуна провулок                                                	провулок Івана Богуна
Івана Бойка вулиця                                                   	вулиця Івана Бойка
Івана Виговського вулиця                                             	вулиця Івана Виговського
Івана Гонти вулиця                                                   	вулиця Івана Гонти
Івана Данилюка вулиця                                                	вулиця Івана Данилюка
Івана Данилюка провулок                                              	провулок Івана Данилюка
Івана Дзюби вулиця                                                   	вулиця Івана Дзюби
Івана Карпенка-Карого вулиця                                         	вулиця Івана Карпенка-Карого
Івана Котляревського вулиця                                          	вулиця Івана Котляревського
Івана Котляревського провулок                                        	провулок Івана Котляревського
Івана Мазепи вулиця                                                  	вулиця Івана Мазепи
Івана Мазепи провулок                                                	провулок Івана Мазепи
Івана Миколайчука вулиця                                             	вулиця Івана Миколайчука
Івана Миколайчука провулок                                           	провулок Івана Миколайчука
Івана Огієнка вулиця                                                 	вулиця Івана Огієнка
Івана Павла ІІ вулиця                                                	вулиця Івана Павла II
Івана Пулюя вулиця                                                   	вулиця Івана Пулюя
Івана Пулюя провулок                                                 	провулок Івана Пулюя
Івана Пулюя тупик                                                    	тупик Івана Пулюя
Івана Піддубного вулиця                                              	вулиця Івана Піддубного
Івана Підкови вулиця                                                 	вулиця Івана Підкови
Івана Світличного вулиця                                             	вулиця Івана Світличного
Івана Світличного провулок                                           	провулок Івана Світличного
Івана Сірка вулиця                                                   	вулиця Івана Сірка
Івана Сірка провулок                                                 	провулок Івана Сірка
Івана Федорова вулиця                                                	вулиця Івана Федорова
Івана Федорова провулок                                              	провулок Івана Федорова
Івана Франка вулиця                                                  	вулиця Івана Франка
Івана Франка провулок                                                	провулок Івана Франка
Івана Франко вулиця                                                  	вулиця Івана Франка
Івана Хоменка вулиця                                                 	вулиця Івана Хоменка
Івана Шиповича вулиця                                                	вулиця Івана Шиповича
Івана Щирського вулиця                                               	вулиця Івана Щирського
Івана Яковенка вулиця                                                	вулиця Івана Яковенка
Івана-Павла ІІ вулиця                                                	вулиця Івана-Павла II
Іванв Мазепи вулиця                                                  	вулиця Івана Мазепи
Івасюка вулиця                                                       	вулиця Івасюка
Ігоря Андріїшина вулиця                                              	вулиця Ігоря Андріїшина
Ігоря Костецького вулиця                                             	вулиця Ігоря Костецького
Ігоря Римара та Сергія Ковриги вулиця                                	вулиця Ігоря Римара та Сергія Ковриги
Ігоря Савченка провулок                                              	провулок Ігоря Савченка
Ігоря Сікорського вулиця                                             	вулиця Ігоря Сікорського
Іллі Антонюка вулиця                                                 	вулиця Іллі Антонюка
Іоана Богослова вулиця                                               	вулиця Іоана Богослова
Іскри і Кочубея вулиця                                               	вулиця Іскри і Кочубея
Ісмаїла Гаспринського вулиця                                         	вулиця Ісмаїла Гаспринського
Ісмаїла Гаспринського провулок                                       	провулок Ісмаїла Гаспринського
Їжаківського вулиця                                                  	вулиця Їжаківського
А. Грубого вулиця                                                    	вулиця А. Грубого
А. Добраня вулиця                                                    	вулиця А. Добраня
Автомобілістів вулиця                                                	вулиця Автомобілістів
Агатангела Кримського вулиця                                         	вулиця Агатангела Кримського
Агатангела Кримського провулок                                       	провулок Агатангела Кримського
Аграрана вулиця                                                      	Аграрна вулиця
Айвазовського вулиця                                                 	вулиця Айвазовського
Академіка Боголюбова вулиця                                          	вулиця Академіка Боголюбова
Академіка Буняковського вулиця                                       	вулиця Академіка Буняковського
Академіка Вернадського вулиця                                        	вулиця Академіка Вернадського
Академіка Заболотного вулиця                                         	вулиця Академіка Заболотного
Академіка Заболотного провулок                                       	провулок Академіка Заболотного
Академіка Павлова вулиця                                             	вулиця Академіка Павлова
Академіка Ющенка вулиця                                              	вулиця Академіка Ющенка
Академіка Янгеля вулиця                                              	вулиця Академіка Янгеля
Академіка Янгеля провулок                                            	провулок Академіка Янгеля
Алеї вулиця                                                          	вулиця Алеї
Алли Горської вулиця                                                 	вулиця Алли Горської
Альферова вулиця                                                     	вулиця Альферова
Амосова вулиця                                                       	вулиця Амосова
Амосова провулок                                                     	провулок Амосова
Анастасії Медвідь вулиця                                             	вулиця Анастасії Медвідь
Анатолія Базилевича вулиця                                           	вулиця Анатолія Базилевича
Анатолія Бортняка вулиця                                             	вулиця Анатолія Бортняка
Анатолія Обухова вулиця                                              	вулиця Анатолія Обухова
Анатолія Пачевського вулиця                                          	вулиця Анатолія Пачевського
Анатолія Свидницького вулиця                                         	вулиця Анатолія Свидницького
Анатолія Черниша вулиця                                              	вулиця Анатолія Черниша
Андрея Шептицького вулиця                                            	вулиця Андрея Шептицького
Андрея Шептицького провулок                                          	провулок Андрея Шептицького
Андрійчука вулиця                                                    	вулиця Андрійчука
Андрія Долейка вулиця                                                	вулиця Андрія Долейка
Андрія Малишка вулиця                                                	вулиця Андрія Малишка
Андрія Первозванного вулиця                                          	вулиця Андрія Первозванного
Андрія Шептицького вулиця                                            	вулиця Андрія Шептицького
Антона Листопада вулиця                                              	вулиця Антона Листопада
Антона Листопада провулок                                            	провулок Антона Листопада
Антона Турчановича вулиця                                            	вулиця Антона Турчановича
Антоновича вулиця                                                    	вулиця Антоновича
Антоновича провулок                                                  	провулок Антоновича
Антонця вулиця                                                       	вулиця Антонця
Антонінка вулиця                                                     	вулиця Антонінка
Артема вулиця                                                        	вулиця Артема
Артема провулок                                                      	провулок Артема
Артура Венжика вулиця                                                	вулиця Артура Венжика
Архитектора Кобелєва вулиця                                          	вулиця Архітектора Кобелєва
Архитектора Кобелєва провулок                                        	провулок Архітектора Кобелєва
Архітектора Артинова вулиця                                          	вулиця Архітектора Артинова
Архітектора Кеди вулиця                                              	вулиця Архітектора Кеди
Аріадни Стебельської вулиця                                          	вулиця Аріадни Стебельської
Асмолова вулиця                                                      	вулиця Асмолова
Б. Хмельницького вулиця                                              	вулиця Б. Хмельницького
Б.Шуляка вулиця                                                      	вулиця Б. Шуляка
Бабаджаняна вулиця                                                   	вулиця Бабаджаняна
Бабія вулиця                                                         	вулиця Бабія
Багаутдіна Мітарова вулиця                                           	вулиця Багаутдіна Мітарова
Баженова вулиця                                                      	вулиця Баженова
Баженова провулок                                                    	провулок Баженова
Бакалова вулиця                                                      	вулиця Бакалова
Баранова вулиця                                                      	вулиця Баранова
Барляєва вулиця                                                      	вулиця Барляєва
Баумана вулиця                                                       	вулиця Баумана
Бевза вулиця                                                         	вулиця Бевза
Берегового вулиця                                                    	вулиця Берегового
Березовського вулиця                                                 	вулиця Березовського
Березівка вулиця                                                     	вулиця Березівка
Бернарда Претвича вулиця                                             	вулиця Бернарда Претвича
Бернарда Претвича провулок                                           	провулок Бернарда Претвича
Берута провулок                                                      	провулок Берута
Бесарабова вулиця                                                    	вулиця Бесарабова
Бестужева вулиця                                                     	вулиця Бестужева
Бистрицького вулиця                                                  	вулиця Бистрицького
Бичковського вулиця                                                  	вулиця Бичковського
Блока вулиця                                                         	вулиця Блока
Блюхера вулиця                                                       	вулиця Блюхера
Боброва вулиця                                                       	вулиця Боброва
Богачука вулиця                                                      	вулиця Богачука
Богдана Іщука вулиця                                                 	вулиця Богдана Іщука
Богдана Ступки вулиця                                                	вулиця Богдана Ступки
Богдана Хмельницкого вулиця                                          	вулиця Богдана Хмельницкого
Богдана Хмельницького вулиця                                         	вулиця Богдана Хмельницького
Богдана Хмельницького провулок                                       	провулок Богдана Хмельницького
Богомольця вулиця                                                    	вулиця Богомольця
Богомольця провулок                                                  	провулок Богомольця
Богомольця тупик                                                     	тупик Богомольця
Богуна вулиця                                                        	вулиця Богуна
Боженка вулиця                                                       	вулиця Боженка
Боженко вулиця                                                       	вулиця Боженко
Бойка вулиця                                                         	вулиця Бойка
Бони Сфорци вулиця                                                   	вулиця Бони Сфорци
Бориса Гмирі вулиця                                                  	вулиця Бориса Гмирі
Бориса Грінченка вулиця                                              	вулиця Бориса Грінченка
Бориса Крижевого вулиця                                              	вулиця Бориса Крижевого
Бориса Лук’яновського вулиця                                         	вулиця Бориса Лукʼяновського
Бориса Олійника вулиця                                               	вулиця Бориса Олійника
Бориса Шкляра вулиця                                                 	вулиця Бориса Шкляра
Борівка вулиця                                                       	вулиця Борівка
Братерства вулиця                                                    	вулиця Братерства
Братів Западинських вулиця                                           	вулиця Братів Западинських
Братів Катеренюків вулиця                                            	вулиця Братів Катеренюків
Братів Кислюків вулиця                                               	вулиця Братів Кислюків
Братів Котенків вулиця                                               	вулиця Братів Котенків
Братів Котенків провулок                                             	провулок Братів Котенків
Братів Лопушанів вулиця                                              	вулиця Братів Лопушанів
Братів Мельників вулиця                                              	вулиця Братів Мельників
Братів Михайлишиних вулиця                                           	вулиця Братів Михайлишиних
Братів Михайлюків вулиця                                             	вулиця Братів Михайлюків
Братів Обухів вулиця                                                 	вулиця Братів Обухів
Братів Павленків вулиця                                              	вулиця Братів Павленків
Броніцького вулиця                                                   	вулиця Броніцького
Бублікова вулиця                                                     	вулиця Бублікова
Будкевича вулиця                                                     	вулиця Будкевича
Будьонного вулиця                                                    	вулиця Будьонного
Будьоного вулиця                                                     	вулиця Будьоного
Будівельників вулиця                                                 	вулиця Будівельників
Будівельників провулок                                               	провулок Будівельників
Буняковського вулиця                                                 	вулиця Буняковського
Бурти вулиця                                                         	вулиця Бурти
Бучми вулиця                                                         	вулиця Бучми
Бучми провулок                                                       	провулок Бучми
Буянова вулиця                                                       	вулиця Буянова
Бєлінського вулиця                                                   	вулиця Бєлінського
Білоченка вулиця                                                     	вулиця Білоченка
Білошкурського вулиця                                                	вулиця Білошкурського
В'ячеслава Чорновола вулиця                                          	вулиця Вʼячеслава Чорновола
В. Земляка вулиця                                                    	вулиця В. Земляка
В. Котика вулиця                                                     	вулиця В. Котика
В. Котика провулок                                                   	провулок В. Котика
В. Кузьмінова вулиця                                                 	вулиця В. Кузьмінова
В. Наумова провулок                                                  	провулок В. Наумова
В. С. Драгомира вулиця                                               	вулиця В. С. Драгомира
В. Семенюка вулиця                                                   	вулиця В. Семенюка
В. Стуса вулиця                                                      	вулиця В. Стуса
В. Терешкової вулиця                                                 	вулиця В. Терешкової
В. Чорновола вулиця                                                  	вулиця В. Чорновола
В.Ілика вулиця                                                       	вулиця В. Ілика
В.Беделя вулиця                                                      	вулиця В. Беделя
В.Косіянчука вулиця                                                  	вулиця В. Косіянчука
В.М.Кавуна вулиця                                                    	вулиця В. М. Кавуна
В.Соколовського вулиця                                               	вулиця В. Соколовського
В.Сосюри вулиця                                                      	вулиця В. Сосюри
Вадима Нестерчука вулиця                                             	вулиця Вадима Нестерчука
Вадима Нестерчука провулок                                           	провулок Вадима Нестерчука
Вадима Олійника вулиця                                               	вулиця Вадима Олійника
Ваксмана вулиця                                                      	вулиця Ваксмана
Валентина Білошкурського вулиця                                      	вулиця Валентина Білошкурського
Валентина Комарова вулиця                                            	вулиця Валентина Комарова
Валентина Отамановського вулиця                                      	вулиця Валентина Отамановського
Валентини Грабовської вулиця                                         	вулиця Валентини Грабовської
Валеріана Боржковського вулиця                                       	вулиця Валеріана Боржковського
Валерія Брезденюка вулиця                                            	вулиця Валерія Брезденюка
Валерія Лобановського вулиця                                         	вулиця Валерія Лобановського
Валі Котик вулиця                                                    	вулиця Валі Котика
Валі Котика вулиця                                                   	вулиця Валі Котика
Василя Барки вулиця                                                  	вулиця Василя Барки
Василя Барки провулок                                                	провулок Василя Барки
Василя Гречулевича вулиця                                            	вулиця Василя Гречулевича
Василя Думанського вулиця                                            	вулиця Василя Думанського
Василя Копитка вулиця                                                	вулиця Василя Копитка
Василя Кричевського вулиця                                           	вулиця Василя Кричевського
Василя Кричевського провулок                                         	провулок Василя Кричевського
Василя Кулака вулиця                                                 	вулиця Василя Кулака
Василя Липківського вулиця                                           	вулиця Василя Липківського
Василя Пирогова вулиця                                               	вулиця Василя Пирогова
Василя Порика вулиця                                                 	вулиця Василя Порика
Василя Сильвестрова вулиця                                           	вулиця Василя Сильвестрова
Василя Симоненка вулиця                                              	вулиця Василя Симоненка
Василя Симоненка провулок                                            	провулок Василя Симоненка
Василя Сліпака вулиця                                                	вулиця Василя Сліпака
Василя Стефаника вулиця                                              	вулиця Василя Стефаника
Василя Стуса вулиця                                                  	вулиця Василя Стуса
Василя Тютюнника вулиця                                              	вулиця Василя Тютюнника
Василя Хмелюка вулиця                                                	вулиця Василя Хмелюка
Василівка вулиця                                                     	вулиця Василівка
Васьковського вулиця                                                 	вулиця Васьковського
Васютинських вулиця                                                  	вулиця Васютинських
Ватутіна вулиця                                                      	вулиця Ватутіна
Ватутіна провулок                                                    	провулок Ватутіна
Вацлава Гавела вулиця                                                	вулиця Вацлава Гавела
Вацлава Гавела провулок                                              	провулок Вацлава Гавела
Верещагіна провулок                                                  	провулок Верещагіна
Верлана вулиця                                                       	вулиця Верлана
Вернадського вулиця                                                  	вулиця Вернадського
Вернадського провулок                                                	провулок Вернадського
Верхарна вулиця                                                      	вулиця Верхарна
Веселівка вулиця                                                     	вулиця Веселівка
Весилий Хутір вулиця                                                 	вулиця Веселий Хутір
Ветеранів Війни вулиця                                               	вулиця Ветеранів Війни
Ветеранів вулиця                                                     	вулиця Ветеранів
Визволення вулиця                                                    	вулиця Визволення
Визволителів вулиця                                                  	вулиця Визволителів
Винниченка вулиця                                                    	вулиця Винниченка
Високовича вулиця                                                    	вулиця Високовича
Висоцького вулиця                                                    	вулиця Висоцького
Вишенька вулиця                                                      	вулиця Вишенька
Вишенька провулок                                                    	провулок Вишенька
Вишневий Сад проїзд                                                  	проїзд Вишневий Сад
Вишневського вулиця                                                  	вулиця Вишневського
Владислава Городецького вулиця                                       	вулиця Владислава Городецького
Водоп’янова вулиця                                                   	вулиця Водопʼянова
Возз’єднання вулиця                                                  	вулиця Воззʼєднання
Вознюка вулиця                                                       	вулиця Вознюка
Войкова вулиця                                                       	вулиця Войкова
Войкова провулок                                                     	провулок Войкова
Войцехівського вулиця                                                	вулиця Войцехівського
Волинця вулиця                                                       	вулиця Волинця
Волкова вулиця                                                       	вулиця Волкова
Володарського вулиця                                                 	вулиця Володарського
Володимира Івасюка вулиця                                            	вулиця Володимира Івасюка
Володимира Івасюка провулок                                          	провулок Володимира Івасюка
Володимира Антоновича вулиця                                         	вулиця Володимира Антоновича
Володимира Великого вулиця                                           	вулиця Володимира Великого
Володимира Винниченка вулиця                                         	вулиця Володимира Винниченка
Володимира Забаштанського вулиця                                     	вулиця Володимира Забаштанського
Володимира Киянка вулиця                                             	вулиця Володимира Киянка
Володимира Маняка вулиця                                             	вулиця Володимира Маняка
Володимира Полупанова вулиця                                         	вулиця Володимира Полупанова
Володимира Свідзінського вулиця                                      	вулиця Володимира Свідзінського
Володимира Сліпенчука вулиця                                         	вулиця Володимира Сліпенчука
Володимира Стеценка вулиця                                           	вулиця Володимира Стеценка
Володимира Черкасова вулиця                                          	вулиця Володимира Черкасова
Волонтерів вулиця                                                    	вулиця Волонтерів
Воровського вулиця                                                   	вулиця Воровського
Вороніна вулиця                                                      	вулиця Вороніна
Ворошилова вулиця                                                    	вулиця Ворошилова
Воїнів-добровольців вулиця                                           	вулиця Воїнів-Добровольців
Воїнів-інтернаціоналістів вулиця                                     	вулиця Воїнів-Інтернаціоналістів
Врублевського вулиця                                                 	вулиця Врублевського
Врублевського провулок                                               	провулок Врублевського
Всеволода Нестайка вулиця                                            	вулиця Всеволода Нестайка
Відродження вулиця                                                   	вулиця Відродження
Віктора Блащука вулиця                                               	вулиця Віктора Блащука
Вінницьке лісництво вулиця                                           	вулиця Вінницьке Лісництво
Віталія Печенюка вулиця                                              	вулиця Віталія Печенюка
Віталія Примакова вулиця                                             	вулиця Віталія Примакова
Вішенька провулок                                                    	провулок Вішенька
В’ячеслава Катрича вулиця                                            	вулиця Вʼячеслава Катрича
В’ячеслава Чорновола вулиця                                          	вулиця Вʼячеслава Чорновола
Г. Лободи вулиця                                                     	вулиця Г. Лободи
Г. Сковороди вулиця                                                  	вулиця Г. Сковороди
Г.Морозової вулиця                                                   	вулиця Г. Морозової
ГЕС провулок                                                         	провулок ГЕС
Гаврилюка Ігоря вулиця                                               	вулиця Ігоря Гаврилюка
Гавришко вулиця                                                      	вулиця Гавришко
Гагагіна вулиця                                                      	вулиця Гагаріна
Гагаріна вулиця                                                      	вулиця Гагаріна
Гагаріна площа                                                       	площа Гагаріна
Гагаріна провулок                                                    	провулок Гагаріна
Гагаріна проїзд                                                      	проїзд Гагаріна
Газовиків проїзд                                                     	проїзд Газовиків
Гайдамацький провулок                                                	провулок Гайдамацький
Гайдара вулиця                                                       	вулиця Гайдара
Гайдара тупик                                                        	тупик Гайдара
Галицьких Вояків вулиця                                              	вулиця Галицьких Вояків
Галицьких Стрільців вулиця                                           	вулиця Галицьких Стрільців
Галицького провулок                                                  	провулок Галицького
Гаркушина вулиця                                                     	вулиця Гаркушина
Гарника вулиця                                                       	вулиця Гарника
Гастелло вулиця                                                      	вулиця Гастелло
Гейдена вулиця                                                       	вулиця Гейдена
Генадія Ніколайчука вулиця                                           	вулиця Генадія Ніколайчука
Генерала Арабея вулиця                                               	вулиця Генерала Арабея
Генерала Безручка вулиця                                             	вулиця Генерала Безручка
Генерала Безручка провулок                                           	провулок Генерала Безручка
Генерала Безручка проїзд                                             	проїзд Генерала Безручка
Генерала Гандзюка вулиця                                             	вулиця Генерала Гандзюка
Генерала Григоренка вулиця                                           	вулиця Генерала Григоренка
Генерала Григоренка провулок                                         	провулок Генерала Григоренка
Генерала Дерев’янка вулиця                                           	вулиця Генерала Деревʼянка
Генерала Дерев’янка провулок                                         	провулок Генерала Деревʼянка
Генерала Заболотного вулиця                                          	вулиця Генерала Заболотного
Генерала Трейка вулиця                                               	вулиця Генерала Трейка
Георгія Нарбута вулиця                                               	вулиця Георгія Нарбута
Георгія Нарбута провулок                                             	провулок Георгія Нарбута
Герасимчука вулиця                                                   	вулиця Герасимчука
Героїв Афганістану вулиця                                            	вулиця Героїв Афганістану
Героїв Крут вулиця                                                   	вулиця Героїв Крут
Героїв Крут тупик                                                    	тупик Героїв Крут
Героїв Майдану вулиця                                                	вулиця Героїв Майдану
Героїв Майдану площа                                                 	площа Героїв Майдану
Героїв Майдану провулок                                              	провулок Героїв Майдану
Героїв Нацгвардії вулиця                                             	вулиця Героїв Нацгвардії
Героїв Небесної Сотні вулиця                                         	вулиця Героїв Небесної Сотні
Героїв Сталінграда площа                                             	площа Героїв Сталінграду
Героїв України вулиця                                                	вулиця Героїв України
Героїв України провулок                                              	провулок Героїв України
Героїв Чорнобиля вулиця                                              	вулиця Героїв Чорнобиля
Героїв вулиця                                                        	вулиця Героїв
Героїв поліції вулиця                                                	вулиця Героїв Поліції
Героїв проспект                                                      	проспект Героїв
Герцена вулиця                                                       	вулиця Герцена
Герцена провулок                                                     	провулок Герцена
Гетьмана Дорошенка вулиця                                            	вулиця Гетьмана Дорошенка
Гетьмана Мазепи вулиця                                               	вулиця Гетьмана Мазепи
Гетьмана Мазепи проїзд 1-й                                           	1-й проїзд Гетьмана Мазепи
Гетьмана Мазепи проїзд 2-й                                           	2-й проїзд Гетьмана Мазепи
Гетьмана Мазепи проїзд 3-й                                           	3-й проїзд Гетьмана Мазепи
Гетьмана Сагайдачного вулиця                                         	вулиця Гетьмана Сагайдачного
Гетьмана Сагайдачного провулок                                       	провулок Гетьмана Сагайдачного
Гладкова вулиця                                                      	вулиця Гладкова
Гладкова провулок                                                    	провулок Гладкова
Глинського провулок                                                  	провулок Глинського
Глушкова вулиця                                                      	вулиця Глушкова
Гліба Успенського вулиця                                             	вулиця Гліба Успенського
Глібова вулиця                                                       	вулиця Глібова
Глінки вулиця                                                        	вулиця Глінки
Гната Мороза вулиця                                                  	вулиця Гната Мороза
Гната Танцюри вулиця                                                 	вулиця Гната Танцюри
Гната Танцюри тупик                                                  	тупик Гната Танцюри
Гната Юри вулиця                                                     	вулиця Гната Юри
Гната Юри провулок                                                   	провулок Гната Юри
Гоголя вулиця                                                        	вулиця Гоголя
Гоголя провулок                                                      	провулок Гоголя
Гонти вулиця                                                         	вулиця Гонти
Гонти провулок                                                       	провулок Гонти
Гонти проїзд                                                         	проїзд Гонти
Горенчука вулиця                                                     	вулиця Горенчука
Горького вулиця                                                      	вулиця Горького
Горького провулок                                                    	провулок Горького
Горєлова вулиця                                                      	вулиця Горєлова
Грабовського вулиця                                                  	вулиця Грабовського
Грабовського провулок                                                	провулок Грабовського
Грибальова вулиця                                                    	вулиця Грибальова
Грибоєдова вулиця                                                    	вулиця Грибоєдова
Грибоєдова провулок                                                  	провулок Грибоєдова
Григоровичів-Барських вулиця                                         	вулиця Григоровичів-Барських
Григорія Сковороди вулиця                                            	вулиця Григорія Сковороди
Григорія Чупринки вулиця                                             	вулиця Григорія Чупринки
Гриньова вулиця                                                      	вулиця Гриньова
Гришина провулок                                                     	провулок Гришина
Грушевсько вулиця                                                    	вулиця Грушевського
Грушевського вулиця                                                  	вулиця Грушевського
Грушевського провулок                                                	провулок Грушевського
Гудзенка вулиця                                                      	вулиця Гудзенка
Гулака-Артемовського вулиця                                          	вулиця Гулака-Артемовського
Гулака-Артемовського провулок                                        	провулок Гулака-Артемовського
Гулевич вулиця                                                       	вулиця Гулевич
Гуменюка вулиця                                                      	вулиця Гуменюка
Гурвіча вулиця                                                       	вулиця Гурвіча
Густава Брілінга провулок                                            	провулок Густава Брілінга
Гідності вулиця                                                      	вулиця Гідності
Гійома Боплана вулиця                                                	вулиця Гійома Боплана
Д.Бідного вулиця                                                     	вулиця Д. Бідного
Данила Галицького вулиця                                             	вулиця Данила Галицького
Данила Нечая вулиця                                                  	вулиця Данила Нечая
Данила Нечая проїзд                                                  	проїзд Данила Нечая
Декабристів вулиця                                                   	вулиця Декабристів
Дем'яна Бєдного вулиця                                               	вулиця Демʼяна Бєдного
Демченка провулок                                                    	провулок Демченка
Джеймса Мейса вулиця                                                 	вулиця Джеймса Мейса
Джеймса Мейса провулок                                               	провулок Джеймса Мейса
Джержинського вулиця                                                 	вулиця Джержинського
Джозефа Конрада вулиця                                               	вулиця Джозефа Конрада
Дзержинського вулиця                                                 	вулиця Дзержинського
Дзержинського провулок                                               	провулок Дзержинського
Димитрова вулиця                                                     	вулиця Димитрова
Димитрова провулок                                                   	провулок Димитрова
Димчука вулиця                                                       	вулиця Димчука
Дмитра Білоконя вулиця                                               	вулиця Дмитра Білоконя
Дмитра Білоконя провулок                                             	провулок Дмитра Білоконя
Дмитра Гнатюка провулок                                              	провулок Дмитра Гнатюка
Дмитра Майбороди вулиця                                              	вулиця Дмитра Майбороди
Дмитра Марковича вулиця                                              	вулиця Дмитра Марковича
Дмитра Марковича провулок                                            	провулок Дмитра Марковича
Дмитра Михайловського вулиця                                         	вулиця Дмитра Михайловського
Дмитра Михайловського провулок                                       	провулок Дмитра Михайловського
Дмитра Франішина вулиця                                              	вулиця Дмитра Франішина
Дмитра Фурманова вулиця                                              	вулиця Дмитра Фурманова
Дмитра Шкарбуна вулиця                                               	вулиця Дмитра Шкарбуна
Добрих Сусідів вулиця                                                	вулиця Добрих Сусідів
Добровольців вулиця                                                  	вулиця Добровольців
Добролюбова вулиця                                                   	вулиця Добролюбова
Добролюбова провулок                                                 	провулок Добролюбова
Добросусідства провулок                                              	провулок Добросусідства
Доватора вулиця                                                      	вулиця Доватора
Довбуша вулиця                                                       	вулиця Довбуша
Довженка вулиця                                                      	вулиця Довженка
Довженка провулок                                                    	провулок Довженка
Докучаєва вулиця                                                     	вулиця Докучаєва
Дорошенка вулиця                                                     	вулиця Дорошенка
Достоєвського вулиця                                                 	вулиця Достоєвського
Драй-Хмари вулиця                                                    	вулиця Драй-Хмари
Дружби вулиця                                                        	вулиця Дружби
Дубініна вулиця                                                      	вулиця Дубініна
Думанського вулиця                                                   	вулиця Думанського
Дундича вулиця                                                       	вулиця Дундича
Діонісія Міклера вулиця                                              	вулиця Діонісія Міклера
Діонісія Міклера провулок                                            	провулок Діонісія Міклера
Едельштейна вулиця                                                   	вулиця Едельштейна
Енгельса вулиця                                                      	вулиця Енгельса
Енгельса проїзд                                                      	проїзд Енгельса
Енергетиків вулиця                                                   	вулиця Енергетиків
Енергетиків провулок                                                 	провулок Енергетиків
Ентузіастів вулиця                                                   	вулиця Ентузіастів
Жанова вулиця                                                        	вулиця Жанова
Жарчинського вулиця                                                  	вулиця Жарчинського
Жданова вулиця                                                       	вулиця Жданова
Ждерельна вулиця                                                     	Джерельна вулиця
Житлове Містечко вулиця                                              	вулиця Житлове Містечко
Жукова вулиця                                                        	вулиця Жукова
Жукова провулок                                                      	провулок Жукова
Жуковського вулиця                                                   	вулиця Жуковського
Жуковського провулок                                                 	провулок Жуковського
Журавльова вулиця                                                    	вулиця Журавльова
Забаштанського вулиця                                                	вулиця Забаштанського
Заболотного вулиця                                                   	вулиця Заболотного
Заболотного провулок                                                 	провулок Заболотного
Завойського вулиця                                                   	вулиця Завойського
Загребельного вулиця                                                 	вулиця Загребельного
Задворного вулиця                                                    	вулиця Задворного
Залiзнична вулиця                                                    	Залізнична вулиця
Заливанського вулиця                                                 	вулиця Заливанського
Залізнічна вулиця                                                    	Залізнична вулиця
Заньковецької вулиця                                                 	вулиця Заньковецької
Заньковецької провулок                                               	провулок Заньковецької
Запорізького Козацтва вулиця                                         	вулиця Запорізького Козацтва
Заріччя вулиця                                                       	вулиця Заріччя
Затонського вулиця                                                   	вулиця Затонського
Захандревича вулиця                                                  	вулиця Захандревича
Захарчука вулиця                                                     	вулиця Захарчука
Захисників Вітчизни вулиця                                           	вулиця Захисників Вітчизни
Захисників України вулиця                                            	вулиця Захисників України
Захисників неба вулиця                                               	вулиця Захисників Неба
Збишка вулиця                                                        	вулиця Збишка
Зв'язківців провулок                                                 	провулок Звʼязківців
Землевпорядників проїзд                                              	проїзд Землевпорядників
Злагоди вулиця                                                       	вулиця Злагоди
Зодчих вулиця                                                        	вулиця Зодчих
Зорге вулиця                                                         	вулиця Зорге
Зоря провулок                                                        	провулок Зоря
Зої Космодем’янської вулиця                                          	вулиця Зої Космодемʼянської
Зубриліна вулиця                                                     	вулиця Зубриліна
Зубриліна провулок                                                   	провулок Зубриліна
Зубриліна проїзд                                                     	проїзд Зубриліна
Зіндельса вулиця                                                     	вулиця Зіндельса
Йоахима Волошиновського вулиця                                       	вулиця Йоахима Волошиновського
Йосипа Косюка вулиця                                                 	вулиця Йосипа Косюка
Кавуна вулиця                                                        	вулиця Кавуна
Казимира Малевича вулиця                                             	вулиця Казимира Малевича
Казішвілі вулиця                                                     	вулиця Казішвілі
Калашника вулиця                                                     	вулиця Калашника
Калинова провулок                                                    	провулок Калинова
Калініна вулиця                                                      	вулиця Калініна
Калініна провулок                                                    	провулок Калініна
Каменярів вулиця                                                     	вулиця Каменярів
Камянка вулиця                                                       	вулиця Камянка
Кам’янецький провулок                                                	Камʼянецький провулок
Кам’янка вулиця                                                      	вулиця Камʼянка
Карбишева вулиця                                                     	вулиця Карбишева
Карбишева провулок                                                   	провулок Карбишева
Карбишева тупик                                                      	тупик Карбишева
Карла Лібкнехта вулиця                                               	вулиця Карла Лібкнехта
Карла Лібкнехта провулок                                             	провулок Карла Лібкнехта
Карла Маркса вулиця                                                  	вулиця Карла Маркса
Карла Маркса провулок                                                	провулок Карла Маркса
Кармалюка вулиця                                                     	вулиця Кармалюка
Кармелюка вулиця                                                     	вулиця Кармелюка
Кароля Вишневецького вулиця                                          	вулиця Кароля Вишневецького
Карпенка вулиця                                                      	вулиця Карпенка
Карпенка-Карого вулиця                                               	вулиця Карпенка-Карого
Картвелішвілі вулиця                                                 	вулиця Картвелішвілі
Кар’єрна вулиця                                                      	Карʼєрна вулиця
Кар’єрний провулок                                                   	Карʼєрний провулок
Катукова вулиця                                                      	вулиця Катукова
Катукова провулок                                                    	провулок Катукова
Каховка вулиця                                                       	вулиця Каховка
Каховського вулиця                                                   	вулиця Каховського
Каховського провулок                                                 	провулок Каховського
Кашевича вулиця                                                      	вулиця Кашевича
Квятека вулиця                                                       	вулиця Квятека
Квітки Цісик вулиця                                                  	вулиця Квітки Цісик
Кемпа вулиця                                                         	вулиця Кемпа
Кибальчича вулиця                                                    	вулиця Кибальчича
Килимника вулиця                                                     	вулиця Килимника
Кириленка вулиця                                                     	вулиця Кириленка
Київська Новобудова вулиця                                           	вулиця Київська Новобудова
Клари Цеткін вулиця                                                  	вулиця Клари Цеткін
Климентія Домінчена вулиця                                           	вулиця Климентія Домінчена
Княгині Ольги вулиця                                                 	вулиця Княгині Ольги
Княгині Щербатової вулиця                                            	вулиця Княгині Щербатової
Князя Володимира вулиця                                              	вулиця Князя Володимира
Князя Святослава вулиця                                              	вулиця Князя Святослава
Князів Коріатовичів вулиця                                           	вулиця Князів Коріатовичів
Князів Коріатовичів провулок                                         	провулок Князів Коріатовичів
Князів Острозьких вулиця                                             	вулиця Князів Острозьких
Кобзаря вулиця                                                       	вулиця Кобзаря
Кобринця вулиця                                                      	вулиця Кобринця
Ковалівка вулиця                                                     	вулиця Ковалівка
Ковпака вулиця                                                       	вулиця Ковпака
Ковпака провулок                                                     	провулок Ковпака
Кожедуба вулиця                                                      	вулиця Кожедуба
Козацький Шлях вулиця                                                	вулиця Козацький Шлях
Козаченка вулиця                                                     	вулиця Козаченка
Козицького вулиця                                                    	вулиця Козицького
Козоріза вулиця                                                      	вулиця Козоріза
Комарова вулиця                                                      	вулиця Комарова
Комарова провулок                                                    	провулок Комарова
Комонавтів вулиця                                                    	вулиця Космонавтів
Комунарів вулиця                                                     	вулиця Комунарів
Кондратюка вулиця                                                    	вулиця Кондратюка
Кондрацького вулиця                                                  	вулиця Кондрацького
Кондрацького провулок                                                	провулок Кондрацького
Константиновича вулиця                                               	вулиця Константиновича
Конєва вулиця                                                        	вулиця Конєва
Копайгородського вулиця                                              	вулиця Копайгородського
Коперника вулиця                                                     	вулиця Коперника
Копитка вулиця                                                       	вулиця Копитка
Корнійчука вулиця                                                    	вулиця Корнійчука
Короленка вулиця                                                     	вулиця Короленка
Корольова вулиця                                                     	вулиця Корольова
Корольова провулок                                                   	провулок Корольова
Корольова проїзд                                                     	проїзд Корольова
Космонавта Комарова вулиця                                           	вулиця Космонавта Комарова
Космонавтів вулиця                                                   	вулиця Космонавтів
Космонавтів проспект                                                 	проспект Космонавтів
Костецького вулиця                                                   	вулиця Костецького
Костя Широцького вулиця                                              	вулиця Костя Широцького
Костя Широцького провулок                                            	провулок Костя Широцького
Костянтина Василенка вулиця                                          	вулиця Костянтина Василенка
Котляревського вулиця                                                	вулиця Котляревського
Котляревського провулок                                              	провулок Котляревського
Котовського вулиця                                                   	вулиця Котовського
Котовського провулок                                                 	провулок Котовського
Котовсього вулиця                                                    	вулиця Котовсього
Коцюбинского вулиця                                                  	вулиця Коцюбинского
Коцюбинського вулиця                                                 	вулиця Коцюбинського
Коцюбинського провулок                                               	провулок Коцюбинського
Коцюбинського проспект                                               	проспект Коцюбинського
Коцюбінського вулиця                                                 	вулиця Коцюбінського
Кошового вулиця                                                      	вулиця Кошового
Кравченка вулиця                                                     	вулиця Кравченка
Кравчика вулиця                                                      	вулиця Кравчика
Красіна вул.                                                         	вулиця Красіна
Красіна вулиця                                                       	вулиця Красіна
Кривицького вулиця                                                   	вулиця Кривицького
Кривоноса вулиця                                                     	вулиця Кривоноса
Криворучка вулиця                                                    	вулиця Криворучка
Кривошеіна вулиця                                                    	вулиця Кривошеіна
Крилова вулиця                                                       	вулиця Крилова
Крилова провулок                                                     	провулок Крилова
Кропивницького вулиця                                                	вулиця Кропивницького
Кропоткіна вулиця                                                    	вулиця Кропоткіна
Крупської вулиця                                                     	вулиця Крупської
Крутнів Яр вулиця                                                    	вулиця Крутнів Яр
Крутнів Яр провулок                                                  	провулок Крутнів Яр
Ксаверівка вулиця                                                    	вулиця Ксаверівка
Кузнецова вулиця                                                     	вулиця Кузнецова
Кузнецова провулок                                                   	провулок Кузнецова
Кузнєцова вулиця                                                     	вулиця Кузнєцова
Куйбишева вулиця                                                     	вулиця Куйбишева
Куйбишева провулок                                                   	провулок Куйбишева
Куликівського вулиця                                                 	вулиця Куликівського
Куркудимівка вулиця                                                  	вулиця Куркудимівка
Кут вулиця                                                           	вулиця Кут
Кутузова вулиця                                                      	вулиця Кутузова
Кутузова провулок                                                    	провулок Кутузова
Кутузова тупик                                                       	тупик Кутузова
Куцого вулиця                                                        	вулиця Куцого
Кушніра вулиця                                                       	вулиця Кушніра
Кірова вулиця                                                        	вулиця Кірова
Кірова провулок                                                      	провулок Кірова
Л. Українки вулиця                                                   	вулиця Л. Українки
Лавреньова вулиця                                                    	вулиця Лавреньова
Лагоди вулиця                                                        	вулиця Лагоди
Лазо вулиця                                                          	вулиця Лазо
Лебединського вулиця                                                 	вулиця Лебединського
Лева Семполовського вулиця                                           	вулиця Лева Семполовського
Лева Симиренка вулиця                                                	вулиця Лева Симиренка
Левада вулиця                                                        	вулиця Левада
Левицького вулиця                                                    	вулиця Левицького
Левка Лук'яненка провулок                                            	провулок Левка Лукʼяненка
Левка Лук’яненка вулиця                                              	вулиця Левка Лукʼяненка
Левка Лук’яненка провулок                                            	провулок Левка Лукʼяненка
Левка Симиренка вулиця                                               	вулиця Левка Симиренка
Лемі Українки вулиця                                                 	вулиця Лесі Українки
Ленських Подій вулиця                                                	вулиця Ленських Подій
Ленських Подій провулок                                              	провулок Ленських Подій
Леніга вулиця                                                        	вулиця Леніга
Леніна вулиця                                                        	вулиця Леніна
Леніна провулок                                                      	провулок Леніна
Леонтовича вулиця                                                    	вулиця Леонтовича
Леонтовича провулок                                                  	провулок Леонтовича
Леонтовіча вулиця                                                    	вулиця Леонтовіча
Леоніда Глібова вулиця                                               	вулиця Леоніда Глібова
Леоніда Каденюка вулиця                                              	вулиця Леоніда Каденюка
Леоніда Каденюка провулок                                            	провулок Леоніда Каденюка
Леоніда Кеденюка вулиця                                              	вулиця Леоніда Кеденюка
Леоніда Красіна вулиця                                               	вулиця Леоніда Красіна
Леоніда Мосендза вулиця                                              	вулиця Леоніда Мосендза
Леоніда Ординського вулиця                                           	вулиця Леоніда Ординського
Леоніда Полянського вулиця                                           	вулиця Леоніда Полянського
Лермонтова вулиця                                                    	вулиця Лермонтова
Лермонтова провулок                                                  	провулок Лермонтова
Лермонтова тупик                                                     	тупик Лермонтова
Леся Курбаса вулиця                                                  	вулиця Леся Курбаса
Лесі Українки вулиця                                                 	вулиця Лесі Українки
Лесі Українки провулок                                               	провулок Лесі Українки
Лещенка вулиця                                                       	вулиця Лещенка
Лиса Гора вулиця                                                     	вулиця Лиса Гора
Лисенка вулиця                                                       	вулиця Лисенка
Лисенка провулок                                                     	провулок Лисенка
Литвиненка вулиця                                                    	вулиця Литвиненка
Ломоносова вулиця                                                    	вулиця Ломоносова
Луначарського вулиця                                                 	вулиця Луначарського
Льва Толстого вулиця                                                 	вулиця Льва Толстого
Льва Толстого провулок                                               	провулок Льва Толстого
Любенка вулиця                                                       	вулиця Любенка
Любомира Гузара вулиця                                               	вулиця Любомира Гузара
Люксембург вулиця                                                    	вулиця Люксембург
Лютневої Революції вулиця                                            	вулиця Лютневої Революції
Лютневої Революції провулок                                          	провулок Лютневої Революції
Лялі Ратушної вулиця                                                 	вулиця Лялі Ратушної
Лялі Ратушної провулок                                               	провулок Лялі Ратушної
Лєрмонтова вулиця                                                    	вулиця Лєрмонтова
Лєрмонтова провулок                                                  	провулок Лєрмонтова
Ліверпуль площа                                                      	площа Ліверпуль
Лізи Чайкіної вулиця                                                 	вулиця Лізи Чайкіної
Лікаря Маєвського вулиця                                             	вулиця Лікаря Маєвського
Ліни Костенко вулиця                                                 	вулиця Ліни Костенко
Ліпіна вулиця                                                        	вулиця Ліпіна
Лісок вулиця                                                         	вулиця Лісок
М. Вакалюк-Дорошенко вулиця                                          	вулиця М. Вакалюк-Дорошенко
М. Грушевського вулиця                                               	вулиця М. Грушевського
М. Зарудного провулок                                                	провулок М. Зарудного
М. Кривоноса вулиця                                                  	вулиця М. Кривоноса
М. Мандибури вулиця                                                  	вулиця М. Мандибури
М.Демченка вулиця                                                    	вулиця М. Демченка
М.Рильського вулиця                                                  	вулиця М. Рильського
Мазурівка вулиця                                                     	вулиця Мазурівка
Майдан вулиця                                                        	вулиця Майдан
Макаренка вулиця                                                     	вулиця Макаренка
Макаренка провулок                                                   	провулок Макаренка
Маковійчука вулиця                                                   	вулиця Маковійчука
Максима Залізняка вулиця                                             	вулиця Максима Залізняка
Максима Кривоноса вулиця                                             	вулиця Максима Кривоноса
Максима Рильського вулиця                                            	вулиця Максима Рильського
Максима Рильського провулок                                          	провулок Максима Рильського
Максима Чорнокнижного вулиця                                         	вулиця Максима Чорнокнижного
Максима Шаповала вулиця                                              	вулиця Максима Шаповала
Максима Шимка вулиця                                                 	вулиця Максима Шимка
Максимовича вулиця                                                   	вулиця Максимовича
Малиновського вулиця                                                 	вулиця Малиновського
Малишка вулиця                                                       	вулиця Малишка
Маліванчука вулиця                                                   	вулиця Маліванчука
Маліновського вулиця                                                 	вулиця Маліновського
Маліновського провулок                                               	провулок Маліновського
Маміна-Сибіряка бульвар                                              	бульвар Маміна-Сибіряка
Маміна-Сибіряка вулиця                                               	вулиця Маміна-Сибіряка
Марка Вовчка вулиця                                                  	вулиця Марка Вовчка
Марко Вовчок бульвар                                                 	бульвар Марко Вовчок
Марко Вовчок вулиця                                                  	вулиця Марко Вовчок
Марцелія Високінського вулиця                                        	вулиця Марцелія Високінського
Марценюка вулиця                                                     	вулиця Марценюка
Марії Гавриш вулиця                                                  	вулиця Марії Гавриш
Марії Заньковецької вулиця                                           	вулиця Марії Заньковецької
Марії Ковач вулиця                                                   	вулиця Марії Ковач
Марії Литвиненко-Вольгемут вулиця                                    	вулиця Марії Литвиненко-Вольгемут
Марії Примаченко вулиця                                              	вулиця Марії Примаченко
Марії Примаченко провулок                                            	провулок Марії Примаченко
Марії Руденко вулиця                                                 	вулиця Марії Руденко
Матвіенка вулиця                                                     	вулиця Матієнка
Матроса Кішки вулиця                                                 	вулиця Матроса Кішки
Матросова вулиця                                                     	вулиця Матросова
Матросова провулок                                                   	провулок Матросова
Машинобудівників вулиця                                              	вулиця Машинобудівників
Маяковського вулиця                                                  	вулиця Маяковського
Маяковського тупик                                                   	тупик Маяковського
Медведєва вулиця                                                     	вулиця Медведєва
Медвецького вулиця                                                   	вулиця Медвецького
Медніка вулиця                                                       	вулиця Медніка
Медніка провулок                                                     	провулок Медніка
Мельника вулиця                                                      	вулиця Мельника
Мельника провулок                                                    	провулок Мельника
Мельника тупик                                                       	тупик Мельника
Мельники провулок                                                    	провулок Мельники
Менделєєва вулиця                                                    	вулиця Менделєєва
Механізаторів вулиця                                                 	вулиця Механізаторів
Мечнікова вулиця                                                     	вулиця Мечнікова
Микитенка вулиця                                                     	вулиця Микитенка
Миколаєнка вулиця                                                    	вулиця Миколаєнка
Миколи Амосова вулиця                                                	вулиця Миколи Амосова
Миколи Амосова провулок                                              	провулок Миколи Амосова
Миколи Бажана вулиця                                                 	вулиця Миколи Бажана
Миколи Битинського вулиця                                            	вулиця Миколи Битинського
Миколи Болярського вулиця                                            	вулиця Миколи Болярського
Миколи Борецького вулиця                                             	вулиця Миколи Борецького
Миколи Ващука вулиця                                                 	вулиця Миколи Ващука
Миколи Зерова вулиця                                                 	вулиця Миколи Зерова
Миколи Костомарова вулиця                                            	вулиця Миколи Костомарова
Миколи Куліша вулиця                                                 	вулиця Миколи Куліша
Миколи Леонтовича вулиця                                             	вулиця Миколи Леонтовича
Миколи Лисенка вулиця                                                	вулиця Миколи Лисенка
Миколи Міхновського вулиця                                           	вулиця Миколи Міхновського
Миколи Некрасова вулиця                                              	вулиця Миколи Некрасова
Миколи Оводова вулиця                                                	вулиця Миколи Оводова
Миколи Стаховського вулиця                                           	вулиця Миколи Стаховського
Миколи Стягайла вулиця                                               	вулиця Миколи Стягайла
Миколи Туніка вулиця                                                 	вулиця Миколи Туніка
Миколи Хвильового вулиця                                             	вулиця Миколи Хвильового
Миколи Холодівського вулиця                                          	вулиця Миколи Холодівського
Миколи Яковченка вулиця                                              	вулиця Миколи Яковченка
Мирного вулиця                                                       	вулиця Мирного
Мирослава Скорика вулиця                                             	вулиця Мирослава Скорика
Миру вулиця                                                          	вулиця Миру
Миру площа                                                           	площа Миру
Миру провулок                                                        	провулок Миру
Митрополита Василя Липківського вулиця                               	вулиця Митрополита Василя Липківського
Митрополита Петра Могили вулиця                                      	вулиця Митрополита Петра Могили
Михайла Вербицького вулиця                                           	вулиця Михайла Вербицького
Михайла Вербицького провулок                                         	провулок Михайла Вербицького
Михайла Грушевського вулиця                                          	вулиця Михайла Грушевського
Михайла Драгоманова вулиця                                           	вулиця Михайла Драгоманова
Михайла Драгоманова провулок                                         	провулок Михайла Драгоманова
Михайла Коцюбинського вулиця                                         	вулиця Михайла Коцюбинського
Михайла Малишенка вулиця                                             	вулиця Михайла Малишенка
Михайла Омеляновича-Павленка вулиця                                  	вулиця Михайла Омеляновича-Павленка
Михайла Старицького вулиця                                           	вулиця Михайла Старицького
Михайла Стельмаха вулиця                                             	вулиця Михайла Стельмаха
Михайличенка вулиця                                                  	вулиця Михайличенка
Михайло Вербицького вулиця                                           	вулиця Михайла Вербицького
Могильчака вулиця                                                    	вулиця Могильчака
Могильчака провулок                                                  	провулок Могильчака
Можайського вулиця                                                   	вулиця Можайського
Молодогвардійський провулок 1-й                                      	1-й Молодогвардійський провулок
Молодої Гвардії вулиця                                               	вулиця Молодої Гвардії
Молодіжна  вулиця                                                    	Молодіжна вулиця
Морозова вулиця                                                      	вулиця Морозова
Москаленка вулиця                                                    	вулиця Москаленка
Москаленка провулок                                                  	провулок Москаленка
Москвіна вулиця                                                      	вулиця Москвіна
Москвіна тупик                                                       	тупик Москвіна
Москвітіна вулиця                                                    	вулиця Москвітіна
Мужності вулиця                                                      	вулиця Мужності
Мужності провулок                                                    	провулок Мужності
Муравського вулиця                                                   	вулиця Муравського
Мури вулиця                                                          	вулиця Мури
Міжріччя вулиця                                                      	вулиця Міжріччя
Мікояна вулиця                                                       	вулиця Мікояна
Мікояна провулок                                                     	провулок Мікояна
Міцкевича вулиця                                                     	вулиця Міцкевича
Мічуріна вулиця                                                      	вулиця Мічуріна
Мічуріна провулок                                                    	провулок Мічуріна
Н. Присяжнюк вулиця                                                  	вулиця Н. Присяжнюк
Надбужжя вулиця                                                      	вулиця Надбужжя
Надії Суровцової вулиця                                              	вулиця Надії Суровцової
Назарія Яремчука вулиця                                              	вулиця Назарія Яремчука
Наконечного вулиця                                                   	вулиця Наконечного
Нансена вулиця                                                       	вулиця Нансена
Насті Присяжнюк вулиця                                               	вулиця Насті Присяжнюк
Насті Присяжнюк тупик                                                	тупик Насті Присяжнюк
Натана Альтмана вулиця                                               	вулиця Натана Альтмана
Нахімова вулиця                                                      	вулиця Нахімова
Нахімова тупик                                                       	тупик Нахімова
Небесної Сотні вулиця                                                	вулиця Небесної Сотні
Невського вулиця                                                     	вулиця Невського
Невського провулок                                                   	провулок Невського
Недєліна вулиця                                                      	вулиця Недєліна
Незалежності України вулиця                                          	вулиця Незалежності України
Незалежності вулиця                                                  	вулиця Незалежності
Незалежності провулок                                                	провулок Незалежності
Незалежності проспект                                                	проспект Незалежності
Некрасова вулиця                                                     	вулиця Некрасова
Некрасова провулок                                                   	провулок Некрасова
Нечуя-Левицького вулиця                                              	вулиця Нечуя-Левицького
Новий Світ вулиця                                                    	вулиця Новий Світ
Новолинника вулиця                                                   	вулиця Новолинника
Новоселів вулиця                                                     	вулиця Новоселів
Новікова вулиця                                                      	вулиця Новікова
Ніколаева вулиця                                                     	вулиця Ніколаєва
Нікольського вулиця                                                  	вулиця Нікольського
Нікітіна вулиця                                                      	вулиця Нікітіна
Ніщинського вулиця                                                   	вулиця Ніщинського
О. Йолтуховського вулиця                                             	вулиця О. Йолтуховського
О. Кошового вулиця                                                   	вулиця О. Кошового
О. Ткача вулиця                                                      	вулиця О. Ткача
О.Леонової вулиця                                                    	вулиця О. Леонової
Об’їзна дорога                                                       	Обʼїзна дорога
Овсяннікова вулиця                                                   	вулиця Овсяннікова
Олега Августюка вулиця                                               	вулиця Олега Августюка
Олега Антонова вулиця                                                	вулиця Олега Антонова
Олега Кошового вулиця                                                	вулиця Олега Кошового
Олега Кошового провулок                                              	провулок Олега Кошового
Олега Лавренчука вулиця                                              	вулиця Олега Лавренчука
Олега Степанюка вулиця                                               	вулиця Олега Степанюка
Олега Ясінського вулиця                                              	вулиця Олега Ясінського
Олеко Дундича вулиця                                                 	вулиця Олеко Дундича
Олександра Багнюка вулиця                                            	вулиця Олександра Багнюка
Олександра Божка вулиця                                              	вулиця Олександра Божка
Олександра Довженка вулиця                                           	вулиця Олександра Довженка
Олександра Кошиця вулиця                                             	вулиця Олександра Кошиця
Олександра Лобжина вулиця                                            	вулиця Олександра Лобжина
Олександра Лотоцького вулиця                                         	вулиця Олександра Лотоцького
Олександра Немченка вулиця                                           	вулиця Олександра Немченка
Олександра Олеся вулиця                                              	вулиця Олександра Олеся
Олександра Подоляна вулиця                                           	вулиця Олександра Подоляна
Олександра Савченка вулиця                                           	вулиця Олександра Савченка
Олександра Соловйова вулиця                                          	вулиця Олександра Соловйова
Олександри Бурбело вулиця                                            	вулиця Олександри Бурбело
Олекси Довбуша вулиця                                                	вулиця Олекси Довбуша
Олекси Новаківського вулиця                                          	вулиця Олекси Новаківського
Олексія Береста вулиця                                               	вулиця Олексія Береста
Олексія Зінов’єва вулиця                                             	вулиця Олексія Зіновʼєва
Олексія Миргородського вулиця                                        	вулиця Олексія Миргородського
Олени Пчілки вулиця                                                  	вулиця Олени Пчілки
Олени Пчілки провулок                                                	провулок Олени Пчілки
Олени Теліги вулиця                                                  	вулиця Олени Теліги
Олеся Гончара вулиця                                                 	вулиця Олеся Гончара
Ольги Кобилянської вулиця                                            	вулиця Ольги Кобилянської
Ольги Кобилянської провулок                                          	провулок Ольги Кобилянської
Олійника вулиця                                                      	вулиця Олійника
Омеляна Грабця вулиця                                                	вулиця Омеляна Грабця
Ополонича вулиця                                                     	вулиця Ополонича
Орджонікідзе вулиця                                                  	вулиця Орджонікідзе
Орлова вулиця                                                        	вулиця Орлова
Осипенка вулиця                                                      	вулиця Осипенка
Осипенко вулиця                                                      	вулиця Осипенко
Остапа Вишні вулиця                                                  	вулиця Остапа Вишні
Остапа Вишні провулок                                                	провулок Остапа Вишні
Островського вулиця                                                  	вулиця Островського
Островського провулок                                                	провулок Островського
Острозького вулиця                                                   	вулиця Острозького
Отамана Сітка вулиця                                                 	вулиця Отамана Сітка
Отця Олександра вулиця                                               	вулиця Отця Олександра
Павла Алепського вулиця                                              	вулиця Павла Алепського
Павла Загребельного вулиця                                           	вулиця Павла Загребельного
Павла Загребельного провулок                                         	провулок Павла Загребельного
Павла Корнелюка вулиця                                               	вулиця Павла Корнелюка
Павла Корнелюка проїзд                                               	проїзд Павла Корнелюка
Павла Мельника вулиця                                                	вулиця Павла Мельника
Павла Скоропадського вулиця                                          	вулиця Павла Скоропадського
Павла Скоропадського провулок                                        	провулок Павла Скоропадського
Павла Тичини вулиця                                                  	вулиця Павла Тичини
Павленка вулиця                                                      	вулиця Павленка
Павленка провулок                                                    	провулок Павленка
Павленка тупик                                                       	тупик Павленка
Павлика Морозова вулиця                                              	вулиця Павлика Морозова
Павлова вулиця                                                       	вулиця Павлова
Павлова провулок                                                     	провулок Павлова
Павлусенка вулиця                                                    	вулиця Павлусенка
Павліка Морозова вулиця                                              	вулиця Павліка Морозова
Паламарчука вулиця                                                   	вулиця Паламарчука
Паліїв Яр вулиця                                                     	вулиця Паліїв Яр
Пам’яті площа                                                        	площа Памʼяті
Панаса Мирного вулиця                                                	вулиця Панаса Мирного
Панфілова вулиця                                                     	вулиця Панфілова
Панфіловців вулиця                                                   	вулиця Панфіловців
Паньковецького вулиця                                                	вулиця Паньковецького
Папаніна вулиця                                                      	вулиця Папаніна
Паризької Комуни вулиця                                              	вулиця Паризької Комуни
Паризької Комуни провулок                                            	провулок Паризької Комуни
Пархоменка вулиця                                                    	вулиця Пархоменка
Пархоменка провулок                                                  	провулок Пархоменка
Паші Ангеліної вулиця                                                	вулиця Паші Ангеліної
Перемоги вулиця                                                      	вулиця Перемоги
Перемоги площа                                                       	площа Перемоги
Перемоги провулок                                                    	провулок Перемоги
Перемоги проспект                                                    	проспект Перемоги
Переправи-44 вулиця                                                  	вулиця Переправи-44
Пересунька вулиця                                                    	вулиця Пересунька
Першутова вулиця                                                     	вулиця Першутова
Пестеля вулиця                                                       	вулиця Пестеля
Пестеля провулок                                                     	провулок Пестеля
Петра Волинця вулиця                                                 	вулиця Петра Волинця
Петра Дорошенка вулиця                                               	вулиця Петра Дорошенка
Петра Запорожця вулиця                                               	вулиця Петра Запорожця
Петра Захарова вулиця                                                	вулиця Петра Захарова
Петра Калнишевського вулиця                                          	вулиця Петра Калнишевського
Петра Ніщинського вулиця                                             	вулиця Петра Ніщинського
Петра Сагайдачного вулиця                                            	вулиця Петра Сагайдачного
Петровського вулиця                                                  	вулиця Петровського
Петрусенко вулиця                                                    	вулиця Петрусенко
Петрусенко провулок                                                  	провулок Петрусенко
Петрусенко тупик                                                     	тупик Петрусенко
Пилипа Козицького вулиця                                             	вулиця Пилипа Козицького
Пилипа Орлика вулиця                                                 	вулиця Пилипа Орлика
Пирогова провулок                                                    	провулок Пирогова
Писарєва вулиця                                                      	вулиця Писарєва
Плахотнюка вулиця                                                    	вулиця Плахотнюка
Плеханова вулиця                                                     	вулиця Плеханова
Плотянського вулиця                                                  	вулиця Плотянського
Площа Миру вулиця                                                    	вулиця Площа Миру
Повстання Броненосця Потьомкін провулок                              	провулок Повстання Броненосця Потьомкін
Повстання Броненосця Потьомкіна вулиця                               	вулиця Повстання Броненосця Потьомкіна
Поділ вулиця                                                         	вулиця Поділ
Пожарського вулиця                                                   	вулиця Пожарського
Покришкіна вулиця                                                    	вулиця Покришкіна
Покришкіна провулок                                                  	провулок Покришкіна
Полковника Ганжі вулиця                                              	вулиця Полковника Ганжі
Полуботка вулиця                                                     	вулиця Полуботка
Полухіна вулиця                                                      	вулиця Полухіна
Польва вулиця                                                        	вулиця Польва
Поліна вулиця                                                        	вулиця Поліна
Поліни Осипенко вулиця                                               	вулиця Поліни Осипенко
Понєдєліна вулиця                                                    	вулиця Понєдєліна
Поплавського вулиця                                                  	вулиця Поплавського
Поповича вулиця                                                      	вулиця Поповича
Порика вулиця                                                        	вулиця Порика
Постишева вулиця                                                     	вулиця Постишева
Праведників світу вулиця                                             	вулиця Праведників Світу
Примакова вулиця                                                     	вулиця Примакова
Примирення вулиця                                                    	вулиця Примирення
Проектувальників проїзд                                              	проїзд Проектувальників
Професора Шульги вулиця                                              	вулиця Професора Шульги
Процишина вулиця                                                     	вулиця Процишина
Птахіна вулиця                                                       	вулиця Птахіна
Пугачова вулиця                                                      	вулиця Пугачова
Пугачова провулок                                                    	провулок Пугачова
Пушкіна вулиця                                                       	вулиця Пушкіна
Підгаєцького вулиця                                                  	вулиця Підгаєцького
Підгорбунського вулиця                                               	вулиця Підгорбунського
Піддубного вулиця                                                    	вулиця Піддубного
Пірогова вулиця                                                      	вулиця Пірогова
П’ятничанська вулиця                                                 	Пʼятничанська вулиця
Радянської Армії вулиця                                              	вулиця Радянської Армії
Разіна вулиця                                                        	вулиця Разіна
Разіна провулок                                                      	провулок Разіна
Ракова Шийка вулиця                                                  	вулиця Ракова Шийка
Революції Гідності вулиця                                            	вулиця Революції Гідності
Революції вулиця                                                     	вулиця Революції
Речмедіна вулиця                                                     	вулиця Речмедіна
Рибалка вулиця                                                       	вулиця Рибалка
Рильського вулиця                                                    	вулиця Рильського
Рилєєва вулиця                                                       	вулиця Рилєєва
Родіона Скалецького вулиця                                           	вулиця Родіона Скалецького
Рози Люксембург вулиця                                               	вулиця Рози Люксембург
Романа Балаби вулиця                                                 	вулиця Романа Балаби
Романа Грушка вулиця                                                 	вулиця Романа Грушка
Романа Чайковського вулиця                                           	вулиця Романа Чайковського
Романа Шухевича вулиця                                               	вулиця Романа Шухевича
Романа Шухевича провулок                                             	провулок Романа Шухевича
Романенко вулиця                                                     	вулиця Романенко
Россоха вулиця                                                       	вулиця Россоха
Руданського вулиця                                                   	вулиця Руданського
Руднева вулиця                                                       	вулиця Руднева
Руський Вал вулиця                                                   	вулиця Руський Вал
Рєпіна вулиця                                                        	вулиця Рєпіна
С. Ковриги вулиця                                                    	вулиця С. Ковриги
С. Нігояна вулиця                                                    	вулиця С. Нігояна
Савишина вулиця                                                      	вулиця Савишина
Савчука вулиця                                                       	вулиця Савчука
Сагайдачного вулиця                                                  	вулиця Сагайдачного
Садова  вулиця                                                       	Садова вулиця
Садовського вулиця                                                   	вулиця Садовського
Саксаганського вулиця                                                	вулиця Саксаганського
Саксаганського провулок                                              	провулок Саксаганського
Салтикова-Щедріна вулиця                                             	вулиця Салтикова-Щедріна
Салтикова-Щедріна провулок                                           	провулок Салтикова-Щедріна
Самійла Самуся вулиця                                                	вулиця Самійла Самуся
Сахарова вулиця                                                      	вулиця Сахарова
Сашка вулиця                                                         	вулиця Сашка
Свердлова вулиця                                                     	вулиця Свердлова
Свердлова провулок                                                   	провулок Свердлова
Свинаря вулиця                                                       	вулиця Свинаря
Свободи бульвар                                                      	бульвар Свободи
Свободи вулиця                                                       	вулиця Свободи
Свободи проспект                                                     	проспект Свободи
Святого Миколая вулиця                                               	вулиця Святого Миколая
Святого Миколая майдан                                               	майдан Святого Миколая
Святослава Хороброго вулиця                                          	вулиця Святослава Хороброго
Святослава Хороброго провулок                                        	провулок Святослава Хороброго
Свідзінського вулиця                                                 	вулиця Свідзінського
Северина Наливайка вулиця                                            	вулиця Северина Наливайка
Северина Наливайка площа                                             	площа Северина Наливайка
Северина Наливайка провулок                                          	провулок Северина Наливайка
Северина Наливайка тупик                                             	тупик Северина Наливайка
Седова вулиця                                                        	вулиця Седова
Семака вулиця                                                        	вулиця Семака
Семашко вулиця                                                       	вулиця Семашко
Семена Олійничука провулок                                           	провулок Семена Олійничука
Семенова вулиця                                                      	вулиця Семенова
Семенюка вулиця                                                      	вулиця Семенюка
Семеренка вулиця                                                     	вулиця Семеренка
Сенатора Маккейна вулиця                                             	вулиця Сенатора Маккейна
Серафимовича вулиця                                                  	вулиця Серафимовича
Сербіна вулиця                                                       	вулиця Сербіна
Сербіна провулок                                                     	провулок Сербіна
Сергєєва-Ценського провулок                                          	провулок Сергєєва-Ценського
Сергія Гармишева вулиця                                              	вулиця Сергія Гармишева
Сергія Зулінського вулиця                                            	вулиця Сергія Зулінського
Сергія Лазо вулиця                                                   	вулиця Сергія Лазо
Сергія Лазо провулок                                                 	провулок Сергія Лазо
Сергія Параджанова вулиця                                            	вулиця Сергія Параджанова
Сердечнюка вулиця                                                    	вулиця Сердечнюка
Симона Петлюри вулиця                                                	вулиця Симона Петлюри
Симона Петрлюри вулиця                                               	вулиця Симона Петрлюри
Сиротюка вулиця                                                      	вулиця Сиротюка
Склярова вулиця                                                      	вулиця Склярова
Сковороди вулиця                                                     	вулиця Сковороди
Слобода вулиця                                                       	вулиця Слобода
Слов’янська вулиця                                                   	Словʼянська вулиця
Слов’янський провулок                                                	Словʼянський провулок
Соборності вулиця                                                    	вулиця Соборності
Соборності провулок                                                  	провулок Соборності
Сокирка провулок                                                     	провулок Сокирка
Солов'їна вулиця                                                     	Соловʼїна вулиця
Солов’їна вулиця                                                     	Соловʼїна вулиця
Солов’їний провулок                                                  	Соловʼїний провулок
Соломії Крушельницької вулиця                                        	вулиця Соломії Крушельницької
Соломії Крушельницької провулок                                      	провулок Соломії Крушельницької
Солідарності вулиця                                                  	вулиця Солідарності
Сорокопуда вулиця                                                    	вулиця Сорокопуда
Сосновий Бір вулиця                                                  	вулиця Сосновий Бір
Сосонка вулиця                                                       	вулиця Сосонка
Сосюри вулиця                                                        	вулиця Сосюри
Софії Русової вулиця                                                 	вулиця Софії Русової
Спартака вулиця                                                      	вулиця Спартака
Спорту вулиця                                                        	вулиця Спорту
Станіславського вулиця                                               	вулиця Станіславського
Станіславського провулок                                             	провулок Станіславського
Станіславського проїзд                                               	проїзд Станіславського
Старицького вулиця                                                   	вулиця Старицького
Стахурського вулиця                                                  	вулиця Стахурського
Сташко вулиця                                                        	вулиця Сташко
Стельмаха вулиця                                                     	вулиця Стельмаха
Степана Бандери вулиця                                               	вулиця Степана Бандери
Степана Бандери провулок                                             	провулок Степана Бандери
Степана Руданського вулиця                                           	вулиця Степана Руданського
Степана Тимошенка вулиця                                             	вулиця Степана Тимошенка
Степана Тимошенка провулок                                           	провулок Степана Тимошенка
Степового вулиця                                                     	вулиця Степового
Стеценка Кирила вулиця                                               	вулиця Кирила Стеценка
Стеценка вулиця                                                      	вулиця Стеценка
Столярчука вулиця                                                    	вулиця Столярчука
Стровського вулиця                                                   	вулиця Стровського
Строкача вулиця                                                      	вулиця Строкача
Струтинського вулиця                                                 	вулиця Струтинського
Стуса вулиця                                                         	вулиця Стуса
Суворова вулиця                                                      	вулиця Суворова
Сьомака вулиця                                                       	вулиця Сьомака
Сєдова вулиця                                                        	вулиця Сєдова
Сєрова вулиця                                                        	вулиця Сєрова
Січових Стрілців вулиця                                              	вулиця Січових Стрільців
Січових Стрільців вулиця                                             	вулиця Січових Стрільців
Т. Г. Шевченка вулиця                                                	вулиця Т. Г. Шевченка
Талаліхіна вулиця                                                    	вулиця Талаліхіна
Талаліхіна провулок                                                  	провулок Талаліхіна
Танкістів вулиця                                                     	вулиця Танкістів
Тараса Сича вулиця                                                   	вулиця Тараса Сича
Тараса Сича провулок                                                 	провулок Тараса Сича
Тараса Шевченка вулиця                                               	вулиця Тараса Шевченка
Тараса Шевченка площа                                                	площа Тараса Шевченка
Тараса Шевченка провулок                                             	провулок Тараса Шевченка
Тараса Шевченка тупик                                                	тупик Тараса Шевченка
Тарногродського вулиця                                               	вулиця Тарногродського
Тельмана вулиця                                                      	вулиця Тельмана
Тельнюка вулиця                                                      	вулиця Тельнюка
Телячука вулиця                                                      	вулиця Телячука
Терентія Полубуткіна вулиця                                          	вулиця Терентія Полубуткіна
Терешкової вулиця                                                    	вулиця Терешкової
Терешкової провулок                                                  	провулок Терешкової
Тетяни Кошиць вулиця                                                 	вулиця Тетяни Кошиць
Тетяни Яблонської вулиця                                             	вулиця Тетяни Яблонської
Тимка Падури вулиця                                                  	вулиця Тимка Падури
Тимка Падури провулок                                                	провулок Тимка Падури
Тимощука вулиця                                                      	вулиця Тимощука
Тичини вулиця                                                        	вулиця Тичини
Тобілевича вулиця                                                    	вулиця Тобілевича
Толбухіна вулиця                                                     	вулиця Толбухіна
Толбухіна провулок                                                   	провулок Толбухіна
Толстого вулиця                                                      	вулиця Толстого
Топольського вулиця                                                  	вулиця Топольського
Трембицького вулиця                                                  	вулиця Трембицького
Тропініна вулиця                                                     	вулиця Тропініна
Тропініна провулок                                                   	провулок Тропініна
Трублаїні вулиця                                                     	вулиця Трублаїні
Тугушова вулиця                                                      	вулиця Тугушова
Тургенєва вулиця                                                     	вулиця Тургенєва
Тухачевського вулиця                                                 	вулиця Тухачевського
Тімірязева вулиця                                                    	вулиця Тімірязева
Тімірязева провулок                                                  	провулок Тімірязева
Тімірязєва вулиця                                                    	вулиця Тімірязєва
Тімірязєва провулок                                                  	провулок Тімірязєва
Тітова вулиця                                                        	вулиця Тітова
Уборевича вулиця                                                     	вулиця Уборевича
Ударника вулиця                                                      	вулиця Ударника
Ударника провулок                                                    	провулок Ударника
Українського Козацтва вулиця                                         	вулиця Українського Козацтва
Уласа Самчука вулиця                                                 	вулиця Уласа Самчука
Урицького вулиця                                                     	вулиця Урицького
Устима Кармалюка вулиця                                              	вулиця Устима Кармалюка
Устима Кармалюка провулок                                            	провулок Устима Кармалюка
Устима Кармелюка вулиця                                              	вулиця Устима Кармелюка
Устима Кармелюка провулок                                            	провулок Устима Кармелюка
Ушакова вулиця                                                       	вулиця Ушакова
Ушакова провулок                                                     	провулок Ушакова
Ушинського вулиця                                                    	вулиця Ушинського
Фабріціуса вулиця                                                    	вулиця Фабріціуса
Фадєєва вулиця                                                       	вулиця Фадєєва
Фадєєва провулок                                                     	провулок Фадєєва
Федора Маківчука вулиця                                              	вулиця Федора Маківчука
Фелікса Дзержинського вулиця                                         	вулиця Фелікса Дзержинського
Фелікса Кона вулиця                                                  	вулиця Фелікса Кона
Фелікса Кона провулок                                                	провулок Фелікса Кона
Франка вулиця                                                        	вулиця Франка
Франца Мерінга провулок                                              	провулок Франца Мерінга
Франциска Скорини вулиця                                             	вулиця Франциска Скорини
Франциска Скорини провулок                                           	провулок Франциска Скорини
Фрунзе вулиця                                                        	вулиця Фрунзе
Фрунзе провулок                                                      	провулок Фрунзе
Фурманова вулиця                                                     	вулиця Фурманова
Фурманова вуліця                                                     	вулиця Фурманова
Халтуріна вулиця                                                     	вулиця Халтуріна
Хліборобів вулиця                                                    	вулиця Хліборобів
Хмельницького вулиця                                                 	вулиця Хмельницького
Хмельницького провулок                                               	провулок Хмельницького
Целіш вулиця                                                         	вулиця Целіш
Центральна вулицяц                                                   	Центральна вулиця
Цукровиків вулиця                                                    	вулиця Цукровиків
Цукрозаводу вулиця                                                   	вулиця Цукрозаводу
Ціолковського вулиця                                                 	вулиця Ціолковського
Ціолковського провулок                                               	провулок Ціолковського
Чабана вулиця                                                        	вулиця Чабана
Чайковського вулиця                                                  	вулиця Чайковського
Чайковського провулок                                                	провулок Чайковського
Чапаева вулиця                                                       	вулиця Чапаєва
Чапаєва вулиця                                                       	вулиця Чапаєва
Чейковського вулиця                                                  	вулиця Чейковського
Червоних Курсантів вулиця                                            	вулиця Червоних Курсантів
Червоних Партизан вулиця                                             	вулиця Червоних Партизан
Червоного Козацтва вулиця                                            	вулиця Червоного Козацтва
Червоної Калини вулиця                                               	вулиця Червоної Калини
Червоної Калини провулок                                             	провулок Червоної Калини
Черешенька провулок                                                  	провулок Черешенька
Черлінка вулиця                                                      	вулиця Черлінка
Чернишевского вулиця                                                 	вулиця Чернишевського
Чернишевського вулиця                                                	вулиця Чернишевського
Чернова вулиця                                                       	вулиця Чернова
Черняховського вулиця                                                	вулиця Черняховського
Черняховського провулок                                              	провулок Черняховського
Черняхівського вулиця                                                	вулиця Черняхівського
Чесака вулиця                                                        	вулиця Чесака
Чехова вулиця                                                        	вулиця Чехова
Чехова провулок                                                      	провулок Чехова
Чехова проїзд 1-й                                                    	1-й проїзд Чехова
Чехова проїзд 2-й                                                    	2-й проїзд Чехова
Чехова проїзд 3-й                                                    	3-й проїзд Чехова
Чкалова вулиця                                                       	вулиця Чкалова
Чорнобаївка вулиця                                                   	вулиця Чорнобаївка
Чорновола вулиця                                                     	вулиця Чорновола
Чубаря вулиця                                                        	вулиця Чубаря
Чумацький Шлях вулиця                                                	вулиця Чумацький Шлях
Чумацький Шлях провулок                                              	провулок Чумацький Шлях
Шапова вулиця                                                        	вулиця Шапова
Шевченка вулиця                                                      	вулиця Шевченка
Шевченка площа                                                       	площа Шевченка
Шевченка провулок                                                    	провулок Шевченка
Шевчука вулиця                                                       	вулиця Шевчука
Шереметка вулиця                                                     	вулиця Шереметка
Шереметка провулок                                                   	провулок Шереметка
Шереметка проїзд                                                     	проїзд Шереметка
Шибінського вулиця                                                   	вулиця Шибінського
Ширшова вулиця                                                       	вулиця Ширшова
Шмідта вулиця                                                        	вулиця Шмідта
Шмідта провулок                                                      	провулок Шмідта
Шолом-Алейхема вулиця                                                	вулиця Шолом-Алейхема
Шолохова вулиця                                                      	вулиця Шолохова
Шорса вулиця                                                         	вулиця Шорса
Шпаковича вулиця                                                     	вулиця Шпаковича
Шпорти вулиця                                                        	вулиця Шпорти
Шукшина вулиця                                                       	вулиця Шукшина
Щастлива вулиця                                                      	Щаслива вулиця
Щастя вулиця                                                         	вулиця Щастя
Щедріна провулок                                                     	провулок Щедріна
Щорса вулиця                                                         	вулиця Щорса
Щорса провулок                                                       	провулок Щорса
Щукіна вулиця                                                        	вулиця Щукіна
Щукіна провулок                                                      	провулок Щукіна
Ю.Курія вулиця                                                       	вулиця Ю. Курія
Ю.Рябчинської вулиця                                                 	вулиця Ю. Рябчинської
Ю.Смирнова вулиця                                                    	вулиця Ю. Смирнова
Ю.Смирнова провулок                                                  	провулок Ю. Смирнова
Юківка вулиця                                                        	вулиця Юківка
Юліуша Словацького вулиця                                            	вулиця Юліуша Словацького
Юності вулиця                                                        	вулиця Юності
Юності провулок                                                      	провулок Юності
Юності проспект                                                      	проспект Юності
Юності проїзд                                                        	проїзд Юності
Юрія Іллєнка вулиця                                                  	вулиця Юрія Іллєнка
Юрія Александровича вулиця                                           	вулиця Юрія Александровича
Юрія Гагаріна вулиця                                                 	вулиця Юрія Гагаріна
Юрія Збанацького вулиця                                              	вулиця Юрія Збанацького
Юрія Клена вулиця                                                    	вулиця Юрія Клена
Юрія Коваленка вулиця                                                	вулиця Юрія Коваленка
Юрія Левади вулиця                                                   	вулиця Юрія Левади
Юрія Лісового вулиця                                                 	вулиця Юрія Лісового
Юхима Сіцінського вулиця                                             	вулиця Юхима Сіцінського
Юхима Сіцінського провулок                                           	провулок Юхима Сіцінського
Ющенка вулиця                                                        	вулиця Ющенка
Я. Іщенка вулиця                                                     	вулиця Я. Іщенка
Я. Дем'янишина вулиця                                                	вулиця Я. Демʼянишина
Я. Мудрого вулиця                                                    	вулиця Я. Мудрого
Якова Гальчевського вулиця                                           	вулиця Якова Гальчевського
Якова Гальчевського провулок                                         	провулок Якова Гальчевського
Якова Шепеля вулиця                                                  	вулиця Якова Шепеля
Яковчука вулиця                                                      	вулиця Яковчука
Яковчука провулок                                                    	провулок Яковчука
Якіра вулиця                                                         	вулиця Якіра
Якіра провулок                                                       	провулок Якіра
Яна Засідателя вулиця                                                	вулиця Яна Засідателя
Яна Засідателя провулок                                              	провулок Яна Засідателя
Янківського вулиця                                                   	вулиця Янківського
Янюка М. вулиця                                                      	вулиця М. Янюка
Яреми вулиця                                                         	вулиця Яреми
Яремчука вулиця                                                      	вулиця Яремчука
Ярмоли Мелешка вулиця                                                	вулиця Ярмоли Мелешка
Ярослава Галана вулиця                                               	вулиця Ярослава Галана
Ярослава Мудрого вулиця                                              	вулиця Ярослава Мудрого
Ярослава Нємеца вулиця                                               	вулиця Ярослава Нємеца
Ярослава Нємеца провулок                                             	провулок Ярослава Нємеца
Ярошинського вулиця                                                  	вулиця Ярошинського
Ґрохольських вулиця                                                  	вулиця Ґрохольських
Ґрохольських провулок                                                	провулок Ґрохольських
Ґрохольських тупик                                                   	тупик Ґрохольських
1 Серпня вулиця                                                      	вулиця 1 Серпня
1 лінія                                                              	1-ша лінія
1-й Кропоткина переулок                                              	1-й провулок Кропоткіна
1-й Юрыя Левади проїзд                                               	1-й проїзд Юрія Левади
1-й провулок Північний                                               	1-й Північний провулок
10 лінія                                                             	10-та лінія
11 лінія                                                             	11-та лінія
12 лінія                                                             	12-та лінія
13 лінія                                                             	13-та лінія
14 лінія                                                             	14-та лінія
15 лінія                                                             	15-та лінія
16 лінія                                                             	16-та лінія
17 лінія                                                             	17-та лінія
18 лінія                                                             	18-та лінія
19 лінія                                                             	19-та лінія
2 лінія                                                              	2-га лінія
2-й Гетьмана Сагайдачного провулок                                   	
2-й Скыфський провулок                                               	2-й Скіфський провулок
2-й провулок Північний                                               	2-й Північний провулок
20 лінія                                                             	20-та лінія
3 лінія                                                              	3-тя лінія
3-й Леоніда Каженюка провулок                                        	3-й провулок Леоніда Каженюка
30 Rokiv Peremohy                                                    	30 років Перемоги
3rd Moskovskyi Lane;3-й Московський провулок;переулок 3-й Московский 	3-й Московський провулок
4 лінія                                                              	4-та лінія
5 лінія                                                              	5-та лінія
6 лінія                                                              	6-та лінія
7 лінія                                                              	7-ма лінія
8 Марта                                                              	8 Березня
8 лінія                                                              	8-ма лінія
9 лінія                                                              	9-та лінія
5-й Леонида Каденюка провулок                                        	5-й провулок Леоніда Каденюка
50-річчя Жовтня вулиця;50-летия Октября улица                        	вулиця 50-річчя Жовтня
:Жовтнева вулиця                                                     	Жовтнева вулиця
=Миколи Амосова вулиця                                               	вулиця Миколи Амосова
Frunze Street;Фрунзе вулиця                                          	вулиця Фрунзе
Gagarin Street;Gagarina                                              	вулиця Гагаріна
Gagarin Street;Gagarina Street                                       	вулиця Гагаріна
Gogol Street;Gogolya Street                                          	вулиця Гоголя
Lenina;Леніна                                                        	Леніна                                       	
XX Парт'їзду вулиця;20-го Партз'їзду вулиця                          	вулиця XX Партзʼїзду
Будьонного вулиця;Будённого улица                                    	вулиця Будьонного
Володимира Очеретнего вулиця;Жовтнева вулиця                         	вулиця Володимира Очеретнего;Жовтнева вулиця
Галицької Армії вулиця;Некрасова вулиця                              	вулиця Галицької Армії;вулиця Некрасова
Дзержинського вулиця;Дзержинского улица                              	вулиця Дзержинського
Енгельса вулиця;Engels Street;Enhelsa Street;Engelsa Street          	вулиця Енгельса
Кирова улица;Кірова вулиця                                           	вулиця Кірова
Комсомольська вулиця;Комсомольская улица                             	Комсомольська вулиця
Котовського вулиця;Котовского улица;Kotovskogo;Kotovsky;Kotowski     	вулиця Котовського
Кірова вулиця;Кирова улица                                           	вулиця Кірова
Леніна вулиця;Lenin Street;Lenina Street;Ленина улица                	вулиця Леніна
Леніна вулиця;Lenina Street;Lenin Street                             	вулиця Леніна
Орджонікідзе вулиця;Орджоникидзе улица                               	вулиця Орджонікідзе
Пархоменка вулиця;Пархоменко улица                                   	вулиця Пархоменка
Постишева вулиця;Постышева улица                                     	вулиця Постишева
Пугачова вулиця;Pugachev;Pugacheva;Puhachova;Pugatschow              	вулиця Пугачова
Піонерська вулиця;Пионерская улица                                   	Піонерська вулиця
Радгоспна вулиця;Совхозная улица                                     	Радгоспна вулиця
Радянська вулиця;Советская улица                                     	Радянська вулиця
Степана Бандери вулиця;Гагаріна вулиця                               	вулиця Степана Бандери;вулиця Гагаріна
Червоноармійська вулиця;Красноармейская улица                        	Червоноармійська вулиця
Якира улица;Якіра вулиця                                             	вулиця Якіра
Іраклія Ковалевського вулиця                                         	вулиця Іраклія Ковалевського
Багабунта вулиця                                                     	вулиця Багабунта
Бриллінг вулиця                                                      	вулиця Бриллінг
Володимера Даценка вулиця                                            	вулиця Володимира Даценка
Володимира Четверука вулиця                                          	вулиця Володимира Четверука
Гівка вулиця                                                         	вулиця Гівка
Дейча вулиця                                                         	вулиця Дейча
Дерев'яний місток                                                    	Деревʼяний місток
Дружба міст                                                          	міст Дружба
Жовтого вулиця                                                       	вулиця Жовтого
Коваля Григорія вулиця                                               	вулиця Григорія Коваля
Колонтай вул.                                                        	вулиця Колонтай
Колонтай вулиця                                                      	вулиця Колонтай
Комінтерна вулиця                                                    	вулиця Комінтерна
Костянтина Коновалова вулиця                                         	вулиця Костянтина Коновалова
Ліверпуль майдан                                                     	майдан Ліверпуль
Мазуркевича вулиця                                                   	вулиця Мазуркевича
Молодіжнга вулиця                                                    	Молодіжна вулиця
Н.Курченко вулиця                                                    	вулиця Н. Курченко
Петра Шмідта вулиця                                                  	вулиця Петра Шмідта
Сквер Здоров’я                                                       	сквер Здоровʼя
Сходи Артинова                                                       	сходи Артинова
Шолом Алейхем вулиця                                                 	вулиця Шолом Алейхем
Якова Галчевського вулиця                                            	вулиця Якова Галчевського
вул. Зодчих                                                          	вулиця Зодчих
вулиця 1-го Травня                                                   	вулиця 1 Травня
вулиця 14 го Березня                                                 	вулиця 14 Березня
вулиця 9-го Січня                                                    	вулиця 9 Січня
вулиця В.Семенця                                                     	вулиця В. Семенця
вулиця Зої Космодем'янської                                          	вулиця Зої Космодемʼянської
вулиця Лесі Унраїнки                                                 	вулиця Лесі Українки
вулиця О.Довженка                                                    	вулиця О. Довженка
вулиця ім. Гомелюка                                                  	вулиця Гомелюка