1-й Трутовського провулок	1-й провулок Трутовського
1-а Набережна вулиця	1-ша Набережна вулиця
Об’їздна перша вулиця	1-ша Обʼїздна вулиця
10-а Набережна вулиця	10-та Набережна вулиця
11-а Набережна вулиця	11-та Набережна вулиця
12-а Набережна вулиця	12-та Набережна вулиця
2-а Набережна вулиця	2-га Набережна вулиця
Об’їздна друга вулиця	2-га Обʼїздна вулиця
2-й Ватутіна провулок	2-й провулок Ватутіна
2-й Трутовського провулок	2-й провулок Трутовського
3-й Трутовського провулок	3-й провулок Трутовського
3-я Набережна вулиця	3-тя Набережна вулиця
Об’їздна третя вулиця	3-тя Обʼїздна вулиця
4-а Набережна вулиця	4-та Набережна вулиця
Об’їздна четверта вулиця	4-та Обʼїздна вулиця
5-а Набережна вулиця	5-та Набережна вулиця
5-а Об’їздна вулиця	5-та Обʼїздна вулиця
6-а Набережна вулиця	6-та Набережна вулиця
7-а Набережна вулиця	7-ма Набережна вулиця
8-а Набережна вулиця	8-ма Набережна вулиця
Алея Героїв АТО	алея Героїв АТО
алея лікарських трав	алея Лікарських Трав
Алея лікарських трав	алея Лікарських Трав
Алея ліхтарів	алея Ліхтарів
Алея парасольок	алея Парасольок
Алея почесних поховань	алея Почесних Поховань
Алея скульптур	алея Скульптур
Стравінського алея	алея Стравінського
білоруська вулиця	Білоруська вулиця
Козацька Бічна вулиця	Бічна Козацька вулиця
Дружби народів бульвар	бульвар Дружби Народів
Дружби Народів бульвар	бульвар Дружби Народів
Лесі Українки бульвар	бульвар Лесі Українки
Шевченка бульвар	бульвар Шевченка
1 Грудня вулиця	вулиця 1 Грудня
1-го Грудня вулиця	вулиця 1 Грудня
1 Травня вулиця	вулиця 1 Травня
1-го травня вулиця	вулиця 1 Травня
1-го Травня вулиця	вулиця 1 Травня
Першого Травня вулиця	вулиця 1 Травня
100-річчя Маневич вулиця	вулиця 100-річчя Маневич
14-ї Князівської бригади вулиця	вулиця 14-ї Князівської Бригади
15-й Мікрорайон вулиця	вулиця 15-й Мікрорайон
16 Липня вулиця	вулиця 16 Липня
17 вересня вулиця	вулиця 17 Вересня
17 Вересня вулиця	вулиця 17 Вересня
17-го Вересня вулиця	вулиця 17 Вересня
22-го Січня вулиця	вулиця 22 Січня
24 Серпня вулиця	вулиця 24 Серпня
3-го Інтернаціоналу вулиця	вулиця 3-го Інтернаціоналу
30-річчя Перемоги вулиця	вулиця 30-річчя Перемоги
39-го Полку вулиця	вулиця 39-го Полку
40 років Перемоги вулиця	вулиця 40 років Перемоги
40 Років Перемоги вулиця	вулиця 40 років Перемоги
40 річчя Перемоги вулиця	вулиця 40-річчя Перемоги
40-річчя перемоги вулиця	вулиця 40-річчя Перемоги
40-річчя Перемоги вулиця	вулиця 40-річчя Перемоги
45 років Перемоги вулиця	вулиця 45 років Перемоги
45-ї Дивізії провулок	вулиця 45-ї Дивізії
5-го Лютого вулиця	вулиця 5 Лютого
5-й Мікрорайон вулиця	вулиця 5-й Мікрорайон
50 років Перемоги вулиця	вулиця 50 років Перемоги
50 Років Перемоги вулиця	вулиця 50 років Перемоги
500-річчя Вижівки вулиця	вулиця 500-річчя Вижівки
500-річчя Локач вулиця	вулиця 500-річчя Локач
6-й Мікрорайон вулиця	вулиця 6-й Мікрорайон
60-ліття СРСР	вулиця 60-ліття СРСР
70-річчя Великого Жовтня вулиця	вулиця 70-річчя Великого Жовтня
750-річчя Горохова вулиця	вулиця 750-річчя Горохова
8 березня вулиця	вулиця 8 Березня
8 Березня вулиця	вулиця 8 Березня
8-го Березня вулиця	вулиця 8 Березня
вулиця 8 березня	вулиця 8 Березня
9 Травня вулиця	вулиця 9 Травня
9-го Травня вулиця	вулиця 9 Травня
Авіаторів вулиця	вулиця Авіаторів
Агатангела Кримського вулиця	вулиця Агатангела Кримського
Адама Міцкевича вулиця	вулиця Адама Міцкевича
Айвазовського вулиця	вулиця Айвазовського
Академіка Глушкова вулиця	вулиця Академіка Глушкова
Академіка Корольова вулиця	вулиця Академіка Корольова
Академіка Кравчука вулиця	вулиця Академіка Кравчука
Академіка Кримського вулиця	вулиця Академіка Кримського
Академіка Крип’якевича вулиця	вулиця Академіка Крипʼякевича
Академіка Люльки вулиця	вулиця Академіка Люльки
Академіка Степана Радіона вулиця	вулиця Академіка Степана Радіона
Андрія Войнаровського вулиця	вулиця Андрія Войнаровського
Андрія Кузьменка вулиця	вулиця Андрія Кузьменка
Андрія Марцинюка вулиця	вулиця Андрія Марцинюка
Андрія Первозванного вулиця	вулиця Андрія Первозванного
Андрія Снітка вулиця	вулиця Андрія Снітка
Андрузького вулиця	вулиця Андрузького
Антона Чехова вулиця	вулиця Антона Чехова
Антоновича вулиця	вулиця Антоновича
Арсена Річинського вулиця	вулиця Арсена Річинського
Артема вулиця	вулиця Артема
Архипенка вулиця	вулиця Архипенка
Архітектора Метельницького вулиця	вулиця Архітектора Метельницького
Арцеулова вулиця	вулиця Арцеулова
Астронавта Каденюка вулиця	вулиця Астронавта Каденюка
Б. Калуша вулиця	вулиця Б. Калуша
Б. Хмельницького вулиця	вулиця Б. Хмельницького
Б.Хмельницького вулиця	вулиця Б. Хмельницького
Балакірєва вулиця	вулиця Балакірєва
Баранова вулиця	вулиця Баранова
Бенделіані вулиця	вулиця Бенделіані
Березівка вулиця	вулиця Березівка
Березня вулиця	вулиця Березня
Березовського вулиця	вулиця Березовського
Бобрика вулиця	вулиця Бобрика
Богатирьова вулиця	вулиця Богатирьова
Богачука вулиця	вулиця Богачука
Богдана Климчука вулиця	вулиця Богдана Климчука
Богдана Лепкого вулиця	вулиця Богдана Лепкого
Богдана Ступки вулиця	вулиця Богдана Ступки
Богдана Хмельницького вулиця	вулиця Богдана Хмельницького
Богомольця вулиця	вулиця Богомольця
Богуна вулиця	вулиця Богуна
Бодинька вулиця	вулиця Бодинька
Боженка вулиця	вулиця Боженка
Бойка вулиця	вулиця Бойка
Бондаренка вулиця	вулиця Бондаренка
Бориса Грінченка вулиця	вулиця Бориса Грінченка
Боровики вулиця	вулиця Боровики
Боровиковського вулиця	вулиця Боровиковського
Бородіна вулиця	вулиця Бородіна
Бортнянського вулиця	вулиця Бортнянського
Боткіна вулиця	вулиця Боткіна
Братковського вулиця	вулиця Братковського
Бригадний двір вулиця	вулиця Бригадний Двір
Бринського вулиця	вулиця Бринського
Брюллова вулиця	вулиця Брюллова
Брюлова вулиця	вулиця Брюлова
Будівельників вулиця	вулиця Будівельників
Будьонного вулиця	вулиця Будьонного
В. Григорука вулиця	вулиця В. Григорука
В. Івасюка вулиця	вулиця В. Івасюка
В. Мельника вулиця	вулиця В. Мельника
Вавилова вулиця	вулиця Вавилова
Вадима гетьмана вулиця	вулиця Вадима Гетьмана
Вадима Гетьмана вулиця	вулиця Вадима Гетьмана
Валерії Новодворської вулиця	вулиця Валерії Новодворської
Валерія Шиманського вулиця	вулиця Валерія Шиманського
Вальсроде вулиця	вулиця Вальсроде
Варварівка вулиця	вулиця Варварівка
Васильєва вулиця	вулиця Васильєва
Васильчука вулиця	вулиця Васильчука
Василя Вегерича вулиця	вулиця Василя Вегерича
Василя Коржана вулиця	вулиця Василя Коржана
Василя Сагана вулиця	вулиця Василя Сагана
Василя Симоненка вулиця	вулиця Василя Симоненка
Василя Стуса вулиця	вулиця Василя Стуса
Васільєва вулиця	вулиця Васільєва
Васюти вулиця	вулиця Васюти
Ватутіна вулиця	вулиця Ватутіна
Вахтангова вулиця	вулиця Вахтангова
Вербицького вулиця	вулиця Вербицького
Вересая вулиця	вулиця Вересая
Верещагіна вулиця	вулиця Верещагіна
Вериківського вулиця	вулиця Вериківського
Ветеранів вулиця	вулиця Ветеранів
Виговського вулиця	вулиця Виговського
Визволителів вулиця	вулиця Визволителів
Винниченка вулиця	вулиця Винниченка
Вишенського вулиця	вулиця Вишенського
Вишневецького вулиця	вулиця Вишневецького
Відродження вулиця	вулиця Відродження
Вільної України вулиця	вулиця Вільної України
Вільхівка вулиця	вулиця Вільхівка
Віталія Карповича вулиця	вулиця Віталія Карповича
Вітковського вулиця	вулиця Вітковського
Власа Мізинця вулиця	вулиця Власа Мізинця
Власюка вулиця	вулиця Власюка
Воз'єднання вулиця	вулиця Воззʼєднання
Возз’єднання вулиця	вулиця Воззʼєднання
Воїнів-афганців вулиця	вулиця Воїнів-Афганців
Воїнів-Афганців вулиця	вулиця Воїнів-Афганців
Воїнів-інтернаціоналістів вулиця	вулиця Воїнів-Інтернаціоналістів
Воїнів-Інтернаціоналістів вулиця	вулиця Воїнів-Інтернаціоналістів
Волиця вулиця	вулиця Волиця
Волі вулиця	вулиця Волі
Володимира Андрощука вулиця	вулиця Володимира Андрощука
Володимира Васильчука вулиця	вулиця Володимира Васильчука
Володимира Великого вулиця	вулиця Володимира Великого
Володимира Винниченка вулиця	вулиця Володимира Винниченка
Володимира Зарадюка вулиця	вулиця Володимира Зарадюка
Володимира Івасюка вулиця	вулиця Володимира Івасюка
Володимира Кияна вулиця	вулиця Володимира Кияна
Володимира Мономаха вулиця	вулиця Володимира Мономаха
Володимира Сосюри вулиця	вулиця Володимира Сосюри
Володимира Хомича вулиця	вулиця Володимира Хомича
Волошина вулиця	вулиця Волошина
Воля вулиця	вулиця Воля
Воровського вулиця	вулиця Воровського
Вороніхіна вулиця	вулиця Вороніхіна
Вороного вулиця	вулиця Вороного
Вуглерозвідників вулиця	вулиця Вуглерозвідників
В'ячеслава Липинського вулиця	вулиця Вʼячеслава Липинського
В’ячеслава Липинського вулиця	вулиця Вʼячеслава Липинського
В’ячеслава Хурсенка вулиця	вулиця Вʼячеслава Хурсенка
В'ячеслава Чорновола вулиця	вулиця Вʼячеслава Чорновола
В’ячеслава Чорновола вулиця	вулиця Вʼячеслава Чорновола
вулиця В'ячеслава Чорновола	вулиця Вʼячеслава Чорновола
Г. Сидорчук вулиця	вулиця Г. Сидорчук
Габріелі Запольської вулиця	вулиця Габріелі Запольської
Габрієлі Запольської вулиця	вулиця Габрієлі Запольської
Гаврилюка вулиця	вулиця Гаврилюка
Гаврися вулиця	вулиця Гаврися
гагаріна вулиця	вулиця Гагаріна
гАГАРІНА вулиця	вулиця Гагаріна
Гагаріна вулиця	вулиця Гагаріна
Газіна вулиця	вулиця Газіна
Гайдара вулиця	вулиця Гайдара
Гайдашука вулиця	вулиця Гайдашука
Галана вулиця	вулиця Галана
Галини Коханської  вулиця	вулиця Галини Коханської
Галини Коханської вулиця	вулиця Галини Коханської
Галини Рейкіної вулиця	вулиця Галини Рейкіної
Галшки Гулевичівни вулиця	вулиця Галшки Гулевичівни
Ганни Жежко вулиця	вулиця Ганни Жежко
Гасанова вулиця	вулиця Гасанова
Гастелло вулиця	вулиця Гастелло
Генерала Грекова вулиця	вулиця Генерала Грекова
Генерала Жукова вулиця	вулиця Генерала Жукова
Генерала Чупринки вулиця	вулиця Генерала Чупринки
Генерала Шухевича вулиця	вулиця Генерала Шухевича
Геологів вулиця	вулиця Геологів
Георгія Гонгадзе вулиця	вулиця Георгія Гонгадзе
Георгія Проскури вулиця	вулиця Георгія Проскури
Героїв Крут вулиця	вулиця Героїв Крут
ГероЇв Крут вулиця	вулиця Героїв Крут
Героїв Майдану вулиця	вулиця Героїв Майдану
Героїв небесної сотні вулиця	вулиця Героїв Небесної Сотні
Героїв Небесної сотні вулиця	вулиця Героїв Небесної Сотні
Героїв Небесної Сотні вулиця	вулиця Героїв Небесної Сотні
Героїв України вулиця	вулиця Героїв України
Героїв УПА вулиця	вулиця Героїв УПА
Героїв Чорнобиля вулиця	вулиця Героїв Чорнобиля
Героїв-добровольців вулиця	вулиця Героїв-Добровольців
Герцена вулиця	вулиця Герцена
Гетьмана Дорошенка вулиця	вулиця Гетьмана Дорошенка
Гетьмана Мазепи вулиця	вулиця Гетьмана Мазепи
Гетьмана Сагайдачного вулиця	вулиця Гетьмана Сагайдачного
Глинище вулиця	вулиця Глинище
Глібова вулиця	вулиця Глібова
Глієра вулиця	вулиця Глієра
Глінки вулиця	вулиця Глінки
Глушець вулиця	вулиця Глушець
Глущика вулиця	вулиця Глущика
Гнатюка вулиця	вулиця Гнатюка
Гніровського вулиця	вулиця Гніровського
Гоголя вулиця	вулиця Гоголя
Голобурди вулиця	вулиця Голобурди
Голубенка вулиця	вулиця Голубенка
Гончарівка вулиця	вулиця Гончарівка
Гончарова вулиця	вулиця Гончарова
Гордіюк вулиця	вулиця Гордіюк
Горєлова вулиця	вулиця Горєлова
Горілова вулиця	вулиця Горілова
Горка вулиця	вулиця Горка
Горького вулиця	вулиця Горького
Грабовського вулиця	вулиця Грабовського
Градний Узвіз вулиця	вулиця Градний Узвіз
Границя вулиця	вулиця Границя
Гребінки вулиця	вулиця Гребінки
Грекова вулиця	вулиця Грекова
Грибоєдова вулиця	вулиця Грибоєдова
Григорія Гуляницького вулиця	вулиця Григорія Гуляницького
Григорія Косинки вулиця	вулиця Григорія Косинки
Григорія Ланевича вулиця	вулиця Григорія Ланевича
Григорія Сковороди вулиця	вулиця Григорія Сковороди
Григорія Хомича вулиця	вулиця Григорія Хомича
Гризодубової вулиця	вулиця Гризодубової
Гриневича вулиця	вулиця Гриневича
Грінченка вулиця	вулиця Грінченка
Грушевського вулиця	вулиця Грушевського
Гуденка вулиця	вулиця Гуденка
Гулака Артемовського вулиця	вулиця Гулака-Артемовського
Гулака-Артемовського вулиця	вулиця Гулака-Артемовського
Гулевичівни вулиця	вулиця Гулевичівни
Д. Галицького вулиця	вулиця Д. Галицького
Данила галицького вулиця	вулиця Данила Галицького
Данила Галицького вулиця	вулиця Данила Галицького
Данила Нечая вулиця	вулиця Данила Нечая
Данила Шумука вулиця	вулиця Данила Шумука
Данильченка вулиця	вулиця Данильченка
Даньшина вулиця	вулиця Даньшина
Дарвіна вулиця	вулиця Дарвіна
Даргомижського вулиця	вулиця Даргомижського
Дверницького вулиця	вулиця Дверницького
Декабристів вулиця	вулиця Декабристів
Дем'яна Герштанського вулиця	вулиця Демʼяна Герштанського
Дем’янівка вулиця	вулиця Демʼянівка
Денисова вулиця	вулиця Денисова
Деревообробників вулиця	вулиця Деревообробників
Джура вулиця	вулиця Джура
Дзержинського вулиця	вулиця Дзержинського
Дисидентів вулиця	вулиця Дисидентів
Діброва вулиця	вулиця Діброва
Дмитра Вітовського вулиця	вулиця Дмитра Вітовського
Дмитра Донцова вулиця	вулиця Дмитра Донцова
Дмитра Іващенка вулиця	вулиця Дмитра Іващенка
Добровольців вулиця	вулиця Добровольців
Добролюбова вулиця	вулиця Добролюбова
Довбуша вулиця	вулиця Довбуша
Довгаля вулиця	вулиця Довгаля
Довженка вулиця	вулиця Довженка
Докучаєва вулиця	вулиця Докучаєва
Долинка вулиця	вулиця Долинка
Дорошенка вулиця	вулиця Дорошенка
Достоєвського вулиця	вулиця Достоєвського
Драгоманова вулиця	вулиця Драгоманова
Дружби вулиця	вулиця Дружби
Дружби Вулиця	вулиця Дружби
Дружби народів вулиця	вулиця Дружби Народів
Дружби Народів вулиця	вулиця Дружби Народів
Дубинка вулиця	вулиця Дубинка
Дубіка вулиця	вулиця Дубіка
Дунаєвського вулиця	вулиця Дунаєвського
Дюжинова вулиця	вулиця Дюжинова
Енгельса вулиця	вулиця Енгельса
Енергетиків вулиця	вулиця Енергетиків
Євгена Гаврилюка вулиця	вулиця Євгена Гаврилюка
Євгена Гребінки вулиця	вулиця Євгена Гребінки
Євгена Карановича вулиця	вулиця Євгена Карановича
Євгена Колодійчука вулиця	вулиця Євгена Колодійчука
Євгена Коновальця вулиця	вулиця Євгена Коновальця
Євгена Сверстюка вулиця	вулиця Євгена Сверстюка
Єрмолової вулиця	вулиця Єрмолової
Єршова вулиця	вулиця Єршова
Єрьоміна вулиця	вулиця Єрьоміна
Єсеніна вулиця	вулиця Єсеніна
Жежків вулиця	вулиця Жежків
Жукова вулиця	вулиця Жукова
Жуковського вулиця	вулиця Жуковського
З. Шумчук вулиця	вулиця З. Шумчук
Забріддя вулиця	вулиця Забріддя
Заглиння вулиця	вулиця Заглиння
Загребелля вулиця	вулиця Загребелля
Загребельного вулиця	вулиця Загребельного
Загребля вулиця	вулиця Загребля
Задвориння вулиця	вулиця Задвориння
Залізниця вулиця	вулиця Залізниця
Залізняка вулиця	вулиця Залізняка
Залужжя вулиця	вулиця Залужжя
Заньковецької вулиця	вулиця Заньковецької
Запольської вулиця	вулиця Запольської
Заріччя вулиця	вулиця Заріччя
Застав’є вулиця	вулиця Заставʼє
Застав’я вулиця	вулиця Заставʼя
Заступ’я вулиця	вулиця Заступʼя
Захарова вулиця	вулиця Захарова
Захисників Маріуполя вулиця	вулиця Захисників Маріуполя
Захисників України вулиця	вулиця Захисників України
Зацепи вулиця	вулиця Зацепи
Зв’язківців вулиця	вулиця Звʼязківців
Зелінського вулиця	вулиця Зелінського
Зерова вулиця	вулиця Зерова
Зільберта вулиця	вулиця Зільберта
Злагоди вулиця	вулиця Злагоди
Зої Космодем’янської вулиця	вулиця Зої Космодемʼянської
Золотаренка вулиця	вулиця Золотаренка
Зубінського вулиця	вулиця Зубінського
І.Франка вулиця	вулиця І. Франка
Івана Багряного вулиця	вулиця Івана Багряного
Івана Богуна вулиця	вулиця Івана Богуна
Івана Бубала вулиця	вулиця Івана Бубала
Івана Гонти вулиця	вулиця Івана Гонти
Івана Губи вулиця	вулиця Івана Губи
Івана Кожедуба вулиця	вулиця Івана Кожедуба
Івана Котляревського вулиця	вулиця Івана Котляревського
Івана Крип’якевича вулиця	вулиця Івана Крипʼякевича
Івана Купала вулиця	вулиця Івана Купала
Івана Мазепи вулиця	вулиця Івана Мазепи
Івана Миколайчука вулиця	вулиця Івана Миколайчука
Івана Огієнка вулиця	вулиця Івана Огієнка
Івана Пасевича вулиця	вулиця Івана Пасевича
Івана Перлика вулиця	вулиця Івана Перлика
Івана Підкови вулиця	вулиця Івана Підкови
Івана Пулюя вулиця	вулиця Івана Пулюя
Івана Сірка вулиця	вулиця Івана Сірка
Івана Тарасюка вулиця	вулиця Івана Тарасюка
Івана Федорова вулиця	вулиця Івана Федорова
Івана Франка вулиця	вулиця Івана Франка
Івана Ющука вулиця	вулиця Івана Ющука
Івасюка вулиця	вулиця Івасюка
Ігоря Сливки вулиця	вулиця Ігоря Сливки
Ізмайлова вулиця	вулиця Ізмайлова
Іови Кондзелевича вулиця	вулиця Іови Кондзелевича
Ісая вулиця	вулиця Ісая
Йова Кондзелевича вулиця	вулиця Йова Кондзелевича
Йосафата Кунцевича вулиця	вулиця Йосафата Кунцевича
Кавалерії вулиця	вулиця Кавалерії
Калахани вулиця	вулиця Калахани
Калініна вулиця	вулиця Калініна
Калнишевського вулиця	вулиця Калнишевського
Камінчука вулиця	вулиця Камінчука
Каразіна вулиця	вулиця Каразіна
Карбишева вулиця	вулиця Карбишева
Карла Маркса вулиця	вулиця Карла Маркса
Карла Маркса Вулиця	вулиця Карла Маркса
Кармелюка вулиця	вулиця Кармелюка
Карпенка-Карого вулиця	вулиця Карпенка-Карого
Каспрука вулиця	вулиця Каспрука
Катерини Білокур вулиця	вулиця Катерини Білокур
Кауркова вулиця	вулиця Кауркова
Качалова вулиця	вулиця Качалова
Квачука вулиця	вулиця Квачука
Квітки-Основ’яненка вулиця	вулиця Квітки-Основʼяненка
Киричука вулиця	вулиця Киричука
Кисіля вулиця	вулиця Кисіля
Кіборгів вулиця	вулиця Кіборгів
Кірова вулиця	вулиця Кірова
Клари Цеткін вулиця	вулиця Клари Цеткін
Клебанщина вулиця	вулиця Клебанщина
Клима Савура вулиця	вулиця Клима Савура
Клима Савури вулиця	вулиця Клима Савури
Княгині Ольги вулиця	вулиця Княгині Ольги
Князів острозьких вулиця	вулиця Князів Острозьких
Князів Острозьких вулиця	вулиця Князів Острозьких
Князів Ружинських вулиця	вулиця Князів Ружинських
Князя Василька вулиця	вулиця Князя Василька
Князя Володимира вулиця	вулиця Князя Володимира
Князя Всеволода вулиця	вулиця Князя Всеволода
Князя Любаша вулиця	вулиця Князя Любаша
Князя Мстислава вулиця	вулиця Князя Мстислава
Князя Олега вулиця	вулиця Князя Олега
Князя Острозького вулиця	вулиця Князя Острозького
Князя Романа вулиця	вулиця Князя Романа
Князя Романа Великого вулиця	вулиця Князя Романа Великого
Кобзаря вулиця	вулиця Кобзаря
Кобилянської вулиця	вулиця Кобилянської
Ковальова вулиця	вулиця Ковальова
Ковальчуків вулиця	вулиця Ковальчуків
Ковпака вулиця	вулиця Ковпака
Ковського вулиця	вулиця Ковського
Кожедуба вулиця	вулиця Кожедуба
Козакова вулиця	вулиця Козакова
Козацької слави вулиця	вулиця Козацької Слави
Козацької Слави вулиця	вулиця Козацької Слави
Козіно вулиця	вулиця Козіно
Кокінакі вулиця	вулиця Кокінакі
Коккінакі вулиця	вулиця Коккінакі
Кольцова вулиця	вулиця Кольцова
комарова вулиця	вулиця Комарова
Комарова вулиця	вулиця Комарова
Комка вулиця	вулиця Комка
Кондзелевича вулиця	вулиця Кондзелевича
Кондратюка вулиця	вулиця Кондратюка
Конищука вулиця	вулиця Конищука
Коновалова вулиця	вулиця Коновалова
Коновальця вулиця	вулиця Коновальця
Конотопської битви вулиця	вулиця Конотопської Битви
Конотопської Битви вулиця	вулиця Конотопської Битви
Конякіна вулиця	вулиця Конякіна
Копань вулиця	вулиця Копань
Коперника вулиця	вулиця Коперника
Коперніка вулиця	вулиця Коперніка
Корея вулиця	вулиця Корея
Короленка вулиця	вулиця Короленка
Корольова вулиця	вулиця Корольова
Короля Данила вулиця	вулиця Короля Данила
Косачів вулиця	вулиця Косачів
Космодем'янської вулиця	вулиця Космодемʼянської
Космонавтів вулиця	вулиця Космонавтів
Костомарова вулиця	вулиця Костомарова
Костючика вулиця	вулиця Костючика
Костюшка вулиця	вулиця Костюшка
Костюшко вулиця	вулиця Костюшко
Коте Шилокадзе вулиця	вулиця Коте Шилокадзе
Котляревського вулиця	вулиця Котляревського
Котовського вулиця	вулиця Котовського
Коцюбинського вулиця	вулиця Коцюбинського
Кочерги вулиця	вулиця Кочерги
Кошового вулиця	вулиця Кошового
Кравчука вулиця	вулиця Кравчука
Кривенького вулиця	вулиця Кривенького
Кривий Вал вулиця	вулиця Кривий Вал
Кривоноса вулиця	вулиця Кривоноса
Крилова вулиця	вулиця Крилова
Кримського вулиця	вулиця Кримського
Кропивницького вулиця	вулиця Кропивницького
Крупської вулиця	вулиця Крупської
Крушельницького вулиця	вулиця Крушельницького
Крушельницької вулиця	вулиця Крушельницької
Кузнецова вулиця	вулиця Кузнецова
Кузнєцова вулиця	вулиця Кузнєцова
Кузьміна вулиця	вулиця Кузьміна
Куйбишева вулиця	вулиця Куйбишева
Кулаковського вулиця	вулиця Кулаковського
Куліша вулиця	вулиця Куліша
Кунцевича вулиця	вулиця Кунцевича
Купріна вулиця	вулиця Купріна
Куптія вулиця	вулиця Куптія
Курбаса вулиця	вулиця Курбаса
Курчатова вулиця	вулиця Курчатова
Кутузова вулиця	вулиця Кутузова
Л. Толстого вулиця	вулиця Л. Толстого
Лаврентія Горки вулиця	вулиця Лаврентія Горки
Лазарчука вулиця	вулиця Лазарчука
Лазо вулиця	вулиця Лазо
Ландау вулиця	вулиця Ландау
Лаховського вулиця	вулиця Лаховського
Левінцова вулиця	вулиця Левінцова
Левітана вулиця	вулиця Левітана
вулиця Левка Лук'яненка	вулиця Левка Лукʼяненка
Левка Лук'яненка вулиця	вулиця Левка Лукʼяненка
Левченка вулиця	вулиця Левченка
Лейтенанта Кібенок вулиця	вулиця Лейтенанта Кібенок
Леніна вулиця	вулиця Леніна
Леоніда Каденюка вулиця	вулиця Леоніда Каденюка
Леонтовича вулиця	вулиця Леонтовича
Лермонтова вулиця	вулиця Лермонтова
Лесі Паєвської вулиця	вулиця Лесі Паєвської
Лесі Українки вулиця	вулиця Лесі Українки
Лесі УКраїнки вулиця	вулиця Лесі Українки
ЛЕСІ УКРАЇНКИ вулиця	вулиця Лесі Українки
Леся Курбаса вулиця	вулиця Леся Курбаса
Леся Мартовича вулиця	вулиця Леся Мартовича
Лечин вулиця	вулиця Лечин
Лєскова вулиця	вулиця Лєскова
Липинського вулиця	вулиця Липинського
Липкана вулиця	вулиця Липкана
Лисенка вулиця	вулиця Лисенка
Лізи Чайкіної вулиця	вулиця Лізи Чайкіної
Лобачевського вулиця	вулиця Лобачевського
Локачинського вулиця	вулиця Локачинського
Ломоносова вулиця	вулиця Ломоносова
Лопатіна вулиця	вулиця Лопатіна
Лотоцького вулиця	вулиця Лотоцького
Лук’яна Кобилиці вулиця	вулиця Лукʼяна Кобилиці
Льва Толстого вулиця	вулиця Льва Толстого
Любини вулиця	вулиця Любини
Людмирської Діви вулиця	вулиця Людмирської Діви
Мазепи вулиця	вулиця Мазепи
Майструка вулиця	вулиця Майструка
Макаренка вулиця	вулиця Макаренка
Макарова вулиця	вулиця Макарова
Маковського вулиця	вулиця Маковського
Максима Горького вулиця	вулиця Максима Горького
Максима Залізняка вулиця	вулиця Максима Залізняка
Максима Кривоноса вулиця	вулиця Максима Кривоноса
Максима Рильського вулиця	вулиця Максима Рильського
Максимука вулиця	вулиця Максимука
Кут Малиновий вулиця	вулиця Малиновий Кут
Малишка вулиця	вулиця Малишка
Малієвських вулиця	вулиця Малієвських
Малієвського вулиця	вулиця Малієвського
Мальчевського вулиця	вулиця Мальчевського
Маргарити Малиновської вулиця	вулиця Маргарити Малиновської
Марії Заньковецької вулиця	вулиця Марії Заньковецької
Марка Безручка вулиця	вулиця Марка Безручка
Марка Вовчка вулиця	вулиця Марка Вовчка
Марка Кримчука вулиця	вулиця Марка Кримчука
Марка Черемшини вулиця	вулиця Марка Черемшини
Маркевича вулиця	вулиця Маркевича
Марко Вовчок вулиця	вулиця Марко Вовчок
Мартинюка вулиця	вулиця Мартинюка
Марусі Богуславки вулиця	вулиця Марусі Богуславки
Марусі Чурай вулиця	вулиця Марусі Чурай
Матейка вулиця	вулиця Матейка
Матиюка вулиця	вулиця Матиюка
Матієнка вулиця	вулиця Матієнка
матросова вулиця	вулиця Матросова
Матросова вулиця	вулиця Матросова
Маяковського вулиця	вулиця Маяковського
Меліораторів вулиця	вулиця Меліораторів
Мельника вулиця	вулиця Мельника
Менделєєва вулиця	вулиця Менделєєва
Менчикова вулиця	вулиця Менчикова
Механізаторів вулиця	вулиця Механізаторів
Мечникова вулиця	вулиця Мечникова
Мєдвєдєва вулиця	вулиця Мєдвєдєва
Миколи Аркаса вулиця	вулиця Миколи Аркаса
Миколи Букатевича вулиця	вулиця Миколи Букатевича
Миколи Коперника вулиця	вулиця Миколи Коперника
Миколи Куделі вулиця	вулиця Миколи Куделі
Миколи Леонтовича вулиця	вулиця Миколи Леонтовича
Миколи Лисенка вулиця	вулиця Миколи Лисенка
Миколи Макаренка вулиця	вулиця Миколи Макаренка
Миколи Міхновського вулиця	вулиця Миколи Міхновського
Миколи Островського вулиця	вулиця Миколи Островського
Миколи Пирогова вулиця	вулиця Миколи Пирогова
Миколи Хвильового вулиця	вулиця Миколи Хвильового
Мирослава Скорика вулиця	вулиця Мирослава Скорика
Мирослави вулиця	вулиця Мирослави
Миру вулиця	вулиця Миру
Миру Вулиця	вулиця Миру
Митрополита Андрея Шептицького вулиця	вулиця Митрополита Андрея Шептицького
Митрополита Шептицького вулиця	вулиця Митрополита Шептицького
Михайла Вербицького вулиця	вулиця Михайла Вербицького
Михайла Гаврилка вулиця	вулиця Михайла Гаврилка
Михайла Глінки вулиця	вулиця Михайла Глінки
Михайла Грушевського вулиця	вулиця Михайла Грушевського
Михайла Драй-Хмари вулиця	вулиця Михайла Драй-Хмари
Михайла Коцюбинського вулиця	вулиця Михайла Коцюбинського
Михайла Тележинського вулиця	вулиця Михайла Тележинського
Міцкевича вулиця	вулиця Міцкевича
Мічуріна вулиця	вулиця Мічуріна
Модеста Левицького вулиця	вулиця Модеста Левицького
Можайського вулиця	вулиця Можайського
Молодогвардійців вулиця	вулиця Молодогвардійців
Мохнюка вулиця	вулиця Мохнюка
Мрії вулиця	вулиця Мрії
Музиченка вулиця	вулиця Музиченка
Мурашка вулиця	вулиця Мурашка
Мячина вулиця	вулиця Мячина
На Таборищі вулиця	вулиця На Таборищі
Надії вулиця	вулиця Надії
Назарія Яремчука вулиця	вулиця Назарія Яремчука
Наконечного вулиця	вулиця Наконечного
Наливайка вулиця	вулиця Наливайка
Народів вулиця	вулиця Народів
Народних Депутатів вулиця	вулиця Народних Депутатів
Наталії Ужвій вулиця	вулиця Наталії Ужвій
Нахімова вулиця	вулиця Нахімова
Небесної сотні вулиця	вулиця Небесної Сотні
Небесної Сотні вулиця	вулиця Небесної Сотні
Незалежності вулиця	вулиця Незалежності
Некрасова вулиця	вулиця Некрасова
Нестерова вулиця	вулиця Нестерова
Нестора Бурчака вулиця	вулиця Нестора Бурчака
Літописця Нестора вулиця	вулиця Нестора Літописця
Нечуя-Левицького вулиця	вулиця Нечуя-Левицького
Нікішева вулиця	вулиця Нікішева
Ніла Хасевича вулиця	вулиця Ніла Хасевича
Нова Воля вулиця	вулиця Нова Воля
Новоселів вулиця	вулиця Новоселів
Новосілля вулиця	вулиця Новосілля
О. Заєць вулиця	вулиця О. Заєць
Огієнка вулиця	вулиця Огієнка
Огієнко вулиця	вулиця Огієнко
Олега Кошового вулиця	вулиця Олега Кошового
Олега Ольжича вулиця	вулиця Олега Ольжича
Олександра Богачука вулиця	вулиця Олександра Богачука
Олександра Довженка вулиця	вулиця Олександра Довженка
Олександра Кониського вулиця	вулиця Олександра Кониського
Олександра Невського вулиця	вулиця Олександра Невського
Олександра Олеся вулиця	вулиця Олександра Олеся
Олександра Оніщука вулиця	вулиця Олександра Оніщука
Олександрів вулиця	вулиця Олександрів
Олекси Алмазова вулиця	вулиця Олекси Алмазова
Олекси Довбуша вулиця	вулиця Олекси Довбуша
Олекси Новаківського вулиця	вулиця Олекси Новаківського
Олекси Ошуркевича вулиця	вулиця Олекси Ошуркевича
Олекси Тихого вулиця	вулиця Олекси Тихого
Олексія Шума вулиця	вулиця Олексія Шума
Олексюка вулиця	вулиця Олексюка
Олени Кульчицької вулиця	вулиця Олени Кульчицької
Олени Полонської вулиця	вулиця Олени Полонської
Олени Пчілки вулиця	вулиця Олени Пчілки
Олени Теліги вулиця	вулиця Олени Теліги
Олени Хохол вулиця	вулиця Олени Хохол
Олеся Гончара вулиця	вулиця Олеся Гончара
Олійника вулиця	вулиця Олійника
Ольги Басараб вулиця	вулиця Ольги Басараб
Ольги Кобилянської вулиця	вулиця Ольги Кобилянської
Оляндри вулиця	вулиця Оляндри
Орджонікідзе вулиця	вулиця Орджонікідзе
Осипенка вулиця	вулиця Осипенка
Остапа Вересая вулиця	вулиця Остапа Вересая
Остапа Вишні вулиця	вулиця Остапа Вишні
Островського вулиця	вулиця Островського
П. Савєльєвої вулиця	вулиця П. Савєльєвої
Павла Пащевського вулиця	вулиця Павла Пащевського
Павла Полуботка вулиця	вулиця Павла Полуботка
Павла Скоропадського вулиця	вулиця Павла Скоропадського
Павла Тичини вулиця	вулиця Павла Тичини
Павла Чубинського вулиця	вулиця Павла Чубинського
павлова вулиця	вулиця Павлова
Павлова вулиця	вулиця Павлова
Палія вулиця	вулиця Палія
Панаса Мирного вулиця	вулиця Панаса Мирного
Панасюка вулиця	вулиця Панасюка
Паризької комуни вулиця	вулиця Паризької Комуни
Паризької Комуни вулиця	вулиця Паризької Комуни
Партизанів вулиця	вулиця Партизанів
Пархоменка вулиця	вулиця Пархоменка
Патона вулиця	вулиця Патона
Паторжинського вулиця	вулиця Паторжинського
Паши Савельєвої вулиця	вулиця Паші Савельєвої
Паші Савелєвої вулиця	вулиця Паші Савельєвої
Паші Савєльєвої вулиця	вулиця Паші Савельєвої
Перемоги вулиця	вулиця Перемоги
Петра Болбочана вулиця	вулиця Петра Болбочана
Петра Грабовського вулиця	вулиця Петра Грабовського
Петра Мартинюка вулиця	вулиця Петра Мартинюка
Петра Маха вулиця	вулиця Петра Маха
Петра Могили вулиця	вулиця Петра Могили
Петра Сагайдачного вулиця	вулиця Петра Сагайдачного
Петра Штика вулиця	вулиця Петра Штика
Петрова вулиця	вулиця Петрова
Петрука вулиця	вулиця Петрука
Петрусенко вулиця	вулиця Петрусенко
Пилипа Мельника вулиця	вулиця Пилипа Мельника
Пилипа Орлика вулиця	вулиця Пилипа Орлика
Писаревського вулиця	вулиця Писаревського
Підгірських вулиця	вулиця Підгірських
Підгір'я вулиця	вулиця Підгірʼя
Підгір’я вулиця	вулиця Підгірʼя
Підзамче вулиця	вулиця Підзамче
Підколодного вулиця	вулиця Підколодного
Підліски вулиця	вулиця Підліски
Підріжжя вулиця	вулиця Підріжжя
Підцерква вулиця	вулиця Підцерква
Плетінка вулиця	вулиця Плетінка
Плитниця вулиця	вулиця Плитниця
Покальчуків вулиця	вулиця Покальчуків
Поліська Січ вулиця	вулиця Поліська Січ
Поліської Січі вулиця	вулиця Поліської Січі
Поліщука вулиця	вулиця Поліщука
Полковника Литвинюка вулиця	вулиця Полковника Литвинюка
Полуботка вулиця	вулиця Полуботка
Полянка вулиця	вулиця Полянка
Полянського вулиця	вулиця Полянського
Попова вулиця	вулиця Попова
Послідовського вулиця	вулиця Послідовського
Потебні вулиця	вулиця Потебні
Праведників народів світу вулиця	вулиця Праведників Народів Світу
Прасолів вулиця	вулиця Прасолів
Прикордонників вулиця	вулиця Прикордонників
Прогресу вулиця	вулиця Прогресу
Прокоповича вулиця	вулиця Прокоповича
Прокопюка вулиця	вулиця Прокопюка
Просвіти вулиця	вулиця Просвіти
Професора Бобка вулиця	вулиця Професора Бобка
Пугачова вулиця	вулиця Пугачова
Пушкіна вулиця	вулиця Пушкіна
П’ятихатки вулиця	вулиця Пʼятихатки
П’ятницька Гірка вулиця	вулиця Пʼятницька Гірка
Ради Європи вулиця	вулиця Ради Європи
Радіщева вулиця	вулиця Радіщева
Рахманінова вулиця	вулиця Рахманінова
Раціоналізаторів вулиця	вулиця Раціоналізаторів
Ревуцького вулиця	вулиця Ревуцького
Рєпіна вулиця	вулиця Рєпіна
Рилєєва вулиця	вулиця Рилєєва
Рильського вулиця	вулиця Рильського
Ринок вулиця	вулиця Ринок
Річинського вулиця	вулиця Річинського
Рогізно вулиця	вулиця Рогізно
Родини Тобілевичів вулиця	вулиця Родини Тобілевичів
Рокицького вулиця	вулиця Рокицького
Рокосовського вулиця	вулиця Рокосовського
Роксолани вулиця	вулиця Роксолани
Романа Шухевича вулиця	вулиця Романа Шухевича
Романюка вулиця	вулиця Романюка
Ростислава Братуня вулиця	вулиця Ростислава Братуня
Ростислава Волошина вулиця	вулиця Ростислава Волошина
Рощини вулиця	вулиця Рощини
Руданського вулиця	вулиця Руданського
Руденка вулиця	вулиця Руденка
Руднєєва вулиця	вулиця Руднєєва
Рудочка вулиця	вулиця Рудочка
Румовського вулиця	вулиця Румовського
Руставелі вулиця	вулиця Руставелі
Рятувальників вулиця	вулиця Рятувальників
Савицької вулиця	вулиця Савицької
Сагайдачного вулиця	вулиця Сагайдачного
Садовського вулиця	вулиця Садовського
Саксаганського вулиця	вулиця Саксаганського
Салтикова-Щедріна вулиця	вулиця Салтикова-Щедріна
Самойла Величка вулиця	вулиця Самійла Величка
Самохіна вулиця	вулиця Самохіна
Саперів вулиця	вулиця Саперів
Сарапіних вулиця	вулиця Сарапіних
Сафрона Мицюка вулиця	вулиця Сафрона Мицюка
Свердлова вулиця	вулиця Свердлова
Свидригайла вулиця	вулиця Свидригайла
Свободи вулиця	вулиця Свободи
Святого Володимира вулиця	вулиця Святого Володимира
Святого Миколая вулиця	вулиця Святого Миколая
Северина Наливайка вулиця	вулиця Северина Наливайка
Сенатора вулиця	вулиця Сенатора
Сенаторки Левчанівської вулиця	вулиця Сенаторки Левчанівської
Сергія Богдана вулиця	вулиця Сергія Богдана
Сергія Корольова вулиця	вулиця Сергія Корольова
Сергія Кривенького вулиця	вулиця Сергія Кривенького
Сергія Курила вулиця	вулиця Сергія Курила
Сергія Рудика вулиця	вулиця Сергія Рудика
Сергія Тимошенка вулиця	вулиця Сергія Тимошенка
Сєченова вулиця	вулиця Сєченова
Симеренка вулиця	вулиця Симеренка
Симиренка вулиця	вулиця Симиренка
Симона Петлюри вулиця	вулиця Симона Петлюри
Симоненка вулиця	вулиця Симоненка
Сінкевича вулиця	вулиця Сінкевича
Сірка вулиця	вулиця Сірка
Сірої дивізії вулиця	вулиця Сірої Дивізії
Січових стрільців вулиця	вулиця Січових Стрільців
Січових Стрільців вулиця	вулиця Січових Стрільців
Скляренка вулиця	вулиця Скляренка
Скобелка вулиця	вулиця Скобелка
Сковороди вулиця	вулиця Сковороди
Скрябіна вулиця	вулиця Скрябіна
Словацького вулиця	вулиця Словацького
Слупачика вулиця	вулиця Слупачика
Смаля вулиця	вулиця Смаля
Смєлякова вулиця	вулиця Смєлякова
Смирнова вулиця	вулиця Смирнова
Смірнова вулиця	вулиця Смірнова
Смоливиця вулиця	вулиця Смоливиця
Смолярня вулиця	вулиця Смолярня
Смотрицького вулиця	вулиця Смотрицького
Собесяка вулиця	вулиця Собесяка
вулиця Соборності	вулиця Соборності
Вулиця Соборності	вулиця Соборності
Соборності вулиця	вулиця Соборності
Солобаєва вулиця	вулиця Солобаєва
Соловчиння вулиця	вулиця Соловчиння
Соломії Крушельницької вулиця	вулиця Соломії Крушельницької
Сосюри вулиця	вулиця Сосюри
Софії Ковалевської вулиця	вулиця Софії Ковалевської
Софії Перовської вулиця	вулиця Софії Перовської
СофіЇ ПеровськоЇ вулиця	вулиця Софії Перовської
Софії Русової вулиця	вулиця Софії Русової
Спиридона Гнатюка вулиця	вулиця Спиридона Гнатюка
Ставки вулиця	вулиця Ставки
Дністрянського Станіслава вулиця	вулиця Станіслава Дністрянського
Станіславського вулиця	вулиця Станіславського
Стара дорога вулиця	вулиця Стара Дорога
Стара Дорога вулиця	вулиця Стара Дорога
Старицьких вулиця	вулиця Старицьких
Старицького вулиця	вулиця Старицького
Степана Бандери вулиця	вулиця Степана Бандери
Степана Бойка вулиця	вулиця Степана Бойка
Степана Кривенького вулиця	вулиця Степана Кривенького
Степана Мазурця вулиця	вулиця Степана Мазурця
Степана Рудайського вулиця	вулиця Степана Рудайського
Степана Тулайдана вулиця	вулиця Степана Тулайдана
Степана Фуги вулиця	вулиця Степана Фуги
Степаняна вулиця	вулиця Степаняна
Стефаника вулиця	вулиця Стефаника
Столярчука вулиця	вулиця Столярчука
Стравінського вулиця	вулиця Стравінського
Стрельникова вулиця	вулиця Стрельникова
Струглі вулиця	вулиця Струглі
Струтинської вулиця	вулиця Струтинської
Стубелевича вулиця	вулиця Стубелевича
Стуса вулиця	вулиця Стуса
Суворова вулиця	вулиця Суворова
Супутника вулиця	вулиця Супутника
Сухарєва вулиця	вулиця Сухарєва
Сухомлинського вулиця	вулиця Сухомлинського
Сушкевича вулиця	вулиця Сушкевича
Тараса Боровця вулиця	вулиця Тараса Боровця
Тараса Бульби-Боровця вулиця	вулиця Тараса Бульби-Боровця
Тараса Шевченка вулиця	вулиця Тараса Шевченка
Тараса Шевченка Вулиця	вулиця Тараса Шевченка
Терешкової вулиця	вулиця Терешкової
Тесленка вулиця	вулиця Тесленка
Тиверців вулиця	вулиця Тиверців
Тимовського вулиця	вулиця Тимовського
Тимошенка вулиця	вулиця Тимошенка
Тичини вулиця	вулиця Тичини
Тишика вулиця	вулиця Тишика
Тімірязєва вулиця	вулиця Тімірязєва
Толока вулиця	вулиця Толока
Толстого вулиця	вулиця Толстого
Тридуба вулиця	вулиця Тридуба
Трохима Цьося вулиця	вулиця Трохима Цьося
Троця вулиця	вулиця Троця
Трункіна вулиця	вулиця Трункіна
Трутовського вулиця	вулиця Трутовського
Туполєва вулиця	вулиця Туполєва
Тургенєва вулиця	вулиця Тургенєва
Тургєнєва вулиця	вулиця Тургєнєва
Українських Героїв вулиця	вулиця Українських Героїв
Української Армії вулиця	вулиця Української Армії
Уласа Самчука вулиця	вулиця Уласа Самчука
Уляни Громової вулиця	вулиця Уляни Громової
Уляни Саркевич вулиця	вулиця Уляни Саркевич
Устима Кармелюка вулиця	вулиця Устима Кармелюка
Ушинського вулиця	вулиця Ушинського
Федорова вулиця	вулиця Федорова
Федьковича вулиця	вулиця Федьковича
Фещака вулиця	вулиця Фещака
Філатова вулиця	вулиця Філатова
Франка вулиця	вулиця Франка
Фрунзе вулиця	вулиця Фрунзе
Хакімова вулиця	вулиця Хакімова
Халчевської вулиця	вулиця Халчевської
Хані вулиця	вулиця Хані
Хвильового вулиця	вулиця Хвильового
Хмельницького вулиця	вулиця Хмельницького
Хмільова вулиця	вулиця Хмільова
Ходкевича вулиця	вулиця Ходкевича
Хотинського вулиця	вулиця Хотинського
Хутір вулиця	вулиця Хутір
Цинкаловського вулиця	вулиця Цинкаловського
Ціолковського вулиця	вулиця Ціолковського
Чайковського вулиця	вулиця Чайковського
Чапаєва вулиця	вулиця Чапаєва
Чекаленко вулиця	вулиця Чекаленко
Челюскіна вулиця	вулиця Челюскіна
Червоного Хреста вулиця	вулиця Червоного Хреста
Червоної Армії вулиця	вулиця Червоної Армії
Червоної Калини вулиця	вулиця Червоної Калини
Чернишевського вулиця	вулиця Чернишевського
Чернухи вулиця	вулиця Чернухи
Черняховського вулиця	вулиця Черняховського
Чехова вулиця	вулиця Чехова
Чкалова вулиця	вулиця Чкалова
Чорновола вулиця	вулиця Чорновола
Чубинського вулиця	вулиця Чубинського
Чумовицкого вулиця	вулиця Чумовицкого
Чумовицького вулиця	вулиця Чумовицького
Шабліовського вулиця	вулиця Шабліовського
Шави вулиця	вулиця Шави
Шапова вулиця	вулиця Шапова
Шевченка вулиця	вулиця Шевченка
Шептицького вулиця	вулиця Шептицького
Шишкіна вулиця	вулиця Шишкіна
Шістдесятників вулиця	вулиця Шістдесятників
Шковороди вулиця	вулиця Шковороди
Шолбіна вулиця	вулиця Шолбіна
Шолохова вулиця	вулиця Шолохова
Шопена вулиця	вулиця Шопена
Шостаковича вулиця	вулиця Шостаковича
Шостий гон вулиця	вулиця Шостий Гон
Шота Руставелі вулиця	вулиця Шота Руставелі
Шукшина вулиця	вулиця Шукшина
Шумика вулиця	вулиця Шумика
Шуміка вулиця	вулиця Шуміка
Шухевича вулиця	вулиця Шухевича
Щастя вулиця	вулиця Щастя
Щепкіна вулиця	вулиця Щепкіна
Щоголіва вулиця	вулиця Щоголіва
Щорса вулиця	вулиця Щорса
Щусєва вулиця	вулиця Щусєва
Юзефа Чеховіча вулиця	вулиця Юзефа Чеховіча
Юліана Опільського вулиця	вулиця Юліана Опільського
Юності вулиця	вулиця Юності
Юрія Гагаріна вулиця	вулиця Юрія Гагаріна
Юрія Кондратюка вулиця	вулиця Юрія Кондратюка
Юрія Трохимука вулиця	вулиця Юрія Трохимука
Юрія Тютюнника вулиця	вулиця Юрія Тютюнника
Юхима Бунди вулиця	вулиця Юхима Бунди
Юхимука вулиця	вулиця Юхимука
Я. Галана вулиця	вулиця Я. Галана
Яворівка вулиця	вулиця Яворівка
Яворницького вулиця	вулиця Яворницького
Янки Купали вулиця	вулиця Янки Купали
Яновського вулиця	вулиця Яновського
Янчишина вулиця	вулиця Янчишина
Ярини Смоляр вулиця	вулиця Ярини Смоляр
Ярмолівка вулиця	вулиця Ярмолівка
Ярмолюка вулиця	вулиця Ярмолюка
Ярмошука вулиця	вулиця Ярмошука
Яровиця вулиця	вулиця Яровиця
Ярослава Мудрого вулиця	вулиця Ярослава Мудрого
Ярослава Стецька вулиця	вулиця Ярослава Стецька
Ярослава Царука вулиця	вулиця Ярослава Царука
Ярощука вулиця	вулиця Ярощука
Яруська вулиця	вулиця Яруська
Ясеничче вулиця	вулиця Ясеничче
В’язівненський провулок	Вʼязівненський провулок
Зап'ятницька вулиця	Запʼятницька вулиця
Бена міст	міст Бена
Міст закоханих	міст Закоханих
Нагірна Вулиця	Нагірна вулиця
Об'їздна вулиця	Обʼїздна вулиця
Об’їздна вулиця	Обʼїздна вулиця
Об’їзна вулиця	Обʼїзна вулиця
першотравнева вулиця	Першотравнева вулиця
Героїв Майдану площа	площа Героїв Майдану
Героїв Майдану Площа	площа Героїв Майдану
Культури площа	площа Культури
Миру площа	площа Миру
Незалежності площа	площа Незалежності
Площа Незалежності	площа Незалежності
Покровська Вулиця	Покровська вулиця
Полоьова вулиця	Польова вулиця
Привокзальна Вулиця	Привокзальна вулиця
30-річчя Перемоги провулок	провулок 30-річчя Перемоги
8 Березня провулок	провулок 8 Березня
8-го Березня провулок	провулок 8 Березня
9 Травня провулок	провулок 9 Травня
Академіка Кравчука провулок	провулок Академіка Кравчука
Андрія Первозванного провулок	провулок Андрія Первозванного
Баранова провулок	провулок Баранова
Богатирьова провулок	провулок Богатирьова
Бойко провулок	провулок Бойко
Бондаренка провулок	провулок Бондаренка
Будівельників провулок	провулок Будівельників
Ватутіна провулок	провулок Ватутіна
Виговського провулок	провулок Виговського
Винниченка провулок	провулок Винниченка
Відродження провулок	провулок Відродження
Волі провулок	провулок Волі
В'ячеслава Липинського провулок	провулок Вʼячеслава Липинського
В’ячеслава Липинського провулок	провулок Вʼячеслава Липинського
Гагаріна провулок	провулок Гагаріна
Галана провулок	провулок Галана
Галини Коханської провулок	провулок Галини Коханської
Героїв УПА провулок	провулок Героїв УПА
Глібова провулок	провулок Глібова
Гоголя провулок	провулок Гоголя
Грибоєдова провулок	провулок Грибоєдова
Грінченка провулок	провулок Грінченка
Грушевського провулок	провулок Грушевського
Дмитра Донцова провулок	провулок Дмитра Донцова
Дорошенка провулок	провулок Дорошенка
Достоєвського провулок	провулок Достоєвського
Дружби провулок	провулок Дружби
Енергетиків провулок	провулок Енергетиків
Євгена Коновальця провулок	провулок Євгена Коновальця
Залізничників провулок	провулок Залізничників
Захисників України провулок	провулок Захисників України
Зої Космодем’янської провулок	провулок Зої Космодемʼянської
Івана Богуна провулок	провулок Івана Богуна
Івана Котляревського провулок	провулок Івана Котляревського
Івана Франка провулок	провулок Івана Франка
Качалова провулок	провулок Качалова
Князів Острозьких провулок	провулок Князів Острозьких
Комарова провулок	провулок Комарова
Конищука провулок	провулок Конищука
Костюшка провулок	провулок Костюшка
Кошового провулок	провулок Кошового
Крилова провулок	провулок Крилова
Левицького провулок	провулок Левицького
Леоніда Каденюка провулок	провулок Леоніда Каденюка
Лермонтова провулок	провулок Лермонтова
Лесі Українки провулок	провулок Лесі Українки
Лізи Чайкіної провулок	провулок Лізи Чайкіної
М. Бурака провулок	провулок М. Бурака
Мазепи провулок	провулок Мазепи
матросова провулок	провулок Матросова
Матросова провулок	провулок Матросова
Маяковського провулок	провулок Маяковського
Миколайчука провулок	провулок Миколайчука
Миколи Ваврисевича провулок	провулок Миколи Ваврисевича
Миру провулок	провулок Миру
Михайла Драй-Хмари провулок	провулок Михайла Драй-Хмари
Міцкевича провулок	провулок Міцкевича
Мічуріна провулок	провулок Мічуріна
Мотузи провулок	провулок Мотузи
Н. Поліщук провулок	провулок Н. Поліщук
Народів провулок	провулок Народів
Незалежності провулок	провулок Незалежності
Некрасова провулок	провулок Некрасова
Нова Воля провулок	провулок Нова Воля
Олени Пчілки провулок	провулок Олени Пчілки
Олеся Гончара провулок	провулок Олеся Гончара
Перемоги провулок	провулок Перемоги
Поліщука провулок	провулок Поліщука
Прикордонників провулок	провулок Прикордонників
Пугачова провулок	провулок Пугачова
Пушкіна провулок	провулок Пушкіна
Рєпіна провулок	провулок Рєпіна
Сагайдачного провулок	провулок Сагайдачного
Свободи провулок	провулок Свободи
Святої Покрови провулок	провулок Святої Покрови
Симоненка провулок	провулок Симоненка
Січових стрільців провулок	провулок Січових Стрільців
Січових Стрільців провулок	провулок Січових Стрільців
Слави провулок	провулок Слави
Соборності провулок	провулок Соборності
Старицького провулок	провулок Старицького
Степана Мазурця провулок	провулок Степана Мазурця
Стефаника провулок	провулок Стефаника
Тараса Шевченка провулок	провулок Тараса Шевченка
Тарасики провулок	провулок Тарасики
Толстого провулок	провулок Толстого
Труша провулок	провулок Труша
Циганика провулок	провулок Циганика
Чкалова провулок	провулок Чкалова
Шевченка провулок	провулок Шевченка
Шептицького провулок	провулок Шептицького
Шота Руставелі провулок	провулок Шота Руставелі
Щорса провулок	провулок Щорса
Я. Галана провулок	провулок Я. Галана
Язвини провулок	провулок Язвини
Ярмолюки провулок	провулок Ярмолюки
Міцкевича проїзд	проїзд Міцкевича
Тещин Язик проїзд	проїзд Тещин Язик
пролетарська вулиця	Пролетарська вулиця
Василя Мойсея проспект	проспект Василя Мойсея
Відродження проспект	проспект Відродження
Волі проспект	проспект Волі
Дружби проспект	проспект Дружби
Молоді проспект	проспект Молоді
Перемоги проспект	проспект Перемоги
Президента Грушевського проспект	проспект Президента Грушевського
Соборності проспект	проспект Соборності
вулиця Робітнича	Робітнича вулиця
Робітнича Вулиця	Робітнича вулиця
Слов’янська вулиця	Словʼянська вулиця
вулиця Соборна	Соборна вулиця
Солов’їна вулиця	Соловʼїна вулиця
Тополина Вулиця	Тополина вулиця
Центральна Вулиця	Центральна вулиця
Цетральна вулиця	Центральна вулиця
ШКІЛЬНА вулиця	Шкільна вулиця