Антонівка вулиця	вулиця Антонівка
Ахманівка вулиця	вулиця Ахманівка
Базарівка вулиця	вулиця Базарівка
Баківка вулиця	вулиця Баківка
Балабанівка вулиця	вулиця Балабанівка
Балашівка вулиця	вулиця Балашівка
Бандурівка вулиця	вулиця Бандурівка
Батівка вулиця	вулиця Батівка
Бахматівка вулиця	вулиця Бахматівка
Бежівка вулиця	вулиця Бежівка
Безимівка вулиця	вулиця Безимівка
Березівка вулиця	вулиця Березівка
Берунівка вулиця	вулиця Берунівка
Бесалівка вулиця	вулиця Бесалівка
Білодідівка вулиця	вулиця Білодідівка
Бовдирівка вулиця	вулиця Бовдирівка
Богданівка вулиця	вулиця Богданівка
Богодарівка вулиця	вулиця Богодарівка
Боднарівка вулиця	вулиця Боднарівка
Бойківка вулиця	вулиця Бойківка
Борисівка вулиця	вулиця Борисівка
Боричівка вулиця	вулиця Боричівка
Бочанівка вулиця	вулиця Бочанівка
Бринівка вулиця	вулиця Бринівка
Будківка вулиця	вулиця Будківка
Буланівка вулиця	вулиця Буланівка
Бунівка вулиця	вулиця Бунівка
Буряківка вулиця	вулиця Буряківка
Вадрусівка вулиця	вулиця Вадрусівка
Варварівка вулиця	вулиця Варварівка
Василівка вулиця	вулиця Василівка
Веделівка вулиця	вулиця Веделівка
Велика Захватівка вулиця	вулиця Велика Захватівка
Велика Ковалівка вулиця	вулиця Велика Ковалівка
Вербівка вулиця	вулиця Вербівка
Вергонівка вулиця	вулиця Вергонівка
Верхня Антонівка вулиця	вулиця Верхня Антонівка
Веселівка вулиця	вулиця Веселівка
Вибранівка вулиця	вулиця Вибранівка
Видрівка вулиця	вулиця Видрівка
Вільхівка вулиця	вулиця Вільхівка
вулиця Бабківка	вулиця Бабківка
вулиця Голубівка	вулиця Голубівка
вулиця Задубівка	вулиця Задубівка
вулиця Прусівка	вулиця Прусівка
Гаврашівка вулиця	вулиця Гаврашівка
Гаврюківка вулиця	вулиця Гаврюківка
Гайдівка вулиця	вулиця Гайдівка
Гарбузівка вулиця	вулиця Гарбузівка
Гергелівка вулиця	вулиця Гергелівка
Глухівка вулиця	вулиця Глухівка
Голотівка вулиця	вулиця Голотівка
Голубівка вулиця	вулиця Голубівка
Гончарівка вулиця	вулиця Гончарівка
Горбівка вулиця	вулиця Горбівка
Горболівка вулиця	вулиця Горболівка
Гордіівка вулиця	вулиця Гордіівка
Горіхівка вулиця	вулиця Горіхівка
Горовівка провулок	провулок Горовівка
Гребешівка вулиця	вулиця Гребешівка
Гресівка вулиці	вулиця Гресівка
Грицівка вулиця	вулиця Грицівка
Грицулівка вулиця	вулиця Грицулівка
Гудзівка вулиця	вулиця Гудзівка
Гуменівка вулиця	вулиця Гуменівка
Дальківка вулиця	вулиця Дальківка
Дармолівка вулиця	вулиця Дармолівка
Дем’янівка вулиця	вулиця Демʼянівка
Денисівка вулиця	вулиця Денисівка
Дернівка вулиця	вулиця Дернівка
Джумаківка вулиця	вулиця Джумаківка
Дібрівка вулиця	вулиця Дібрівка
Дібрівка провулок	провулок Дібрівка
Дівухівка вулиця	вулиця Дівухівка
Дігтярівка вулиця	вулиця Дігтярівка
Довгалівка вулиця	вулиця Довгалівка
Долинівка вулиця	вулиця Долинівка
Долішнівка вулиця	вулиця Долішнівка
Дубівка вулиця	вулиця Дубівка
Дубрівка вулиця	вулиця Дубрівка
Дяченківка вулиця	вулиця Дяченківка
Жаберівка вулиця	вулиця Жаберівка
Жуківка вулиця	вулиця Жуківка
Журбівка вулиця	вулиця Журбівка
Забівка вулиця	вулиця Забівка
Заболотівка вулиця	вулиця Заболотівка
Завгородівка вулиця	вулиця Завгородівка
Замленівка вулиця	вулиця Замленівка
Замлинівка вулиця	вулиця Замлинівка
Захватівка вулиця	вулиця Захватівка
Зеленівка вулиця	вулиця Зеленівка
Ігорівка вулиця	вулиця Ігорівка
Йовівка вулиця	вулиця Йовівка
Кавунівка вулиця	вулиця Кавунівка
Казимирівка вулиця	вулиця Казимирівка
Кайдашівка вулиця	вулиця Кайдашівка
Калинівка вулиця	вулиця Калинівка
Капацілівка вулиця	вулиця Капацілівка
Капилівка вулиця	вулиця Капилівка
Кардашівка вулиця	вулиця Кардашівка
Кастелівка вулиця	вулиця Кастелівка
Кашталянівка вулиця	вулиця Кашталянівка
Кашубівка вулиця	вулиця Кашубівка
Киричівка вулиця	вулиця Киричівка
Кирстівка вулиця	вулиця Кирстівка
Клинівка вулиця	вулиця Клинівка
Книшівка вулиця	вулиця Книшівка
Кобзарівка вулиця	вулиця Кобзарівка
Кобзарівка провулок	провулок Кобзарівка
Ковалівка вулиця	вулиця Ковалівка
Козаківка вулиця	вулиця Козаківка
Козинівка вулиця	вулиця Козинівка
Кордулівка вулиця	вулиця Кордулівка
Коржівка вулиця	вулиця Коржівка
Королівка вулиця	вулиця Королівка
Кортумівка вулиця	вулиця Кортумівка
Котівка вулиця	вулиця Котівка
Кочержівка вулиця	вулиця Кочержівка
Крамарівка вулиця	вулиця Крамарівка
Красилівка вулиця	вулиця Красилівка
Крачківка вулиця	вулиця Крачківка
Крашенівка вулиця	вулиця Крашенівка
Крижівка вулиця	вулиця Крижівка
Крикунівка вулиця	вулиця Крикунівка
Ксаверівка вулиця	вулиця Ксаверівка
Кубалівка вулиця	вулиця Кубалівка
Кузнярівка вулиця	вулиця Кузнярівка
Куличівка вулиця	вулиця Куличівка
Кулишівка вулиця	вулиця Кулишівка
Куркудимівка вулиця	вулиця Куркудимівка
Лабівка вулиця	вулиця Лабівка
Лазьківка вулиця	вулиця Лазьківка
Лебедівка вулиця	вулиця Лебедівка
Лехманівка вулиця	вулиця Лехманівка
Лисичівка вулиця	вулиця Лисичівка
Лісничівка вулиця	вулиця Лісничівка
Логвинівка вулиця	вулиця Логвинівка
Мазурівка вулиця	вулиця Мазурівка
Майорівка вулиця	вулиця Майорівка
Мала Гончарівка вулиця	вулиця Мала Гончарівка
Мала Ковалівка вулиця	вулиця Мала Ковалівка
Мар'янівка вулиця	вулиця Марʼянівка
Мармужівка вулиця	вулиця Мармужівка
Марушківка вулиця	вулиця Марушківка
Марценівка вулиця	вулиця Марценівка
Марцинівка вулиця	вулиця Марцинівка
Маршалківка вулиця	вулиця Маршалківка
Маслівка вулиця	вулиця Маслівка
Матронівка вулиця	вулиця Матронівка
Махлунівка вулиця	вулиця Махлунівка
Медведівка вулиця	вулиця Медведівка
Мигалівка вулиця	вулиця Мигалівка
Мигринівка вулиця	вулиця Мигринівка
Мирошниківка вулиця	вулиця Мирошниківка
Млинівка вулиця	вулиця Млинівка
Морозівка вулиця	вулиця Морозівка
Мохнатівка вулиця	вулиця Мохнатівка
Мохорівка вулиця	вулиця Мохорівка
Мухівка вулиця	вулиця Мухівка
Нагірнівка вулиця	вулиця Нагірнівка
Назарівка вулиця	вулиця Назарівка
Натоківка вулиця	вулиця Натоківка
Нижня Оврамівка вулиця	вулиця Нижня Оврамівка
Ничогівка вулиця	вулиця Ничогівка
Нова Михайлівка вулиця	вулиця Нова Михайлівка
Нова Михайлівка провулок	провулок Нова Михайлівка
Новопанасівка вулиця	вулиця Новопанасівка
Новоселівка вулиця	вулиця Новоселівка
Новоселівка провулок	провулок Новоселівка
Новоселівка проїзд	проїзд Новоселівка
Ододівка вулиця	вулиця Ододівка
Осовківка вулиця	вулиця Осовківка
Осташівка вулиця	вулиця Осташівка
Острівка вулиця	вулиця Острівка
Панасівка вулиця	вулиця Панасівка
Паньківка вулиця	вулиця Паньківка
Папарівка вулиця	вулиця Папарівка
Пасківка вулиця	вулиця Пасківка
Перегонівка вулиця	вулиця Перегонівка
Персенківка вулиця	вулиця Персенківка
Петрівка вулиця	вулиця Петрівка
Пирогівка вулиця	вулиця Пирогівка
Підлісівка вулиця	вулиця Підлісівка
Піндзірівка вулиця	вулиця Піндзірівка
Пісківка вулиця	вулиця Пісківка
Плисівка вулиця	вулиця Плисівка
Погребнівка вулиця	вулиця Погребнівка
Покрасівка вулиця	вулиця Покрасівка
Покрівка вулиця	вулиця Покрівка
Полівка вулиця	вулиця Полівка
Поломарівка вулиця	вулиця Поломарівка
Попівка вулиця	вулиця Попівка
Приточилівка вулиця	вулиця Приточилівка
Причепилівка вулиця	вулиця Причепилівка
Прокопівка вулиця	вулиця Прокопівка
Раківка вулиця	вулиця Раківка
Репехівка вулиця	вулиця Репехівка
Рибалківка вулиця	вулиця Рибалківка
Романівка вулиця	вулиця Романівка
Рубанівка вулиця	вулиця Рубанівка
Рябківка вулиця	вулиця Рябківка
Рябцівка вулиця	вулиця Рябцівка
Рясківка вулиця	вулиця Рясківка
Савонівка вулиця	вулиця Савонівка
Савчуківка вулиця	вулиця Савчуківка
Самойлівка вулиця	вулиця Самойлівка
Сарнівка вулиця	вулиця Сарнівка
Селезнівка вулиця	вулиця Селезнівка
Сигнівка вулиця	вулиця Сигнівка
Сидорівка вулиця	вулиця Сидорівка
Синичівка вулиця	вулиця Синичівка
Сичівка-II вулиця	вулиця Сичівка-II
Сіталівка вулиця	вулиця Сіталівка
Смирнівка вулиця	вулиця Смирнівка
Сокурівка вулиця	вулиця Сокурівка
Солдатівка вулиця	вулиця Солдатівка
Сомівка вулиця	вулиця Сомівка
Соснівка вулиця	вулиця Соснівка
Сотниківка вулиця	вулиця Сотниківка
Софонівка вулиця	вулиця Софонівка
Степанівка вулиця	вулиця Степанівка
Стременівка вулиця	вулиця Стременівка
Стрілківка вулиця	вулиця Стрілківка
Струсівка вулиця	вулиця Струсівка
Стягайлівка вулиця	вулиця Стягайлівка
Таранівка вулиця	вулиця Таранівка
Таранухівка вулиця	вулиця Таранухівка
Терехівка вулиця	вулиця Терехівка
Терешківка вулиця	вулиця Терешківка
Тернівка вулиця	вулиця Тернівка
Тимошівка вулиця	вулиця Тимошівка
Ткачівка вулиця	вулиця Ткачівка
Токарівка вулиця	вулиця Токарівка
Тракторівка вулиця	вулиця Тракторівка
Троянівка вулиця	вулиця Троянівка
Трубачівка вулиця	вулиця Трубачівка
Туківка вулиця	вулиця Туківка
Туманівка вулиця	вулиця Туманівка
Удодівка вулиця	вулиця Удодівка
Улянівка вулиця	вулиця Улянівка
Фегонівка вулиця	вулиця Фегонівка
Хандриківка вулиця	вулиця Хандриківка
Харківка вулиця	вулиця Харківка
Хоменківка вулиця	вулиця Хоменківка
Хоробрівка вулиця	вулиця Хоробрівка
Хрящівка вулиця	вулиця Хрящівка
Хутір Анастазівка вулиця	вулиця Хутір Анастазівка
Хутір Франівка вулиця	вулиця Хутір Франівка
Хуторівка вулиця	вулиця Хуторівка
Цетнерівка вулиця	вулиця Цетнерівка
Циганівка вулиця	вулиця Циганівка
Цикалівка вулиця	вулиця Цикалівка
Чабанівка вулиця	вулиця Чабанівка
Чайківка вулиця	вулиця Чайківка
Черепівка вулиця	вулиця Черепівка
Чернишівка вулиця	вулиця Чернишівка
Чигринівка вулиця	вулиця Чигринівка
Чонгарівка вулиця	вулиця Чонгарівка
Чубівка вулиця	вулиця Чубівка
Чупівка вулиця	вулиця Чупівка
Шандарівка вулиця	вулиця Шандарівка
Шарівка вулиця	вулиця Шарівка
Швабівка вулиця	вулиця Швабівка
Швейцарівка вулиця	вулиця Швейцарівка
Шелестівка вулиця	вулиця Шелестівка
Шоферівка вулиця	вулиця Шоферівка
Шунівка вулиця	вулиця Шунівка
Шуптарівка вулиця	вулиця Шуптарівка
Шутрівка вулиця	вулиця Шутрівка
Юківка вулиця	вулиця Юківка
Юрківка вулиця	вулиця Юрківка
Яворівка вулиця	вулиця Яворівка
Якубівка вулиця	вулиця Якубівка
Ялинівка вулиця	вулиця Ялинівка
Янівка вулиця	вулиця Янівка
Ярмолівка вулиця	вулиця Ярмолівка
Ярошівка вулиця	вулиця Ярошівка
Яцютівка вулиця	вулиця Яцютівка
Tарасівка вулиця	вулиця Тарасівка