Аврушенка вулиця	вулиця Аврушенка
Адаменко вулиця	вулиця Адаменко
Анголенка вулиця	вулиця Анголенка
Аненка вулиця	вулиця Аненка
Анненка вулиця	вулиця Анненка
Архітектора Паученка вулиця	вулиця Архітектора Паученка
Бабаченка вулиця	вулиця Бабаченка
Бабенко вулиця	вулиця Бабенко
Багненка вулиця	вулиця Багненка
Баленко вулиця	вулиця Баленко
Банченка вулиця	вулиця Банченка
Безнощенка вулиця	вулиця Безнощенка
Бєлорєченка вулиця	вулиця Бєлорєченка
Бишенка провулок	провулок Бишенка
Білоченка вулиця	вулиця Білоченка
Блізніченка вулиця	вулиця Блізніченка
Боженко вулиця	вулиця Боженко
Боженко провулок	провулок Боженко
Братів Більченко вулиця	вулиця Братів Більченко
Братів Гавриленко вулиця	вулиця Братів Гавриленко
Братів Довбенко вулиця	вулиця Братів Довбенко
Братів Соколенко вулиця	вулиця Братів Соколенко
Братів Ярошенко вулиця	вулиця Братів Ярошенко
Бугайченка вулиця	вулиця Бугайченка
Бугрименка вулиця	вулиця Бугрименка
Бугрименка проїзд	проїзд Бугрименка
Буруденка вулиця	вулиця Буруденка
В'язовченка вулиця	вулиця Вʼязовченка
В'язовченка провулок	провулок Вʼязовченка
В’ячеслава Хурсенка вулиця	вулиця Вʼячеслава Хурсенка
Веденка вулиця	вулиця Веденка
Веденко вулиця	вулиця Веденко
Велика Виженка вулиця	вулиця Велика Виженка
Вернигоренка вулиця	вулиця Вернигоренка
Вернигоренко вулиця	вулиця Вернигоренко
Винахідниці Ющенко вулиця	вулиця Винахідниці Ющенко
Винокуренка вулиця	вулиця Винокуренка
Висовненка вулиця	вулиця Висовненка
Височенка вулиця	вулиця Височенка
Височиненка вулиця	вулиця Височиненка
Вініченко вулиця	вулиця Вініченко
Волковенка вулиця	вулиця Волковенка
Воровченка вулиця	вулиця Воровченка
Вощенка вулиця	вулиця Вощенка
Гавриленко вулиця	вулиця Гавриленко
Гайденко вулиця	вулиця Гайденко
Гамченка проїзд	проїзд Гамченка
Гарбузенка вулиця	вулиця Гарбузенка
Герася Соколенко вулиця	вулиця Герася Соколенко
Глуменка вулиця	вулиця Глуменка
Гніліченка вулиця	вулиця Гніліченка
Головченко вулиця	вулиця Головченко
Гомоненка вулиця	вулиця Гомоненка
Гончаренко вулиця	вулиця Гончаренко
Горбенко вулиця	вулиця Горбенко
Горпищенко тупик	тупик Горпищенко
Грибенка вулиця	вулиця Грибенка
Грибиниченка вулиця	вулиця Грибиниченка
Грибініченка площа	площа Грибініченка
Грибініченко площа	площа Грибініченко
Гриценко вулиця	вулиця Гриценко
Грищенко вулиця	вулиця Грищенко
Грузиненка вулиця	вулиця Грузиненка
Гуманенка вулиця	вулиця Гуманенка
Гусенка вулиця	вулиця Гусенка
Гутніченка вулиця	вулиця Гутніченка
Гутченка вулиця	вулиця Гутченка
Гутченка провулок	провулок Гутченка
Гутченко вулиця	вулиця Гутченко
Гутченко провулок	провулок Гутченко
Давиденко вулиця	вулиця Давиденко
Данченко вулиця	вулиця Данченко
Дебенка вулиця	вулиця Дебенка
Декаленка вулиця	вулиця Декаленка
Демещенка вулиця	вулиця Демещенка
Деміденка вулиця	вулиця Деміденка
Демченко вулиця	вулиця Демченко
Денисенко вулиця	вулиця Денисенко
Дениченко вулиця	вулиця Дениченко
Дерезенка вулиця	вулиця Дерезенка
Діденко вулиця	вулиця Діденко
Добробоженка вулиця	вулиця Добробоженка
Довденка вулиця	вулиця Довденка
Дорошенко вулиця	вулиця Дорошенко
Дябченка вулиця	вулиця Дябченка
Є.Ткаченко вулиця	вулиця Є. Ткаченко
Єременко вулиця	вулиця Єременко
Єрмощенка вулиця	вулиця Єрмощенка
Єрощенка вулиця	вулиця Єрощенка
Єсауленка вулиця	вулиця Єсауленка
Жаданенка провулок	провулок Жаданенка
Женченка вулиця	вулиця Женченка
Житниченка вулиця	вулиця Житниченка
Забченко вулиця	вулиця Забченко
Заклепенка провулок	провулок Заклепенка
Закутенка вулиця	вулиця Закутенка
Запорожченко квартал	квартал Запорожченко
Зінченко братів провулок	провулок Братів Зінченко
Зінченко вулиця	вулиця Зінченко
Ильченка вулиця	вулиця Ильченка
І.Аліщенка вулиця	вулиця І. Аліщенка
Ігнатченко вулиця	вулиця Ігнатченко
Ільченко вулиця	вулиця Ільченко
імені Бабенко вулиця	вулиця імені Бабенко
Іхненка вулиця	вулиця Іхненка
Кадученка вулиця	вулиця Кадученка
Каліниченка вулиця	вулиця Каліниченка
Карнаушенко вулиця	вулиця Карнаушенко
Квіленка вулиця	вулиця Квіленка
Кетченко вулиця	вулиця Кетченко
Китченка вулиця	вулиця Китченка
Кібенка вулиця	вулиця Кібенка
Кібенко вулиця	вулиця Кібенко
Кіченка вулиця	вулиця Кіченка
Кіченко вулиця	вулиця Кіченко
Клави Байраченко вулиця	вулиця Клави Байраченко
Клименко вулиця	вулиця Клименко
Кожущенко провулок	провулок Кожущенко
Козаченко вулиця	вулиця Козаченко
Командарма Костенко вулиця	вулиця Командарма Костенка
Кондренка вулиця	вулиця Кондренка
Короленко вулиця	вулиця Короленко
Короленко провулок	провулок Короленко
Коротченко вулиця	вулиця Коротченко
Косенко вулиця	вулиця Косенко
Костенко вулиця	вулиця Костенко
Костенко провулок	провулок Костенко
Кравченко вулиця	вулиця Кравченко
Кривенко вулиця	вулиця Кривенко
Крикуненко вулиця	вулиця Крикуненко
Кувітченко вулиця	вулиця Кувітченко
Кувітченко провулок	провулок Кувітченко
Кундіренка вулиця	вулиця Кундіренка
Курченко вулиця	вулиця Курченко
Кутурженка вулиця	вулиця Кутурженка
Лабутенка вулиця	вулиця Лабутенка
Лавроненка вулиця	вулиця Лавроненка
Лантушенка вулиця	вулиця Лантушенка
Левченко вулиця	вулиця Левченко
Левченко квартал	квартал Левченко
Леженка вулиця	вулиця Леженка
Лелеченка вулиця	вулиця Лелеченка
Ленченка вулиця	вулиця Ленченка
Ленченко вулиця	вулиця Ленченко
Лємєщенка вулиця	вулиця Лємєщенка
Линченка вулиця	вулиця Линченка
Липовенка вулиця	вулиця Липовенка
Лисенко вулиця	вулиця Лисенко
Лівенка вулиця	вулиця Лівенка
Лізенка вулиця	вулиця Лізенка
Ліненко вулиця	вулиця Ліненко
Ліченка вулиця	вулиця Ліченка
Логвиненко вулиця	вулиця Логвиненко
Логовенка вулиця	вулиця Логовенка
Лук’яненка вулиця	вулиця Лукʼяненка
Лук’яненка провулок	провулок Лукʼяненка
Луняченко провулок	провулок Луняченко
Луфаренка вулиця	вулиця Луфаренка
Луференка вулиця	вулиця Луференка
Макаренко вулиця	вулиця Макаренко
Мала Виженка вулиця	вулиця Мала Виженка
Маличенка вулиця	вулиця Маличенка
Мануйленко вулиця	вулиця Мануйленко
Мар’яненко провулок	провулок Марʼяненко
МаріЇ Приймаченко вулиця	вулиця Марії Приймаченко
Марунченко вулиця	вулиця Марунченко
Марченко вулиця	вулиця Марченко
Матвіенка вулиця	вулиця Матієнка
Матюшенко вулиця	вулиця Матюшенко
Мащенко вулиця	вулиця Мащенко
Мельченка вулиця	вулиця Мельченка
Микільченка вулиця	вулиця Микільченка
Мирющенко вулиця	вулиця Мирющенко
Михайліченко вулиця	вулиця Михайліченко
Міненко вулиця	вулиця Міненко
Мірошниченко вулиця	вулиця Мірошниченко
Мірющенка вулиця	вулиця Мірющенка
Міхи Козимиренка провулок	провулок Міхи Козимиренка
Міщенко вулиця	вулиця Міщенко
Мнішенко вулиця	вулиця Мнішенко
Могильченка вулиця	вулиця Могильченка
Мольченко вулиця	вулиця Мольченко
Монченка вулиця	вулиця Монченка
Моргуненка вулиця	вулиця Моргуненка
Москаленко вулиця	вулиця Москаленко
Мотрушенка вулиця	вулиця Мотрушенка
Назаренко вулиця	вулиця Назаренко
Ніколенко вулиця	вулиця Ніколенко
Ногтенка вулиця	вулиця Ногтенка
Обушенка вулиця	вулиця Обушенка
Оверченко вулиця	вулиця Оверченко
Одноорченка вулиця	вулиця Одноорченка
Ожоженка вулиця	вулиця Ожоженка
Окатенка вулиця	вулиця Окатенка
Околотенко вулиця	вулиця Околотенко
Оксанченка провулок	провулок Оксанченка
Онищенко вулиця	вулиця Онищенко
Опанасенко вулиця	вулиця Опанасенко
Осипенко вулиця	вулиця Осипенко
Осипенко провулок	провулок Осипенко
Осипенко проїзд	проїзд Осипенко
Осіпенко вулиця	вулиця Осіпенко
Осіпенко провулок	провулок Осіпенко
Остапенко вулиця	вулиця Остапенко
П’ятенка вулиця	вулиця Пʼятенка
Палажченка вулиця	вулиця Палажченка
Панченко вулиця	вулиця Панченко
Пархоменко вулиця	вулиця Пархоменко
Пархоменко провулок	провулок Пархоменко
Пархоменкa вулиця	вулиця Пархоменка
Пасiченка вулиця	вулиця Пасіченка
Педенко вулиця	вулиця Педенко
Петрусенко вулиця	вулиця Петрусенко
Петрусенко провулок	провулок Петрусенко
Петрусенко тупик	тупик Петрусенко
Пиженка вулиця	вулиця Пиженка
Пипенка вулиця	вулиця Пипенка
Пипенка провулок	провулок Пипенка
Писаренко вулиця	вулиця Писаренко
Піюренка вулиця	вулиця Піюренка
Плетенка вулиця	вулиця Плетенка
Плисенка вулиця	вулиця Плисенка
Пойденка вулиця	вулиця Пойденка
Полковника Оксенченка вулиця	вулиця Полковника Оксенченка
Половченка вулиця	вулиця Половченка
Похільченка вулиця	вулиця Похільченка
Правденко провулок	провулок Правденко
Присенка вулиця	вулиця Присенка
Прищепенка вулиця	вулиця Прищепенка
Промогайбенка вулиця	вулиця Промогайбенка
Прохоренко вулиця	вулиця Прохоренко
Проценко вулиця	вулиця Проценко
Ральченка вулиця	вулиця Ральченка
Ральченко вулиця	вулиця Ральченко
Ройченка вулиця	вулиця Ройченка
Романенко вулиця	вулиця Романенко
Ромащенко вулиця	вулиця Ромащенко
Руденко вулиця	вулиця Руденко
Рудниченка вулиця	вулиця Рудниченка
Рудніченко вулиця	вулиця Рудніченко
Савоненка провулок	провулок Савоненка
Савченко вулиця	вулиця Савченко
Садовиченка вулиця	вулиця Садовиченка
Садовниченка вулиця	вулиця Садовниченка
Самійленко вулиця	вулиця Самійленко
Сапоненко вулиця	вулиця Сапоненко
Сапроненка вулиця	вулиця Сапроненка
Свічкаренка вулиця	вулиця Свічкаренка
Свічкаренко вулиця	вулиця Свічкаренко
Семеренко вулиця	вулиця Семеренко
Семиренка вулиця	вулиця Семиренка
Семиренко вулиця	вулиця Семиренко
Сербіненка вулиця	вулиця Сербіненка
Сергіенко вулиця	вулиця Сергіенко
Сивокобиленка вулиця	вулиця Сивокобиленка
Сидоркенка провулок	провулок Сидоркенка
Сипаренка вулиця	вулиця Сипаренка
Смутченка вулиця	вулиця Смутченка
Солов’яненка вулиця	вулиця Соловʼяненка
Строменка вулиця	вулиця Строменка
Сурдуленко вулиця	вулиця Сурдуленко
Таісії Буряченко вулиця	вулиця Таісії Буряченко
Таранущенка вулиця	вулиця Таранущенка
Тарасенко вулиця	вулиця Тарасенко
Терніченко вулиця	вулиця Терніченко
Тесленко вулиця	вулиця Тесленко
Тимошенко вулиця	вулиця Тимошенко
Тимошенко провулок	провулок Тимошенко
Титенко вулиця	вулиця Титенко
Тищенко вулиця	вулиця Тищенко
Тімченко вулиця	вулиця Тімченко
Тітенко вулиця	вулиця Тітенко
Ткаленко квартал	квартал Ткаленко
Ткаченко вулиця	вулиця Ткаченко
Ткаченко площа	площа Ткаченко
Ткаченко-Петренко вулиця	вулиця Ткаченко-Петренко
Тоболенка вулиця	вулиця Тоболенка
Товстенко вулиця	вулиця Товстенко
Торопченка вулиця	вулиця Торопченка
Трофіменко вулиця	вулиця Трофіменко
Трофіменко провулок	провулок Трофіменко
Трубченка вулиця	вулиця Трубченка
Усенко вулиця	вулиця Усенко
Усенко провулок	провулок Усенко
Устенко вулиця	вулиця Устенко
Федоренко вулиця	вулиця Федоренко
Федющенка вулиця	вулиця Федющенка
Фроленка вулиця	вулиця Фроленка
Фуженка вулиця	вулиця Фуженка
Харченко вулиця	вулиця Харченко
Ходченка вулиця	вулиця Ходченка
Хомченко вулиця	вулиця Хомченко
Цокуренка вулиця	вулиця Цокуренка
Чапленка алея	алея Чапленка
Чекаленко вулиця	вулиця Чекаленко
Чернопащенка вулиця	вулиця Чернопащенка
Чехмистренко вулиця	вулиця Чехмистренко
Чмиренка вулиця	вулиця Чмиренка
Чухаленко вулиця	вулиця Чухаленко
Шаренка вулиця	вулиця Шаренка
Шевсченка вулиця	вулиця Шевсченка
Шевченко вул	вулиця Шевченко
Шевченко вулиця	вулиця Шевченко
Шевченко квартал	квартал Шевченко
Шевченко провулок	провулок Шевченко
Шепотиленка вулиця	вулиця Шепотиленка
Шеченка вулиця	вулиця Шеченка
Шеченко вулиця	вулиця Шеченко
Шкапенка вулиця	вулиця Шкапенка
Штеменка вулиця	вулиця Штеменка
Щаденка в’їзд	вʼїзд Щаденка
Щаденка вулиця	вулиця Щаденка
Щаденка провулок	провулок Щаденка
Щаденко вулиця	вулиця Щаденко
Эрошенка вулиця	вулиця Єрошенка
Явдокименка вулиця	вулиця Явдокименка
Якименко вулиця	вулиця Якименко
Яковенко вулиця	вулиця Яковенко
Яременко вулиця	вулиця Яременко
Ярмошенка вулиця	вулиця Ярмошенка
Ярошенко вулиця	вулиця Ярошенко
Яцуненка вулиця	вулиця Яцуненка
Яцуненко вулиця	вулиця Яцуненко
Боєнка вулиця	вулиця Боєнка
Вакацієнка вулиця	вулиця Вакацієнка
Генерала Корнiєнко вулиця	вулиця Генерала Корнієнко
Гордієнко вулиця	вулиця Гордієнко
Гордієнко провулок	провулок Гордієнко
Зуєнко провулок	провулок Зуєнко
Китаєнка вулиця	вулиця Китаєнка
Кіпєнка вулиця	вулиця Кіпєнка
Матієнко вулиця	вулиця Матієнко
Огієнко вулиця	вулиця Огієнко
Онопрієнко вулиця	вулиця Онопрієнко
Онупрієнка вулиця	вулиця Онупрієнка
Сергієнко вулиця	вулиця Сергієнко
Сергієнко провулок	провулок Сергієнко
Старієнка вулиця	вулиця Старієнка
Шалаєнко вулиця	вулиця Шалаєнко
Шкрептиєнка вулиця	вулиця Шкрептиєнка