---Захисників України провулок	провулок Захисників України
Авіабудівників вулиця	вулиця Авіабудівників
Авіабудівників провулок	провулок Авіабудівників
Автоагрегатчиків вулиця	вулиця Автоагрегатчиків
Автобудівельників проїзд	проїзд Автобудівельників
Авторемонтників вулиця	вулиця Авторемонтників
Автотранспортників вулиця	вулиця Автотранспортників
Академіків Линників вулиця	вулиця Академіків Линників
Алея пам’яті полеглих захисників України	алея Памʼяті Полеглих Захисників України
Атомників вулиця	вулиця Атомників
Більшовиків вулиця	вулиця Більшовиків
Бобровників вулиця	вулиця Бобровників
Братів Василиків вулиця	вулиця Братів Василиків
Братів Лисиків вулиця	вулиця Братів Лисиків
Братів Мельників вулиця	вулиця Братів Мельників
Братів Сварників вулиця	вулиця Братів Сварників
Братів Стадників вулиця	вулиця Братів Стадників
Братів Тютюнників вулиця	вулиця Братів Тютюнників
Будівельників бульвар	бульвар Будівельників
Будівельників в'їзд	вʼїзд Будівельників
Будівельників вулиця	вулиця Будівельників
Будівельників квартал	квартал Будівельників
Будівельників мікрорайон	мікрорайон Будівельників
Будівельників провулок	провулок Будівельників
Будівельників проспект	проспект Будівельників
Будівельників шосе	шосе Будівельників
Будівників вулиця	вулиця Будівників
Будіівельників вулиця	вулиця Будівельників
Будывельників вулиця	вулиця Будывельників
Будiвельникiв вулиця	вулиця Будівельників
Буревісників вулиця	вулиця Буревісників
Буревісників провулок	провулок Буревісників
Буровиків вулиця	вулиця Буровиків
Верстатників провулок	провулок Верстатників
Верстатобудівників вулиця	вулиця Верстатобудівників
Верстатобудівників провулок	провулок Верстатобудівників
Винахідників Бикових провулок	провулок Винахідників Бикових
Винахідників вулиця	вулиця Винахідників
Винахідників провулок	провулок Винахідників
Військових будівельників вулиця	вулиця Військових Будівельників
Військових Залізничників вулиця	вулиця Військових Залізничників
Водників вулиця	вулиця Водників
Водників провулок	провулок Водників
Водоочисників вулиця	вулиця Водоочисників
Вугільників вулиця	вулиця Вугільників
Вуглерозвідників вулиця	вулиця Вуглерозвідників
Газовиків вулиця	вулиця Газовиків
Газовиків провулок	провулок Газовиків
Газовиків проїзд	проїзд Газовиків
Гвардійців мінометників вулиця	вулиця Гвардійців Мінометників
Гвардійців-Залізничників вулиця	вулиця Гвардійців-Залізничників
Геофізиків вулиця	вулиця Геофізиків
Геофізиків провулок	провулок Геофізиків
Героїв десантників вулиця	вулиця Героїв Десантників
Героїв Десантників вулиця	вулиця Героїв Десантників
Героїв десантників провулок	провулок Героїв Десантників
Героїв Захисників вулиця	вулиця Героїв Захисників
Героїв Плахотників вулиця	вулиця Героїв Плахотників
Героїв Прикордонників вулиця	вулиця Героїв Прикордонників
Героїв розвідників вулиця	вулиця Героїв Розвідників
Героїв Рятувальників вулиця	вулиця Героїв Рятувальників
Героїв-підпільників вулиця	вулиця Героїв-підпільників
Героїв-підпільників проспект	проспект Героїв-підпільників
Героїв-пожежників вулиця	вулиця Героїв-пожежників
Героїв-Пожежників вулиця	вулиця Героїв-пожежників
Героїв-прикордонників вулиця	вулиця Героїв-прикордонників
Героїв-прикордонників провулок	провулок Героїв-прикордонників
Героїв-Рятівників вулиця	вулиця Героїв-рятівників
Героїв-Рятівників узвіз	узвіз Героїв-рятівників
Героїв-рятувальників вулиця	вулиця Героїв-рятувальників
Героїв-Рятувальників вулиця	вулиця Героїв-рятувальників
Гідробудівників вулиця	вулиця Гідробудівників
Гірників вулиця	вулиця Гірників
Гірників провулок	провулок Гірників
Гірників проспект	проспект Гірників
Гірськолижників узвіз	узвіз Гірськолижників
Гумовиків вулиця	вулиця Гумовиків
Деревообробників вулиця	вулиця Деревообробників
Десантників вулиця	вулиця Десантників
Десантників площа	площа Десантників
Десантників провулок	провулок Десантників
Доломітників вулиця	вулиця Доломітників
Доменщиків вулиця	вулиця Доменщиків
Доменщиків провулок	провулок Доменщиків
Домнобудівників площа	площа Домнобудівників
Дорожників в’їзд	вʼїзд Дорожників
Дорожників вулиця	вулиця Дорожників
Дружинників вулиця	вулиця Дружинників
Електриків вулиця	вулиця Електриків
Електриків провулок	провулок Електриків
Електрозварників вулиця	вулиця Електрозварників
Електромашинобудівників вулиця	вулиця Електромашинобудівників
Електромашинобудiвникiв вулиця	вулиця Електромашинобудівників
Енергетиків бульвар	бульвар Енергетиків
Енергетиків вулиця	вулиця Енергетиків
Енергетиків провулок	провулок Енергетиків
Енергетиків проспект	проспект Енергетиків
Енергетикiв вулиця	вулиця Енергетиків
Енергобудівельників вулиця	вулиця Енергобудівельників
Енергобудівельників проїзд	проїзд Енергобудівельників
Енергобудівників вулиця	вулиця Енергобудівників
Забійників вулиця	вулиця Забійників
Забійників провулок	провулок Забійників
Забійників проспект	проспект Забійників
Забудовників вулиця	вулиця Забудовників
Залізничників вулиця	вулиця Залізничників
Залізничників площа	площа Залізничників
Залізничників провулок	провулок Залізничників
Залізничників проспект	проспект Залізничників
Захисників Азовсталі проїзд	проїзд Захисників Азовсталі
Захисників вулиця	вулиця Захисників
Захисників Зміїного вулиця	вулиця Захисників Зміїного
Захисників Маріуполя вулиця	вулиця Захисників Маріуполя
Захисників Миколаєва вулиця	вулиця Захисників Миколаєва
Захисників неба вулиця	вулиця Захисників Неба
Захисників провулок	провулок Захисників
Захисників України майдан	майдан Захисників України
Землевпорядників проїзд	проїзд Землевпорядників
Зенітників вулиця	вулиця Зенітників
Кабельщиків вулиця	вулиця Кабельщиків
Кварцитників вулиця	вулиця Кварцитників
Керамиків вулиця	вулиця Керамиків
Київських Будівельників вулиця	вулиця Київських Будівельників
Комсомольців-підпільників вулиця	вулиця Комсомольців-підпільників
Комунальників вулиця	вулиця Комунальників
Кріпильників вулиця	вулиця Кріпильників
Ливарників вулиця	вулиця Ливарників
Листопрокатників вулиця	вулиця Листопрокатників
Литейників вулиця	вулиця Литейників
Лірників вулиця	вулиця Лірників
Луговиків вулиця	вулиця Луговиків
Льотчиків Визволителів вулиця	вулиця Льотчиків Визволителів
Льотчиків вулиця	вулиця Льотчиків
Льотчиків провулок	провулок Льотчиків
Машинобудівельників вулиця	вулиця Машинобудівельників
Машинобудівників бульвар	бульвар Машинобудівників
Машинобудівників вулиця	вулиця Машинобудівників
Машинобудівників площа	площа Машинобудівників
Машинобудівників провулок	провулок Машинобудівників
Машинобудівників проспект	проспект Машинобудівників
Мебльовиків провулок	провулок Мебльовиків
Медиків вулиця	вулиця Медиків
Метробудівників вулиця	вулиця Метробудівників
Миколаївських Десантників вулиця	вулиця Миколаївських Десантників
Мірошників вулиця	вулиця Мірошників
Містобудівельників вулиця	вулиця Містобудівельників
Модельщиків вулиця	вулиця Модельщиків
Монтажників вулиця	вулиця Монтажників
Монтажників провулок	провулок Монтажників
Морських десантників вулиця	вулиця Морських Десантників
Морських Десантників вулиця	вулиця Морських Десантників
Моряків-десантників вулиця	вулиця Моряків-десантників
Мостобудівельників вулиця	вулиця Мостобудівельників
Мостобудівників в’їзд	вʼїзд Мостобудівників
Мостобудівників вулиця	вулиця Мостобудівників
Моторобудівників вулиця	вулиця Моторобудівників
Моторобудівників проспект	проспект Моторобудівників
Наваловідбійників вулиця	вулиця Наваловідбійників
Народних Дружинників вулиця	вулиця Народних Дружинників
Наставників вулиця	вулиця Наставників
Наукових Працівників вулиця	вулиця Наукових Працівників
Нафтовиків вулиця	вулиця Нафтовиків
Нафтовиків провулок	провулок Нафтовиків
Неокласиків вулиця	вулиця Неокласиків
Овочівників вулиця	вулиця Овочівників
Паперовиків вулиця	вулиця Паперовиків
Паровозників вулиця	вулиця Паровозників
Паровозників провулок	провулок Паровозників
Партизанів-Підпільників вулиця	вулиця Партизанів-Підпільників
Передовиків вулиця	вулиця Передовиків
Перших Будівельників вулиця	вулиця Перших Будівельників
Першобудівників вулиця	вулиця Першобудівників
Письменників вулиця	вулиця Письменників
Підводників вулиця	вулиця Підводників
Підпільників ОУН вулиця	вулиця Підпільників ОУН
Побутовиків вулиця	вулиця Побутовиків
Пожежників вулиця	вулиця Пожежників
Політехників вулиця	вулиця Політехників
Праведників світу вулиця	вулиця Праведників Світу
Праведників Світу вулиця	вулиця Праведників Світу
Праведників Світу провулок	провулок Праведників Світу
Прикордонників алея	алея Прикордонників
Прикордонників вулиця	вулиця Прикордонників
Прикордонників провулок	провулок Прикордонників
Приладобудівників в’їзд	вʼїзд Приладобудівників
Приладобудівників вулиця	вулиця Приладобудівників
Приладобудівників провулок	провулок Приладобудівників
Проектувальників проїзд	проїзд Проектувальників
Прокатників вулиця	вулиця Прокатників
Прохідників вулиця	вулиця Прохідників
Радянських Прикордонників вулиця	вулиця Радянських Прикордонників
Ракетників вулиця	вулиця Ракетників
Ракетників провулок	провулок Ракетників
Ракетобудівників вулиця	вулиця Ракетобудівників
Резинщиків вулиця	вулиця Резинщиків
Ремонтників вулиця	вулиця Ремонтників
Ровесникiв вулиця	вулиця Ровесників
Розвідників вулиця	вулиця Розвідників
Романтиків вулиця	вулиця Романтиків
Рятівників провулок	провулок Рятівників
Рятувальників вулиця	вулиця Рятувальників
Сільських Будівельників вулиця	вулиця Сільських Будівельників
Сірожупанників вулиця	вулиця Сірожупанників
Солянників вулиця	вулиця Солянників
Соратників вулиця	вулиця Соратників
Стадників вулиця	вулиця Стадників
Старих Більшовиків вулиця	вулиця Старих Більшовиків
Суднобудівників площа	площа Суднобудівників
Суднобудівників провулок	провулок Суднобудівників
Судноремонтників вулиця	вулиця Судноремонтників
Супутників вулиця	вулиця Супутників
Супутників провулок	провулок Супутників
Тваринників вулиця	вулиця Тваринників
Тваринників провулок	провулок Тваринників
Текстильників вулиця	вулиця Текстильників
Текстильників провулок	провулок Текстильників
Текстильників проспект	проспект Текстильників
Теплоенергетиків вулиця	вулиця Теплоенергетиків
Торф’ яників вулиця	вулиця Торфʼяників
Тракторобудівельників вулиця	вулиця Тракторобудівельників
Тракторобудівельників проспект	проспект Тракторобудівельників
Тракторобудівників проспект	проспект Тракторобудівників
Транспортників вулиця	вулиця Транспортників
Транспортників провулок	провулок Транспортників
Транспортних Будівельників вулиця	вулиця Транспортних Будівельників
Трансформаторників вулиця	вулиця Трансформаторників
Трикотажників провулок	провулок Трикотажників
Трубників проспект	проспект Трубників
Трудівників вулиця	вулиця Трудівників
Тютюнників вулиця	вулиця Тютюнників
Ударників вулиця	вулиця Ударників
Українських Прикордонників вулиця	вулиця Українських Прикордонників
Учасників АТО вулиця	вулиця Учасників АТО
Фронтовиків бульвар	бульвар Фронтовиків
Фузиків провулок	провулок Фузиків
Харчовиків вулиця	вулиця Харчовиків
Харчовиків провулок	провулок Харчовиків
Художників вулиця	вулиця Художників
Цементників вулиця	вулиця Цементників
Цементників проспект	проспект Цементників
Цілинників вулиця	вулиця Цілинників
Цукровиків вулиця	вулиця Цукровиків
Цукровиків провулок	провулок Цукровиків
Червоних Майовщиків вулиця	вулиця Червоних Майовщиків
Червонодеревників вулиця	вулиця Червонодеревників
Шахтобудівельників бульвар	бульвар Шахтобудівельників
Шахтобудівельників проспект	проспект Шахтобудівельників
Шахтобудівників вулиця	вулиця Шахтобудівників
Шахтобудівників провулок	провулок Шахтобудівників
Шахтобудівників проспект	проспект Шахтобудівників
Шахтобудівникiв вулиця	вулиця Шахтобудівників
Шахтобудівникiв провулок	провулок Шахтобудівників
Шахтопрохідників вулиця	вулиця Шахтопрохідників
Шістдесятників вулиця	вулиця Шістдесятників
Шкіряників вулиця	вулиця Шкіряників
Шляховиків вулиця	вулиця Шляховиків
Шляховиків провулок	провулок Шляховиків
Шовківників вулиця	вулиця Шовківників