вулиці Холодного А	вулиця А. Холодного
вулиця Абрикосова	Абрикосова вулиця
вулиця Академіка Амосова	вулиця Академіка Амосова
вулиця Академіка Корольова	вулиця Академіка Корольова
вулиця Академіка Патона	вулиця Академіка Патона
вулиця Аксакова	вулиця Аксакова
вулиця Андреєва	вулиця Андреєва
вулиця Бабушкіна	вулиця Бабушкіна
вулиця Батюка	вулиця Батюка
вулиця Берегового	вулиця Берегового
вулиця Богдана Хмельницького	вулиця Богдана Хмельницького
вулиця Боженка	вулиця Боженка
Вулиця Боженка	вулиця Боженка
вулиця Большака	вулиця Большака
вулиця Будьонного	вулиця Будьонного
вулиця В'ячеслава Чорновола	вулиця Вʼячеслава Чорновола
вулиця Василя Большака	вулиця Василя Большака
вулиця Василя Симоненка	вулиця Василя Симоненка
вулиця Василя Стуса	вулиця Василя Стуса
вулиця Василя Харчука	вулиця Василя Харчука
вулиця Ватутіна	вулиця Ватутіна
вулиця Висоцького	вулиця Висоцького
вулиця Володарського	вулиця Володарського
вулиця Володимира Великого	вулиця Володимира Великого
вулиця Воровського	вулиця Воровського
вулиця Ворошилова	вулиця Ворошилова
вулиця Гагаріна	вулиця Гагаріна
вулиця Гайдамаків	вулиця Гайдамаків
вулиця Гайдара	вулиця Гайдара
вулиця Галичанського	вулиця Галичанського
вулиця Галкіна	вулиця Галкіна
вулиця Генерала Момота	вулиця Генерала Момота
вулиця Генерала Опанасенка	вулиця Генерала Опанасенка
вулиця Героїв Небесної Сотні	вулиця Героїв Небесної Сотні
вулиця Герцена	вулиця Герцена
вулиця Гетьмана Сагайдачного	вулиця Гетьмана Сагайдачного
вулиця Глущенка	вулиця Глущенка
вулиця Гоголя	вулиця Гоголя
вулиця Гончарова	вулиця Гончарова
вулиця Горбаша	вулиця Горбаша
вулиця Горького	вулиця Горького
вулиця Грибоєдова	вулиця Грибоєдова
вулиця Григорія Кривди	вулиця Григорія Кривди
вулиця Григорія Сковороди	вулиця Григорія Сковороди
вулиця Грушевського	вулиця Грушевського
вулиця Данила Галицького	вулиця Данила Галицького
вулиця Дарія Понятовського	вулиця Дарія Понятовського
вулиця Дзержинського	вулиця Дзержинського
вулиця Дідика	вулиця Дідика
вулиця Дімітрова	вулиця Дімітрова
вулиця Дмитра Савчука	вулиця Дмитра Савчука
вулиця Довбуша	вулиця Довбуша
вулиця Довженка	вулиця Довженка
вулиця Дорошенка	вулиця Дорошенка
вулиця Драгоманова	вулиця Драгоманова
вулиця Дубініна	вулиця Дубініна
вулиця Євгена Коновальця	вулиця Євгена Коновальця
вулиця Євгена Слабченка	вулиця Євгена Слабченка
вулиця Жданова	вулиця Жданова
вулиця Жукова	вулиця Жукова
вулиця Зої Космодемʼянської	вулиця Зої Космодемʼянської
вулиця І. Франка	вулиця І. Франка
вулиця Івана Кирія	вулиця Івана Кирія
вулиця Івана Котляревського	вулиця Івана Котляревського
вулиця Івана Мазепи	вулиця Івана Мазепи
вулиця Івана Миколайчука	вулиця Івана Миколайчука
вулиця Івана Федорова	вулиця Івана Федорова
вулиця Івана Франка	вулиця Івана Франка
вулиця Ігоря Базелюка	вулиця Ігоря Базелюка
вулиця Ігоря Сікорського	вулиця Ігоря Сікорського
вулиця Каденюка	вулиця Каденюка
вулиця Калініна	вулиця Калініна
вулиця Капітана Пилипенка	вулиця Капітана Пилипенка
вулиця Карбишева	вулиця Карбишева
вулиця Карла Лібкнехта	вулиця Карла Лібкнехта
вулиця Карла Маркса	вулиця Карла Маркса
вулиця Кармелюка	вулиця Кармелюка
вулиця Карпа Васильчука	вулиця Карпа Васильчука
вулиця Катерини Ступницької	вулиця Катерини Ступницької
вулиця Кирпоноса	вулиця Кирпоноса
вулиця Кірова	вулиця Кірова
вулиця Кліща	вулиця Кліща
вулиця Княгині Ольги	вулиця Княгині Ольги
вулиця Князя Володимира	вулиця Князя Володимира
вулиця Князя Святослава	вулиця Князя Святослава
вулиця Козацької Слави	вулиця Козацької Слави
вулиця Комарова	вулиця Комарова
вулиця Коперника	вулиця Коперника
вулиця Короленка	вулиця Короленка
вулиця Корольова	вулиця Корольова
вулиця Косіора	вулиця Косіора
вулиця Котляревського	вулиця Котляревського
вулиця Котовського	вулиця Котовського
вулиця Коцюбинського	вулиця Коцюбинського
вулиця Кошового	вулиця Кошового
вулиця Кошового Олега	вулиця Олега Кошового
вулиця Крикуна	вулиця Крикуна
вулиця Крилова	вулиця Крилова
вулиця Крупської	вулиця Крупської
вулиця Кузнецова	вулиця Кузнецова
вулиця Куйбишева	вулиця Куйбишева
вулиця Кутузова	вулиця Кутузова
вулиця Левадна	вулиця Левадна
вулиця Левка Симиренка	вулиця Левка Симиренка
вулиця Лейтенанта Кобзаря	вулиця Лейтенанта Кобзаря
вулиця Леніна	вулиця Леніна
вулиця Леоніда Каденюка	вулиця Леоніда Каденюка
вулиця Леонтовича	вулиця Леонтовича
вулиця Лермонтова	вулиця Лермонтова
вулиця Лесі Українки	вулиця Лесі Українки
вулиця Литвиненка	вулиця Литвиненка
вулиця Лізиі Чайкіної	вулиця Лізиі Чайкіної
вулиця Ліни Костенко	вулиця Ліни Костенко
вулиця Ломоносова	вулиця Ломоносова
вулиця Мазепи	вулиця Мазепи
вулиця Макаренка	вулиця Макаренка
вулиця Маковійчука	вулиця Маковійчука
вулиця Максима Доника	вулиця Максима Доника
вулиця Максима Залізняка	вулиця Максима Залізняка
вулиця Максима Приходька	вулиця Максима Приходька
вулиця Марка Вовчка	вулиця Марка Вовчка
вулиця Маркевича	вулиця Маркевича
вулиця Матросова	вулиця Матросова
вулиця Маяковського	вулиця Маяковського
вулиця Механізаторів	вулиця Механізаторів
вулиця Миколайчука 	вулиця Миколайчука 
вулиця Миколи Бута	вулиця Миколи Бута
вулиця Миколи Гончарука	вулиця Миколи Гончарука
вулиця Миколи Курчика	вулиця Миколи Курчика
вулиця Мироненка	вулиця Мироненка
вулиця Михайла Грушевського	вулиця Михайла Грушевського
вулиця Михайла Довбні	вулиця Михайла Довбні
вулиця Міхновського	вулиця Міхновського
вулиця Мічуріна	вулиця Мічуріна
вулиця Мусія Кононенка	вулиця Мусія Кононенка
вулиця Назарія Іллюка	вулиця Назарія Іллюка
вулиця Назарука	вулиця Назарука
вулиця Нахімова	вулиця Нахімова
вулиця Небесної Сотні	вулиця Небесної Сотні
вулиця Невського	вулиця Невського
вулиця Некрасова	вулиця Некрасова
вулиця Нечуя-Левицького	вулиця Нечуя-Левицького
вулиця Олександра Довженка	вулиця Олександра Довженка
вулиця Олександра Колодуба	вулиця Олександра Колодуба
вулиця Олексія Дем'янюка	вулиця Олексія Демʼянюка
вулиця Олеся Гончара	вулиця Олеся Гончара
вулиця Ольги Кобилянської	вулиця Ольги Кобилянської
вулиця Осипенка	вулиця Осипенка
вулиця Остапа Вишні	вулиця Остапа Вишні
вулиця Островського	вулиця Островського
вулиця Павла Скоропадського	вулиця Павла Скоропадського
вулиця Павла Тарасенко	вулиця Павла Тарасенко
вулиця Павла Тичини	вулиця Павла Тичини
вулиця Павловського	вулиця Павловського
вулиця Панфілова	вулиця Панфілова
вулиця Пархоменка	вулиця Пархоменка
вулиця Петра Дорошенка	вулиця Петра Дорошенка
вулиця Петра Сагайдачного	вулиця Петра Сагайдачного
вулиця Петренка	вулиця Петренка
вулиця Петровського	вулиця Петровського
вулиця Плисюка	вулиця Плисюка
вулиця Полицька	вулиця Полицька
вулиця Поповича	вулиця Поповича
вулиця Потебні	вулиця Потебні
вулиця Присяжнюка	вулиця Присяжнюка
вулиця Пушкіна	вулиця Пушкіна
вулиця Рильського	вулиця Рильського
вулиця Роговця	вулиця Роговця
вулиця Рози Люксембург	вулиця Рози Люксембург
вулиця Романа Шухевича	вулиця Романа Шухевича
вулиця Романюка	вулиця Романюка
вулиця Руднєва	вулиця Руднєва
вулиця Савицької	вулиця Савицької
вулиця Сагайдачного	вулиця Сагайдачного
вулиця Свердлова	вулиця Свердлова
вулиця Северина Наливайка	вулиця Северина Наливайка
вулиця Семенова	вулиця Семенова
вулиця Сергія Амброса	вулиця Сергія Амброса
вулиця Сергія Бабича	вулиця Сергія Бабича
вулиця Сергія Мосійчука	вулиця Сергія Мосійчука
вулиця Симона Петлюри	вулиця Симона Петлюри
вулиця Слави	вулиця Слави
вулиця Степана Бандери	вулиця Степана Бандери
вулиця Тараса Шевченка	вулиця Тараса Шевченка
вулиця Тараса Шевченко	вулиця Тараса Шевченко
вулиця Тельмана	вулиця Тельмана
вулиця Терешкової	вулиця Терешкової
вулиця Терещенка	вулиця Терещенка
вулиця Титова	вулиця Титова
вулиця Тичини	вулиця Тичини
вулиця Ткаченка	вулиця Ткаченка
вулиця Толстого	вулиця Толстого
вулиця Федьковича	вулиця Федьковича
вулиця Франка	вулиця Франка
вулиця Франка І.	вулиця І. Франка
вулиця Фурманова	вулиця Фурманова
вулиця Харченка	вулиця Харченка
вулиця Чабана	вулиця Чабана
вулиця Чайковського	вулиця Чайковського
вулиця Чапаєва	вулиця Чапаєва
вулиця Червоної азовської флотилії	вулиця Червоної Азовської Флотилії
вулиця Червоної Армії	вулиця Червоної Армії
вулиця Черняховського	вулиця Черняховського
вулиця Чехова	вулиця Чехова
вулиця Чкалова	вулиця Чкалова
вулиця Шевцової	вулиця Шевцової
вулиця Шевченка	вулиця Шевченка
вулиця Щорса	вулиця Щорса
вулиця Яковця	вулиця Яковця
вулиця Ярового	вулиця Ярового
вулиця Ярослава Мудрого	вулиця Ярослава Мудрого
провулок Академіка Корольова	провулок Академіка Корольова
провулок Берегової вулиці	провулок Берегової вулиці
провулок Василя Стуса	провулок Василя Стуса
провулок Володимира Великого	провулок Володимира Великого
провулок Гагаріна	провулок Гагаріна
провулок Галкіна	провулок Галкіна
провулок Герцена	провулок Герцена
провулок Гоголя	провулок Гоголя
провулок Гончарова	провулок Гончарова
провулок Горького	провулок Горького
провулок Григорія Сковороди	провулок Григорія Сковороди
провулок Грушевського І	1-й провулок Грушевського
провулок Грушевського ІІ	2-й провулок Грушевського
провулок Журавського	провулок Журавського
провулок Івана Котляревського	провулок Івана Котляревського
провулок Калініна	провулок Калініна
провулок Катерини Ступницької	провулок Катерини Ступницької
провулок Кірова	провулок Кірова
провулок Княгині Ольги	провулок Княгині Ольги
провулок Кобилянської	провулок Кобилянської
провулок Котовського	провулок Котовського
провулок Коцюбинського	провулок Коцюбинського
провулок Кутузова	провулок Кутузова
провулок Леніна	провулок Леніна
провулок Леоніда Каденюка	провулок Леоніда Каденюка
провулок Лермонтова	провулок Лермонтова
провулок Лесі Українки	провулок Лесі Українки
провулок Лимаря	провулок Лимаря
провулок Литвиненка	провулок Литвиненка
провулок Ломоносова	провулок Ломоносова
провулок Матросова	провулок Матросова
провулок Михайла Грушевського	провулок Михайла Грушевського
провулок Наконечного	провулок Наконечного
провулок Нахімова	провулок Нахімова
провулок Нечуя-Левицького	провулок Нечуя-Левицького
провулок Постишева	провулок Постишева
провулок Рильського	провулок Рильського
провулок Рози Люксембург	провулок Рози Люксембург
провулок Смірнова	провулок Смірнова
провулок Степана Бандери	провулок Степана Бандери
провулок Стогнія	провулок Стогнія
провулок Франка	провулок Франка
провулок Чапаєва	провулок Чапаєва
провулок Чкалова	провулок Чкалова
провулок Шевченка	провулок Шевченка
провулок Щорса	провулок Щорса