Бурхлива вулиця	Бурхлива вулиця
Довга Нива вулиця	вулиця Довга Нива
Золота Нива вулиця	вулиця Золота Нива
Красива вулиця	Красива вулиця
Красивий провулок	Красивий провулок
Красивий Яр вулиця	вулиця Красивий Яр
Крива вулиця	Крива вулиця
Крива Липа проїзд	проїзд Крива Липа
Кривий Брід вулиця	вулиця Кривий Брід
Кривий Брід проїзд	проїзд Кривий Брід
Кривий Вал вулиця	вулиця Кривий Вал
Кривий провулок	Кривий провулок
Миролюбива вулиця	Миролюбива вулиця
Нива вулиця	Нива вулиця
Приваблива вулиця	Приваблива вулиця
Привабливий провулок	Привабливий провулок
Сміливий провулок	Сміливий провулок
Счастлива вулиця	Щаслива вулиця
Щаслива вулиця	Щаслива вулиця
Щасливий в'їзд	Щасливий вʼїзд
Щасливий в’їзд	Щасливий вʼїзд
Щасливий провулок	Щасливий провулок
Щасливий проспект	Щасливий проспект
Щастлива вулиця	Щаслива вулиця