Автовокзальний провулок	Автовокзальний провулок
Автомобільна вулиця	Автомобільна вулиця
Агробудівельна вулиця	Агробудівельна вулиця
Акварельна вулиця	Акварельна вулиця
Артельна вулиця	Артельна вулиця
Артільна вулиця	Артільна вулиця
Артільний провулок	Артільний провулок
Баскетбольна вулиця	Баскетбольна вулиця
Батальна вулиця	Батальна вулиця
Бічна Джерельна вулиця	Бічна Джерельна вулиця
Бічна Індустріальна вулиця	Бічна Індустріальна вулиця
Бічна Кібельна вулиця	Бічна Кібельна вулиця
Бічна шкільна вулиця	Бічна Шкільна вулиця
Бічна Шкільна вулиця	Бічна Шкільна вулиця
Будвільний провулок	Будвільний провулок
Будівельна Бічна вулиця	Бічна Будівельна вулиця
Будівельна вулиця	Будівельна вулиця
Будівельний бульвар	Будівельний бульвар
Будівельний в’їзд	Будівельний вʼїзд
Будівельний провулок	Будівельний провулок
Будівельний проїзд	Будівельний проїзд
Будівельний тупик	Будівельний тупик
Буровугільна вулиця	Буровугільна вулиця
Велика Магістральна вулиця	Велика Магістральна вулиця
Вертикальна вулиця	Вертикальна вулиця
Верхнепродольная вулиця	Верхнепродольная вулиця
Верхньовокзальна вулиця	Верхньовокзальна вулиця
Верхньоторгівельна вулиця	Верхньоторгівельна вулиця
Верхня Вокзальна вулиця	Верхня Вокзальна вулиця
Верхня Шкільна вулиця	Верхня Шкільна вулиця
Весільна вулиця	Весільна вулиця
Визвольна вулиця	Визвольна вулиця
Визвольний провулок	Визвольний провулок
Вирішальна вулиця	Вирішальна вулиця
Вільна вулиця	Вільна вулиця
Вільна Україна вулиця	вулиця Вільна Україна
Вільний в'їзд	Вільний вʼїзд
Вільний Гай вулиця	вулиця Вільний Гай
Вільний Лужок вулиця	вулиця Вільний Лужок
Вільний провулок	Вільний провулок
Вільний проїзд	Вільний проїзд
Вітрильна вулиця	Вітрильна вулиця
Водолікувальна вулиця	Водолікувальна вулиця
Возкальна вулиця	Вокзальна вулиця
Вокзальна вулиця	Вокзальна вулиця
Вокзальна площа	Вокзальна площа
Вокзальний провулок	Вокзальний провулок
Вокзальний спуск	Вокзальний спуск
Волейбольна вулиця	Волейбольна вулиця
Вольний провулок	Вольний провулок
Вугільна вулиця	Вугільна вулиця
Вугільний провулок	Вугільний провулок
Вуглебудівельна вулиця	Вуглебудівельна вулиця
вулиця Джерельна	Джерельна вулиця
вулиця Комунальна	Комунальна вулиця
вулиця Надпільна	Надпільна вулиця
вулиця Центральна	Центральна вулиця
вулиця Шкільна	Шкільна вулиця
Вулиця Шкільна	Шкільна вулиця
Гвоздильна вулиця	Гвоздильна вулиця
Геологорозвідувальний провулок	Геологорозвідувальний провулок
Гірничорятувальна вулиця	Гірничорятувальна вулиця
Гірничорятувальний провулок	Гірничорятувальний провулок
Горноспасательна вулиця	Горноспасательна вулиця
Госпітальна вулиця	Госпітальна вулиця
Госпітальний провулок	Госпітальний провулок
Готельна вулиця	Готельна вулиця
Готельний провулок	Готельний провулок
Гребельна вулиця	Гребельна вулиця
Гребельний провулок	Гребельний провулок
Джерельна вулиця	Джерельна вулиця
Джерельная вулиця	Джерельная вулиця
Джерельний в’їзд	Джерельний вʼїзд
Джерельний провулок	Джерельний провулок
Джерельний проїзд	Джерельний проїзд
Джерельний тупик	Джерельний тупик
Дзеркальна вулиця	Дзеркальна вулиця
Дизельна вулиця	Дизельна вулиця
Дирижабельна вулиця	Дирижабельна вулиця
Діагональна вулиця	Діагональна вулиця
Діагональний провулок	Діагональний провулок
Добровільна вулиця	Добровільна вулиця
Дозвільна вулиця	Дозвільна вулиця
Дольна вулиця	Дольна вулиця
Домбудівельна вулиця	Домбудівельна вулиця
Домобудівельна вулиця	Домобудівельна вулиця
Дробильна вулиця	Дробильна вулиця
Друга Вільна вулиця	2-га Вільна вулиця
Друга Привокзальна вулиця	2-га Привокзальна вулиця
Другий Цегельний провулок	2-й Цегельний провулок
Експерементальна вулиця	Експерементальна вулиця
Експериментальна вулиця	Експериментальна вулиця
Експериментальний провулок	Експериментальний провулок
Електроінструментальний провулок	Електроінструментальний провулок
Єпархіальна вулиця	Єпархіальна вулиця
Ждерельна вулиця	Джерельна вулиця
Журнальна вулиця	Журнальна вулиця
З'єднувальна вулиця	Зʼєднувальна вулиця
Забайкальний провулок	Забайкальний провулок
Завальна вулиця	Завальна вулиця
Завокзальна вулиця	Завокзальна вулиця
Завокзальний провулок	Завокзальний провулок
Заготівельний провулок	Заготівельний провулок
Загребельна вулиця	Загребельна вулиця
Загребельний провулок	Загребельний провулок
Загрибельна вулиця	Загрибельна вулиця
Заперевальна вулиця	Заперевальна вулиця
Зашкільний провулок	Зашкільний провулок
Зашкольна вулиця	Зашкольна вулиця
Збагачувальна вулиця	Збагачувальна вулиця
Збиральна вулиця	Збиральна вулиця
Земельна вулиця	Земельна вулиця
Земельний провулок	Земельний провулок
Землебудівельна вулиця	Землебудівельна вулиця
Зональна вулиця	Зональна вулиця
Зональний проїзд	Зональний проїзд
Зрошувальна вулиця	Зрошувальна вулиця
Зрошувальний провулок	Зрошувальний провулок
Ізобільна вулиця	Ізобільна вулиця
ІІ Шкільний провулок	2-й Шкільний провулок
Індустіальна вулиця	Індустіальна вулиця
Індустріальна вулиця	Індустріальна вулиця
Індустріальний в’їзд	Індустріальний вʼїзд
Індустріальний мікрорайон	Індустріальний мікрорайон
Індустріальний провулок	Індустріальний провулок
Індустріальний проїзд	Індустріальний проїзд
Індустріальний проспект	Індустріальний проспект
Індустріальний тупик	Індустріальний тупик
Інструментальна вулиця	Інструментальна вулиця
Інтернаціональна вулиця	Інтернаціональна вулиця
Інтернаціональна площа	Інтернаціональна площа
Інтернаціональний в’їзд	Інтернаціональний вʼїзд
Інтернаціональний провулок	Інтернаціональний провулок
Кабельна вулиця	Кабельна вулиця
Кальвільна вулиця	Кальвільна вулиця
Камвольна вулиця	Камвольна вулиця
Каменедробильна вулиця	Каменедробильна вулиця
Капітальна вулиця	Капітальна вулиця
Капітальний провулок	Капітальний провулок
Капітульна вулиця	Капітульна вулиця
Карнавальна вулиця	Карнавальна вулиця
Карусельна вулиця	Карусельна вулиця
Карусельний провулок	Карусельний провулок
Катедральна площа	Катедральна площа
Кафедральна вулиця	Кафедральна вулиця
Кафедральний провулок	Кафедральний провулок
Качельна вулиця	Качельна вулиця
Квартальна вулиця	Квартальна вулиця
Квартальний провулок	Квартальний провулок
Кібельна вулиця	Кібельна вулиця
Кличальний провулок	Кличальний провулок
Ковильна вулиця	Ковильна вулиця
Коксобудівельна вулиця	Коксобудівельна вулиця
Комунальна вулиця	Комунальна вулиця
Комунальний в’їзд	Комунальний вʼїзд
Комунальний провулок	Комунальний провулок
Комунальний проїзд	Комунальний проїзд
Контрольна вулиця	Контрольна вулиця
Копальна вулиця	Копальна вулиця
Корабельна вулиця	Корабельна вулиця
Корабельна площа	Корабельна площа
Корабельний провулок	Корабельний провулок
Корабельний тупик	Корабельний тупик
Корабельний узвіз	Корабельний узвіз
Костельна вулиця	Костельна вулиця
Костельний провулок	Костельний провулок
Костьольна вулиця	Костьольна вулиця
Костьольний провулок	Костьольний провулок
Котельна вулиця	Котельна вулиця
Котельний провулок	Котельний провулок
Красильна вулиця	Красильна вулиця
Красильний провулок	Красильний провулок
Кристальна вулиця	Кристальна вулиця
Купальна вулиця	Купальна вулиця
Купальний провулок	Купальний провулок
Купальний узвіз	Купальний узвіз
Лікувальна вулиця	Лікувальна вулиця
Лікувальний провулок	Лікувальний провулок
Лісопильна вулиця	Лісопильна вулиця
Лісопильний тупик	Лісопильний тупик
Магистральний проспект	Магистральний проспект
Магістральна вулиця	Магістральна вулиця
Магістральний в’їзд	Магістральний вʼїзд
Магістральний провулок	Магістральний провулок
майдан Центральний вулиця	вулиця Центральний майдан
Мала Будівельна вулиця	Мала Будівельна вулиця
Маловокзальна вулиця	Маловокзальна вулиця
Малоземельна вулиця	Малоземельна вулиця
Малопідвальна вулиця	Малопідвальна вулиця
Мангальний провулок	Мангальний провулок
Мануальна вулиця	Мануальна вулиця
Мануальний провулок	Мануальний провулок
Матеріальна вулиця	Матеріальна вулиця
Машинобудівельна вулиця	Машинобудівельна вулиця
Машинобудівельний провулок	Машинобудівельний провулок
Меморіальна алея	Меморіальна алея
Меморіальна вулиця	Меморіальна вулиця
Мергельна вулиця	Мергельна вулиця
Мигдальна вулиця	Мигдальна вулиця
Мильний провулок	Мильний провулок
Міжквартальна вулиця	Міжквартальна вулиця
Міжквартальний провулок	Міжквартальний провулок
Міжподільний провулок	Міжподільний провулок
Мінеральна вулиця	Мінеральна вулиця
Мінеральний провулок	Мінеральний провулок
Модельна вулиця	Модельна вулиця
Модельний провулок	Модельний провулок
Музикальна вулиця	Музикальна вулиця
Музикальний провулок	Музикальний провулок
Мукомельна вулиця	Мукомельна вулиця
Муніципальна вулиця	Муніципальна вулиця
Навчальна вулиця	Навчальна вулиця
Навчальний провулок	Навчальний провулок
Надпільна вулиця	Надпільна вулиця
Наступальна вулиця	Наступальна вулиця
Національна вулиця	Національна вулиця
Національний провулок	Національний провулок
Начальна вулиця	Начальна вулиця
Нижня Шкільна вулиця	Нижня Шкільна вулиця
Нижче Вокзальна вулиця	Нижче Вокзальна вулиця
Нова Центральна вулиця	Нова Центральна вулиця
Новобудівельна вулиця	Новобудівельна вулиця
Нововокзальна вулиця	Нововокзальна вулиця
Новогоспітальна вулиця	Новогоспітальна вулиця
Новоподільна вулиця	Новоподільна вулиця
Новосільна вулиця	Новосільна вулиця
Новошкільна вулиця	Новошкільна вулиця
Обільна вулиця	Обільна вулиця
Обогатитєльна вулиця	Обогатитєльна вулиця
Овальна вулиця	Овальна вулиця
Орбітальна вулиця	Орбітальна вулиця
Оскільний провулок	Оскільний провулок
Оскольний провулок	Оскольний провулок
Панельна вулиця	Панельна вулиця
Паралельна вулиця	Паралельна вулиця
Паралельний провулок	Паралельний провулок
Паркувальна вулиця	Паркувальна вулиця
Парцельна вулиця	Парцельна вулиця
Пасхальна вулиця	Пасхальна вулиця
Пасхальний провулок	Пасхальний провулок
Перевальна вулиця	Перевальна вулиця
Перевальний провулок	Перевальний провулок
Перша Вільна вулиця	1-ша Вільна вулиця
Перша Привокзальна вулиця	1-ша Привокзальна вулиця
Південно-Вокзальна вулиця	Південно-Вокзальна вулиця
Південновокзальний провулок	Південновокзальний провулок
Південнорадіальна вулиця	Південнорадіальна вулиця
Північно-Вокзальна вулиця	Північно-Вокзальна вулиця
Підвальна вулиця	Підвальна вулиця
Підвальний провулок	Підвальний провулок
Підпільна вулиця	Підпільна вулиця
Підпільний провулок	Підпільний провулок
Підскельна вулиця	Підскельна вулиця
Пільна вулиця	Пільна вулиця
Пірамідальний провулок	Пірамідальний провулок
Подильна вулиця	Подильна вулиця
Подильний провулок	Подильний провулок
Подільна вулиця	Подільна вулиця
Подольний провулок	Подольний провулок
Польна Бічна вулиця	Бічна Польна вулиця
Польна вулиця	Польна вулиця
Польна-Бічна вулиця	Бічна Польна вулиця
Престольна вулиця	Престольна вулиця
Привільна вулиця	Привільна вулиця
Привільний в’їзд	Привільний вʼїзд
Привільний провулок	Привільний провулок
Привокальна вулиця	Привокальна вулиця
Привокзальна вулиця	Привокзальна вулиця
Привокзальна Вулиця	Привокзальна вулиця
Привокзальна пл.	Привокзальна площа
Привокзальна площа	Привокзальна площа
Привокзальна Слобідка вулиця	вулиця Привокзальна Слобідка
Привокзальна Слобода вулиця	вулиця Привокзальна Слобода
Привокзальний майдан	Привокзальний майдан
Привокзальний провулок	Привокзальний провулок
Привокзальний проїзд	Привокзальний проїзд
Привокзальний тупик	Привокзальний тупик
Привольна вулиця	Привольна вулиця
Привольний провулок	Привольний провулок
Приканальна вулиця	Приканальна вулиця
Прикзальна вулиця	Прикзальна вулиця
Прихильна вулиця	Прихильна вулиця
Причальна вулиця	Причальна вулиця
Причальний провулок	Причальний провулок
Причальний узвіз	Причальний узвіз
Пришкільна вулиця	Пришкільна вулиця
Пришкільний провулок	Пришкільний провулок
Провальна вулиця	Провальна вулиця
провулок Центральний	Центральний провулок
провулок Шкільний	Шкільний провулок
Продольна вулиця	Продольна вулиця
Продольна друга вулиця	2-га Продольна вулиця
Продольна п'ята вулиця	5-та Продольна вулиця
Продольна перша вулиця	1-ша Продольна вулиця
Продольна третя вулиця	3-тя Продольна вулиця
Продольна четверта вулиця	4-та Продольна вулиця
Продольна шоста вулиця	6-та Продольна вулиця
Продольний провулок	Продольний провулок
Проектувальна вулиця	Проектувальна вулиця
Проєктувальна вулиця	Проєктувальна вулиця
Прядильний провулок	Прядильний провулок
Радіальна вулиця	Радіальна вулиця
Радіальний провулок	Радіальний провулок
Раздольна вулиця	Раздольна вулиця
Раздольная вулиця	Раздольная вулиця
Регіональна вулиця	Регіональна вулиця
Розвальна вулиця	Розвальна вулиця
Роздільна вулиця	Роздільна вулиця
Роздільний провулок	Роздільний провулок
Роздольна вулиця	Роздольна вулиця
Роздольний провулок	Роздольний провулок
Самодіяльна вулиця	Самодіяльна вулиця
Середня Шкільна вулиця	Середня Шкільна вулиця
Сигнальна вулиця	Сигнальна вулиця
Скальна вулиця	Скальна вулиця
Скельна вулиця	Скельна вулиця
Скельний провулок	Скельний провулок
Смольна вулиця	Смольна вулиця
Смольний провулок	Смольний провулок
Сортовипробувальний провулок	Сортовипробувальний провулок
Сортувальна вулиця	Сортувальна вулиця
Сортувальна Набережна вулиця	Сортувальна Набережна вулиця
Сортувальний Набережний проїзд	Сортувальний Набережний проїзд
Сортувальний провулок	Сортувальний провулок
Соціальна вулиця	Соціальна вулиця
Соціальний провулок	Соціальний провулок
Спільна вулиця	Спільна вулиця
Сталеплавильна вулиця	Сталеплавильна вулиця
Станкобудівельна вулиця	Станкобудівельна вулиця
Стапельна вулиця	Стапельна вулиця
Старовокзальна вулиця	Старовокзальна вулиця
Старовокзальний провулок	Старовокзальний провулок
Старокатедральна вулиця	Старокатедральна вулиця
Староцентральна вулиця	Староцентральна вулиця
Старошкільний провулок	Старошкільний провулок
Ствольна вулиця	Ствольна вулиця
Стекольний провулок	Стекольний провулок
Строительна вулиця	Строительна вулиця
Строїтєльний провулок	Строїтєльний провулок
Суспільний провулок	Суспільний провулок
Театральна вулиця	Театральна вулиця
Театральна площа	Театральна площа
Театральний бульвар	Театральний бульвар
Театральний майдан	Театральний майдан
Театральний провулок	Театральний провулок
Театральний проспект	Театральний проспект
Театральний тупик	Театральний тупик
Текстильна вулиця	Текстильна вулиця
Текстильний провулок	Текстильний провулок
Територіальний провулок	Територіальний провулок
Тильна вулиця	Тильна вулиця
Тонельна вулиця	Тонельна вулиця
Тонельний провулок	Тонельний провулок
Топольна вулиця	Топольна вулиця
Топольний провулок	Топольний провулок
Торгівельна вулиця	Торгівельна вулиця
Торгівельний провулок	Торгівельний провулок
Торговельна вулиця	Торговельна вулиця
Торговельний провулок	Торговельний провулок
Торкальна вулиця	Торкальна вулиця
Тракторнодетальна вулиця	Тракторнодетальна вулиця
Третій Вирішальний вулиця	вулиця Третій Вирішальний
Третій Вирішальний провулок	провулок Третій Вирішальний
Тріумфальна вулиця	Тріумфальна вулиця
Тріумфальний провулок	Тріумфальний провулок
Трудшкільна вулиця	Трудшкільна вулиця
Тунельна вулиця	Тунельна вулиця
Тунельний провулок	Тунельний провулок
Тунельний проїзд	Тунельний проїзд
Удільна вулиця	Удільна вулиця
Удільний провулок	Удільний провулок
Універсальна вулиця	Універсальна вулиця
Універсальний провулок	Універсальний провулок
Факельний провулок	Факельний провулок
Фенольна вулиця	Фенольна вулиця
Фестивальна алея	Фестивальна алея
Фестивальна вулиця	Фестивальна вулиця
Фестивальна площа	Фестивальна площа
Фестивальний провулок	Фестивальний провулок
Фетивальна вулиця	Фетивальна вулиця
Фільтровальна вулиця	Фільтровальна вулиця
Фільтрувальна вулиця	Фільтрувальна вулиця
Фінальна вулиця	Фінальна вулиця
Фундаментальна вулиця	Фундаментальна вулиця
Футбольна вулиця	Футбольна вулиця
Футбольний провулок	Футбольний провулок
Хлібосольна вулиця	Хлібосольна вулиця
Хмільна вулиця	Хмільна вулиця
Холодильна вулиця	Холодильна вулиця
Холодильний провулок	Холодильний провулок
Холодильний проїзд	Холодильний проїзд
Хрустальна вулиця	Хрустальна вулиця
Хрустальний провулок	Хрустальний провулок
Цегельна бічна вулиця	Бічна Цегельна вулиця
Цегельна вулиця	Цегельна вулиця
Цегельнавулиця	Цегельна вулиця
Цегельний завод вулиця	вулиця Цегельний Завод
Цегельний провулок	Цегельний провулок
Цегельний проувлок	Цегельний проувлок
Цегельний тупик	Цегельний тупик
Ценральна вулиця	Ценральна вулиця
Центральна  вулиця	Центральна вулиця
Центральна алея	Центральна алея
Центральна алея вулиця	вулиця Центральна Алея
Центральна Бічна вулиця	Бічна Центральна вулиця
Центральна вулийя	Центральна вулиця
Центральна вулиці	Центральна вулиця
Центральна вулиця	Центральна вулиця
Центральна Вулиця	Центральна вулиця
Центральна вулицяц	Центральна вулиця
Центральна паркова алея	Центральна Паркова алея
Центральна площа	Центральна площа
Центральна площа м. Сарни	Центральна площа міста Сарни
Центральна Садова вулиця	Центральна Садова вулиця
Центральна-бічна вулиця	Бічна Центральна вулиця
Центральная аллея	Центральная аллея
Центральний автовокзал	Центральний автовокзал
Центральний Аеропорт вулиця	вулиця Центральний Аеропорт
Центральний бульвар	Центральний бульвар
Центральний в'їзд	Центральний вʼїзд
Центральний в’їзд	Центральний вʼїзд
Центральний вʼїзд	Центральний вʼїзд
Центральний квартал	Центральний квартал
Центральний майдан	Центральний майдан
Центральний Майдан вулиця	вулиця Центральний Майдан
Центральний мікрорайон	Центральний мікрорайон
Центральний міст	Центральний міст
Центральний пішоходний міст	Центральний пішоходний міст
Центральний провулок	Центральний провулок
Центральний проїзд	Центральний проїзд
Центральний проспект	Центральний проспект
Центральний Спуск	Центральний спуск
Центральний універмаг	Центральний універмаг
Центрральна вулиця	Центральна вулиця
Цетральна вулиця	Центральна вулиця
Цивільний проїзд	Цивільний проїзд
Цитадельна вулиця	Цитадельна вулиця
Червоношкільна набережна	Червоношкільна набережна
Шкартальна вулиця	Шкартальна вулиця
Шкільна алея	Шкільна алея
Шкільна вулиця	Шкільна вулиця
ШКІЛЬНА вулиця	Шкільна вулиця
Шкільна площа	Шкільна площа
Шкільний бульвар	Шкільний бульвар
Шкільний в’їзд	Шкільний вʼїзд
Шкільний майдан	Шкільний майдан
Шкільний масив	Шкільний масив
Шкільний провулок	Шкільний провулок
Шкільний проїзд	Шкільний проїзд
Шкільний проспект	Шкільний проспект
Шкільний тупик	Шкільний тупик
Шкiльна вулиця	Шкільна вулиця
Шкiльна проща	Шкільна площа
Шкiльний провулок	Шкільний провулок
Штурвальна вулиця	Штурвальна вулиця
Ясельна вулиця	Ясельна вулиця
Ясельний провулок	Ясельний провулок