1-го Травня площа	площа 1 Травня
10-го Квітня площа	площа 10 Квітня
1000-ліття Полонного	площа 1000-ліття Полонного
200-річчя Херсона площа	площа 200-річчя Херсона
40 років Перемоги площа	площа 40 років Перемоги
40-річчя Перемоги площа	площа 40-річчя Перемоги
700-річчя Черкас площа	площа 700-річчя Черкас
900-річчя Буська площа	площа 900-річчя Буська
Августина Штефана площа	площа Августина Штефана
Авіаторів площа	площа Авіаторів
Аграрна площа	Аграрна площа
Адміралтейська площа	Адміралтейська площа
Академіка Олексія Бекетова площа	площа Академіка Олексія Бекетова
Андрія Первозваного площа	площа Андрія Первозваного
Анкари площа	площа Анкари
Арсенальна площа	Арсенальна площа
Арутюнова площа	площа Арутюнова
Базарна площа	Базарна площа
Бессарабська площа	Бессарабська площа
Богдана Хмельницького площа	площа Богдана Хмельницького
Бориса Дерев’янка площа	площа Бориса Дерев’янка
Борисо-Глібська площа	Борисо-Глібська площа
Ботанічна площа	Ботанічна площа
Брезаноці площа	площа Брезаноці
Будапешт площа	площа Будапешт
В. І. Сазанова площа	площа В. І. Сазанова
Валерія Марченка площа	площа Валерія Марченка
Варошдерек площа	площа Варошдерек
Васильківська площа	Васильківська площа
Василя Симоненка площа	площа Василя Симоненка
Визволення майдан	майдан Визволення
Визволення площа	площа Визволення
Відрадна площа	Відрадна площа
Вічева площа	Вічева площа
Вічевий майдан	Вічевий майдан
Воззʼєднання площа	площа Воззʼєднання
Воїнів-інтернаціоналістів площа	площа Воїнів-Інтернаціоналістів
Вокзальна площа	Вокзальна площа
Волі майдан	майдан Волі
Володимирська площа	Володимирська площа
Володимирський майдан	Володимирський майдан
Гайдамаків майдан	майдан Гайдамаків майдан
Галицька площа	Галицька площа
Ганнібала площа	площа Ганнібала
Георгія Кірпи площа	площа Георгія Кірпи
Героїв ВВВ майдан	майдан Героїв ВВВ майдан
Героїв Майдану площа	площа Героїв Майдану
Героїв Майдану Площа	площа Героїв Майдану
Героїв Маріуполя площа	площа Героїв Маріуполя
Героїв Небесної Сотні площа	площа Героїв Небесної Сотні
Героїв площа	площа Героїв
Героїв Сталінграду площа	площа Героїв Сталінграду
Героїв УПА площа	площа Героїв УПА
Головна площа	Головна площа
Голосіївська площа	Голосіївська площа
Гостомельська площа	Гостомельська площа
Грецька площа	Грецька площа
Гур'їва площа	Гурʼїва площа
Дарницька площа	Дарницька площа
Двір площа	площа Двір
Деміївська площа	Деміївська площа
Домнобудівників площа	площа Домнобудівників
Донецька площа	Донецька площа
Дружби народів площа	площа Дружби Народів
Думська площа	Думська площа
Європейська площа	Європейська площа
Європейський майдан	Європейський майдан
Єдності площа	площа Єдності
Житньоторзька площа	Житньоторзька площа
Жігмонда Перені площа	площа Жігмонда Перені
Жовтнева площа	Жовтнева площа
Жупанатська площа	Жупанатська площа
Залізничників площа	площа Залізничників
Замковий майдан	Замковий майдан
Зарембського майдан	майдан Зарембського
Захисників України майдан	майдан Захисників України
Згоди майдан	майдан Згоди
Зигмунда Козара площа	площа Зигмунда Козара
Злуки площа	площа Злуки
Івана Богуна площа	площа Івана Богуна
Івана Франка площа	площа Івана Франка
Ім. Т.Г. Шевченка площа	площа Шевченка
Йосифа Сліпого майдан	майдан Йосифа Сліпого
Кальвіна площа	площа Кальвіна
Керченська площа	Керченська площа
Київська площа	Київська площа
Кловська площа	Кловська площа
Княжа площа	Княжа площа
Князя Ігоря площа	площа Князя Ігоря
Конотопської Битви площа	площа Конотопської Битви
Конституції площа	площа Конституції
Кооперативна площа	Кооперативна площа
Короленка майдан	майдан Короленка
Корольова майдан	майдан Корольова
Космонавтів площа	площа Космонавтів
Кошута площа	площа Кошута
Красна площа	Красна площа
Культури площа	площа Культури
Лемківська площа	Лемківська площа
Леніна площа	площа Леніна
Леоніда Телятникова площа	площа Леоніда Телятникова
Лесі Українки площа	площа Лесі Українки
Либідська площа	Либідська площа
Лук’янівська площа	Лукʼянівська площа
Льва Толстого площа	площа Льва Толстого
Львівська площа	Львівська площа
Майдан 1-го травня	майдан 1 Травня
Майдан Волі	майдан Волі
Майдан Злагоди	майдан Злагоди
майдан Княжий двір	майдан Княжий Двір
Майдан музики	майдан Музики
майдан Незалежності	майдан Незалежності
Майдан Незалежності	майдан Незалежності
Майдан Перемоги	майдан Перемоги
Майдан Університетський	Університетський майдан
Матері площа	площа Матері
Матросова площа	Матросова площа
Машинобудівників площа	площа Машинобудівників
Металістів площа	площа Металістів
Металургів площа	площа Металургів
Миколи Леонтовича площа	площа Миколи Леонтовича
Миру площа	площа Миру
Митна площа	Митна площа
Михайла Загороднього площа	площа Михайла Загороднього
Михайла Співака площа	площа Михайла Співака
Михайлівська площа	Михайлівська площа
Міклоша Зелеі площа	площа Міклоша Зелеі
Мінська площа	Мінська площа
Міський ринок	Міський ринок
Мічуріна площа	площа Мічуріна
Молодіжна площа	Молодіжна площа
Молодої Гвардії площа	площа Молодої Гвардії
Набережна площа	Набережна площа
Наводницька площа	Наводницька площа
Навсі площа	площа Навсі
Народна площа	Народна площа
Національної Гвардії майдан	майдан Національної Гвардії
Незалежності майдан	майдан Незалежності
Незалежності площа	площа Незалежності
Оболонська площа	Оболонська площа
Одеська площа	Одеська площа
ОУН-УПА майдан	майдан ОУН-УПА
Очаківська площа	Очаківська площа
П'ятачок Демократії	Пʼятачок Демократії
П’ять кутів площа	площа Пʼять Кутів
Павла Дубинди площа	площа Павла Дубинди
Павленківська площа	Павленківська площа
Пам’яті площа	площа Памʼяті
Пантелеймона Куліша площа	площа Пантелеймона Куліша
Паркова площа	Паркова площа
Паширова площа	площа Паширова
Перемоги майдан	майдан Перемоги
Перемоги площа	площа Перемоги
Петра Кривоноса площа	площа Петра Кривоноса
Петропавлівська площа	Петропавлівська площа
Печерська площа	Печерська площа
площа Андрія Бачинського	площа Андрія Бачинського
Площа бажання	площа Бажання
площа Богдана Хмельницького	площа Богдана Хмельницького
площа Василя Ґренджі-Донського	площа Василя Ґренджі-Донського
площа Віталія Постолакі	площа Віталія Постолакі
Площа Волоха	площа Волоха
площа Г. Пашкевич	площа Г. Пашкевич
площа Гаврила Глюка	площа Гаврила Глюка
Площа Героїв Євромайдану	площа Героїв Євромайдану
площа Героїв Майдану	площа Героїв Майдану
Площа героїв парку перемоги	Площа Героїв Парку Перемоги
площа Григорія Кірпи	площа Григорія Кірпи
площа Гусєва	площа Гусєва
площа Дружби Народів	площа Дружби Народів
площа Едмунта Егана	площа Едмунта Егана
площа Енді Воргола	площа Енді Воргола
площа Євгена Томенчука	площа Євгена Томенчука
площа Євгена Фенцика	площа Євгена Фенцика
Площа знань	площа Знань
Площа знань НТУУ «КПІ»	площа Знань
Площа ім. Поляка	площа імені Поляка
площа Карла Маркса	площа Карла Маркса
площа Карпатської України	площа Карпатської України
площа Кирила і Мефодія	площа Кирила і Мефодія
площа Князя Лаборця	площа Князя Лаборця
площа Кооперативна	Кооперативна площа
площа Корятовича	площа Корятовича
площа Кошута	площа Кошута
площа Культури	площа Культури
площа Лебедєва-Кумача	площа Лебедєва-Кумача
площа Маяковського	площа Маяковського
площа Миру	площа Миру
Площа Миру	площа Миру
площа Незалежності	площа Незалежності
площа Олександра Духновича	площа Олександра Духновича
площа Олександра Пушкіна	площа Олександра Пушкіна
площа Паланок	площа Паланок
площа Памʼяті	площа Памʼяті
площа Перемоги	площа Перемоги
Площа Перемоги	площа Перемоги
площа Ракоці	площа Ракоці
площа Свободи	площа Свободи
площа Святого Йоана Павла ІІ	площа Святого Йоана Павла II
Площа Соборності	площа Соборності
площа Тараса Шевченка	площа Тараса Шевченка
площа Шандора Петефі	площа Шандора Петефі
площа Шахтарів	площа Шахтарів
Площа Шевченка	площа Шевченка
площа Ювілейна	Ювілейна площа
Покровська площа	Покровська площа
Польовий майдан	Польовий майдан
Польський Ринок площа	площа Польський Ринок
Портова площа	Портова площа
Посохівська площа	Посохівська площа
Поштова площа	Поштова площа
Правобережна площа	Правобережна площа
Привокзальна площа	Привокзальна площа
Привокзальний майдан	Привокзальний майдан
Приморська площа	Приморська площа
Профспілок площа	площа Профспілок
Путятинський майдан	Путятинський майдан
Пушкіна площа	площа Пушкіна
Радянська площа	Радянська площа
Революції площа	площа Революції
Рибна площа	Рибна площа
Ринок майдан	майдан Ринок
Ринок площа	площа Ринок
Різдвяна площа	Різдвяна площа
Романа Шухевича площа	площа Романа Шухевича
Руднянський майдан	Руднянський майдан
Сантьяго-де-Чилі площа	площа Сантьяго-де-Чилі
Свободи площа	площа Свободи
Святошинська площа	Святошинська площа
Севастопольська площа	Севастопольська площа
Северина Наливайка площа	площа Северина Наливайка
Семейка площа	площа Семейка
Сергія Набоки площа	площа Сергія Набоки
Сінна площа	Сінна площа
Січових Стрільців площа	площа Січових Стрільців
Сквер Перемоги	сквер Перемоги
Сквер Прокатників	сквер Прокатників
Сквер слави	сквер Слави
Слави площа	площа Слави
Смолянський майдан	Смолянський майдан
Соборна площа	Соборна площа
Соборний майдан	Соборний майдан
Соборно-Миколаївська площа	Соборно-Миколаївська площа
Соборності площа	площа Соборності
Спортивна площа	Спортивна площа
Стадіонна площа	Стадіонна площа
Станишівський майдан	Станишівський майдан
Станіслава Лема площа	площа Станіслава Лема
Старовокзальна площа	Старовокзальна площа
Степана Бандери майдан	майдан Степана Бандери
Стефана Яворського площа	площа Стефана Яворського
Т. Г. Шевченка площа	площа Т. Г. Шевченка
Т.Г.Шевченка площа	площа Т.Г. Шевченка
Таїрова площа	Таїрова площа
Тараса Григоровича Шевченка площа	площа Тараса Григоровича Шевченка
Тараса Шевченка площа	площа Тараса Шевченка
Театральна площа	Театральна площа
Театральний майдан	Театральний майдан
Ткаченко площа	площа Ткаченко
Товарна площа	Товарна площа
Толбухіна площа	площа Толбухіна
Томаша Есе площа	площа Томаша Есе
Торгова площа	Торгова площа
Транспорта площа	Транспорта площа
Троїцька площа	Троїцька площа
Уланська площа	Уланська площа
Успенська площа	Успенська площа
Ференца Ракоці площа	площа Ференца Ракоці
Ференца Ракоці Ⅱ площа	плоащ Ференца Ракоці II
Фестивальна площа	Фестивальна площа
Холмська площа	Холмська площа
Холодноярський майдан	Холодноярський майдан
Центральна площа	Центральна площа
Центральна площа Крижополя	Центральна площа Крижополя
Центральна площа смт.Підволочиськ	Центральна площа
Центральний майдан	Центральний майдан
Червона площа	Червона площа
Червоний майдан	Червоний майдан
Чернігівська площа	Чернігівська площа
Чорнобаївська площа	Чорнобаївська площа
Шахтарська площа	Шахтарська площа
Шахтарської слави площа	площа Шахтарської Cлави
Шевченка майдан	майдан Шевченка
Шевченка площа	площа Шевченка
Шептицького майдан	майдан Шептицького
Шишманівська площа	Шишманівська площа
Шуберта площа	площа Шуберта
Щекавицька площа	Щекавицька площа
Яловиковська площа	Яловиковська площа
Ярмаркова площа	Ярмаркова площа