Адмірала Холостякова вулиця	вулиця Адмірала Холостякова
Академіка Дем’янова вулиця	вулиця Академіка Демʼянова
Академіка Курнакова вулиця	вулиця Академіка Курнакова
Академіка Оппокова вулиця	вулиця Академіка Оппокова
Академіка Прасолова вулиця	вулиця Академіка Прасолова
Академіка Пріснякова вулиця	вулиця Академіка Пріснякова
Академіка Решитньова вулиця	вулиця Академіка Решитньова
Академіка Шахбазова вулиця	вулиця Академіка Шахбазова
Аки Камбарова вулиця	вулиця Аки Камбарова
Акі Камбарова вулиця	вулиця Акі Камбарова
Алея почесних поховань	алея Почесних Поховань
Андезитовий тупик провулок	провулок Андезитовий Тупик
Архітектора Артинова вулиця	вулиця Архітектора Артинова
Архітектора Старова вулиця	вулиця Архітектора Старова
Белікова балка вулиця	вулиця Белікова Балка
Березова Роща вулиця	вулиця Березова Роща
Березовий Гай вулиця	вулиця Березовий Гай
Березовий Гай провулок	провулок Березовий Гай
Бічна Бігова вулиця	Бічна Бігова вулиця
Бічна Бурштинова вулиця	Бічна Бурштинова вулиця
Бічна Замкова вулиця	Бічна Замкова вулиця
Бічна Лісова вулиця	Бічна Лісова вулиця
Бічна Нова вулиця	Бічна Нова вулиця
Бічна паркова вулиця	Бічна Паркова вулиця
Бічна Польова вулиця	Бічна Польова вулиця
Бічна Промислова вулиця	Бічна Промислова вулиця
Бічна Садова вулиця	Бічна Садова вулиця
Братів Коваленків вулиця	вулиця Братів Коваленків
Братів Коваленків провулок	провулок Братів Коваленків
Братів Ковалів вулиця	вулиця Братів Ковалів
Братів Ковальчуків вулиця	вулиця Братів Ковальчуків
Броварської сотні вулиця	вулиця Броварської Сотні
Броварської сотнi вулиця	вулиця Броварської Сотні
В’ячеслава Куреньова вулиця	вулиця Вʼячеслава Куреньова
Велика Лісова вулиця	Велика Лісова вулиця
Велика Лугова вулиця	Велика Лугова вулиця
Велика Садова вулиця	Велика Садова вулиця
Верхній Береговий провулок	Верхній Береговий провулок
Верхній Лісовий провулок	Верхній Лісовий провулок
Верхній Степовий провулок	Верхній Степовий провулок
Верхня Берегова вулиця	Верхня Берегова вулиця
Верхня Нова вулиця	Верхня Нова вулиця
Верхня польова вулиця	Верхня Польова вулиця
Верхня Садова вулиця	Верхня Садова вулиця
Верхня степова вулиця	Верхня Степова вулиця
Верхня Трудова вулиця	Верхня Трудова вулиця
Вище Польова вулиця	Вище Польова вулиця
Водоп’ янова провулок	провулок Водопʼянова
вулиця Лісова Просіка	вулиця Лісова Просіка
Гайова Бічна вулиця	Бічна Гайова вулиця
Генерала Драгомирова вулиця	вулиця Генерала Драгомирова
Генерала Духова вулиця	вулиця Генерала Духова
Генерала Жадова вулиця	вулиця Генерала Жадова
Генерала Жованика вулиця	вулиця Генерала Жованика
Генерала Зав’ялова вулиця	вулиця Генерала Завʼялова
Генерала Карлова вулиця	вулиця Генерала Карлова
Генерала Луппова вулиця	вулиця Генерала Луппова
Генерала Людникова вулиця	вулиця Генерала Людникова
Генерала Небогатова вулиця	вулиця Генерала Небогатова
Генерала Острякова проспект	проспект Генерала Острякова
Генерала Ратова вулиця	вулиця Генерала Ратова
Генерала Тупікова вулиця	вулиця Генерала Тупікова
Генерала Чибісова вулиця	вулиця Генерала Чибісова
Генерала Чуйкова вулиця	вулиця Генерала Чуйкова
Генерала Шепетова вулиця	вулиця Генерала Шепетова
Генерала Шумілова вулиця	вулиця Генерала Шумілова
Геолога Осколкова провулок	провулок Геолога Осколкова
Героїв Азова вулиця	вулиця Героїв Азова
Героїв Харкова вулиця	вулиця Героїв Харкова
Героїв Харкова проспект	проспект Героїв Харкова
Героїв Чернігова вулиця	вулиця Героїв Чернігова
Головна Поселкова вулиця	Головна Поселкова вулиця
Горіхова Бухта вулиця	вулиця Горіхова Бухта
Грузовий Двір вулиця	вулиця Грузовий Двір
Друга садова вулиця	2-га Садова вулиця
Другий Калиновий провулок	2-й Калиновий провулок
Дубовий гай вулиця	вулиця Дубовий Гай
Дубовий Гай вулиця	вулиця Дубовий Гай
Дубовий куток вулиця	вулиця Дубовий Куток
Дубовий яр вулиця	вулиця Дубовий Яр
Є. Столбова вулиця	вулиця Є. Столбова
Живова Бічна вулиця	Бічна Живова вулиця
Житловий масив вулиця	вулиця Житловий Масив
Замкова Бічна вулиця	Бічна Замкова вулиця
Замкова гора вулиця	вулиця Замкова Гора
Зимова горішня вулиця	Зимова Горішня вулиця
Зимова Горішня вулиця	Зимова Горішня вулиця
Зимова долішня вулиця	Зимова Долішня вулиця
Зимова Долішня вулиця	Зимова Долішня вулиця
І. Богослова вулиця	вулиця І. Богослова
І.І. Рачкова вулиця	вулиця І. І. Рачкова
Калиновий Ріг вулиця	вулиця Калиновий Ріг
Калиновий Ріг проїзд	проїзд Калиновий Ріг
Карначова Генерала вулиця	вулиця Генерала Карначова
Клеменова Дача вулиця	вулиця Клеменова Дача
Клеменова Дача провулок	провулок Клеменова Дача
Кленова Долина вулиця	вулиця Кленова Долина
Кленовий Узвіз вулиця	вулиця Кленовий Узвіз
Командарма Шумілова вулиця	вулиця Командарма Шумілова
Кут Малиновий вулиця	вулиця Малиновий Кут
Лейтенанта Аркалова вулиця	вулиця Лейтенанта Аркалова
Лейтенанта Дніпрова провулок	провулок Лейтенанта Дніпрова
Лейтенанта Покладова вулиця	вулиця Лейтенанта Покладова
Лейтенанта Туркова вулиця	вулиця Лейтенанта Туркова
Липова Алея вулиця	вулиця Липова Алея
Липовий Яр вулиця	вулиця Липовий Яр
Лікаря Горбурова вулиця	вулиця Лікаря Горбурова
Лісова Бічна вулиця	Бічна Лісова вулиця
Лісова поляна вулиця	вулиця Лісова Поляна
Лісова Просіка вулиця	вулиця Лісова Просіка
Мала Лісова вулиця	Мала Лісова вулиця
Мала Польова вулиця	Мала Польова вулиця
Мала Садова вулиця	Мала Садова вулиця
Малий Садовий провулок	Малий Садовий провулок
Мало Садова вулиця	Мало Садова вулиця
Мало Садовий провулок	Мало Садовий провулок
Мар’яна Каптованця вулиця	вулоиця Марʼяна Каптованця
Маршала жукова вулиця	вулиця Маршала Жукова
Маршала Чуйкова вулиця	вулиця Маршала Чуйкова
Межовий Бульвар вулиця	вулиця Межовий Бульвар
Міжлісовий хутір вулиця	вулиця Міжлісовий Хутір
Мостова бічна вулиця	Бічна Мостова вулиця
Нижній Береговий провулок	Нижній Береговий провулок
Нижня Берегова вулиця	Нижня Берегова вулиця
Нижня Нова вулиця	Нижня Нова вулиця
Нижня Садова вулиця	Нижня Садова вулиця
Нижня Трудова вулиця	Нижня Трудова вулиця
Нова бічна вулиця	Бічна Нова вулиця
Нова Воля вулиця	вулиця Нова Воля
Нова Воля провулок	провулок Нова Воля
Нова Гребля вулиця	вулиця Нова Гребля
Нова Займа вулиця	вулиця Нова Займа
Нова Залізнична вулиця	Нова Залізнична вулиця
Нова Зоря вулиця	вулиця Нова Зоря
Нова ІІ вулиця	2-га Нова вулиця
Нова Лугова вулиця	Нова Лугова вулиця
Нова Паркова вулиця	Нова Паркова вулиця
Нова Ріка вулиця	вулиця Нова Ріка
Нова Феофанія вулиця	вулиця Нова Феофанія
Нова Яблунева вулиця	Нова Яблунева вулиця
Новаторів Донбасу вулиця	вулиця Новаторів Донбасу
Новий Базар вулиця	вулиця Новий Базар
Новий Зубок вулиця	вулиця Новий Зубок
Новий мікрорайон вулиця	вулиця Новий Мікрорайон
Новий План вулиця	вулиця Новий План
Новий Побут вулиця	вулиця Новий Побут
Новий Побут провулок	провулок Новий Побут
Новий Посьолок вулиця	вулиця Новий Посьолок
Новий Світ Бічна вулиця	Бічна вулиця Новий Світ
Новий світ вулиця	вулиця Новий Світ
Новий Світ вулиця	вулиця Новий Світ
Новий Світ провулок	провулок Новий Світ
Новий шахтар вулиця	вулиця Новий Шахтар
Новий Шлях вулиця	вулиця Новий Шлях
Нурмагомеда Гаджимагомедова площа	площа Нурмагомеда Гаджимагомедова
Перша Виставкова вулиця	Перша Виставкова вулиця
провулок Лісовий І	1-й Лісовий провулок
провулок Лісовий ІІ	2-й Лісовий провулок
провулок Лісовий ІІІ	3-й Лісовий провулок
Промислова бічна вулиця	Бічна Промислова вулиця
проспект Генерала Острякова	проспект Генерала Острякова
проспект Героїв Харкова	проспект Героїв Харкова
Ранкова Зоря вулиця	вулиця Ранкова Зоря
Родини Коваленків вулиця	вулиця Родини Коваленків
Садова  вулиця	Садова вулиця
Садова бічна вулиця	Бічна Садова вулиця
Садова Бічна вулиця	Бічна Садова вулиця
Садовий Бульвар вулиця	вулиця Садовий Бульвар
Садовий Яр вулиця	вулиця Садовий Яр
Скульптора Ізмалкова вулиця	вулиця Скульптора Ізмалкова
Соснова поляна вулиця	вулиця Соснова Поляна
Сосновий бір вулиця	вулиця Сосновий Бір
Сосновий Бір вулиця	вулиця Сосновий Бір
Сосновий Гай вулиця	вулиця Сосновий Гай
Ставковий спуск вулиця	вулиця Ставковий Спуск
Степова друга вулиця	2-га Степова вулиця
Степова перша вулиця	1-ша Степова вулиця
Торгова Бічна вулиця	Бічна Торгова вулиця
Урочище Промисловий центр вулиця	урочище Промисловий Центр
Фруктова бічна вулиця	Бічна Фруктова вулиця
Хмельова друга вулиця	2-га Хмельова вулиця
Хмельова П’ята вулиця	5-та Хмельова вулиця
Хмельова перша вулиця	1-ша Хмельова вулиця
Хмельова третя вулиця	3-тя Хмельова вулиця
Хмельова четверта вулиця	4-та Хмельова вулиця
Художника Канцерова провулок	провулок Художника Канцерова
Хутір Садовий вулиця	вулиця Садовий Хутір
Царова гора вулиця	вулиця Царова Гора
Цукровий завод вулиця	вулиця Цукровий Завод
Червоний Камінь житловий масив	житловий масив Червоний Камінь
Чуйкова Маршала вулиця	вулиця Маршала Чуйкова