
1-а Матросова вулиця	1-ша вулиця Матросова
1-а Менделєєва вулиця	1-ша вулиця Менделєєва
1-а Ползунова вулиця	1-ша вулиця Ползунова
1-ая Пирогова вулиця	1-ша вулиця Пирогова
1-ий Захарченка провулок	1-й провулок Захарченка
1-ий Мазепи провулок	1-й провулок Мазепи
1-й Айвазовського провулок	1-й провулок Айвазовського
1-й Амундсена провулок	1-й провулок Амундсена
1-й Байрона в’їзд	1-й вʼїзд Байрона
1-й Бестужева провулок	1-й провулок Бестужева
1-й Блюхера провулок	1-й провулок Блюхера
1-й Бойка провулок	1-й провулок Бойка
1-й Будьонного провулок	1-й провулок Будьонного
1-й Ватутіна провулок	1-й провулок Ватутіна
1-й Вишневського провулок	1-й провулок Вишневського
1-й Воровського провулок	1-й провулок Воровського
1-й Ворошилова провулок	1-й провулок Ворошилова
1-й Гагаріна провулок	1-й провулок Гагаріна
1-й Гайдара провулок	1-й провулок Гайдара
1-й Герцена провулок	1-й провулок Герцена
1-й Глазунова провулок	1-й провулок Глазунова
1-й Глінки провулок	1-й провулок Глінки
1-й Гоголя провулок	1-й провулок Гоголя
1-й Горького провулок	1-й провулок Горького
1-й Грибоєдова провулок	1-й провулок Грибоєдова
1-й Громова провулок	1-й провулок Громова
1-й Грушевського провулок	1-й провулок Грушевського
1-й Дзержинського провулок	1-й провулок Дзержинського
1-й Димитрова провулок	1-й провулок Димитрова
1-й Добролюбова провулок	1-й провулок Добролюбова
1-й Довженка провулок	1-й провулок Довженка
1-й Докучаєва проїзд	1-й проїзд Докучаєва
1-й Достоєвського в’їзд	1-й вʼїзд Достоєвського
1-й Дубініна провулок	1-й провулок Дубініна
1-й Дудіна провулок	1-й провулок Дудіна
1-й Дунаєвського провулок	1-й провулок Дунаєвського
1-й Дундича провулок	1-й провулок Дундича
1-й Жукова провулок	1-й провулок Жукова
1-й Задніпровського провулок	1-й провулок Задніпровського
1-й Затонського провулок	1-й провулок Затонського
1-й Зелінського провулок	1-й провулок Зелінського
1-й І.Франка провулок	1-й провулок І. Франка
1-й Іванова провулок	1-й провулок Іванова
1-й Калініна провулок	1-й провулок Калініна
1-й Карбишева провулок	1-й провулок Карбишева
1-й Карбишева проїзд	1-й проїзд Карбишева
1-й Кармелюка провулок	1-й провулок Кармелюка
1-й Кибальчича провулок	1-й провулок Кибальчича
1-й Кірова провулок	1-й провулок Кірова
1-й Ковпака провулок	1-й провулок Ковпака
1-й Комарова провулок	1-й провулок Комарова
1-й Коновальця провулок	1-й провулок Коновальця
1-й Короленка провулок	1-й провулок Короленка
1-й Корольова провулок	1-й провулок Корольова
1-й Котляревського провулок	1-й провулок Котляревського
1-й Коцюбинського провулок	1-й провулок Коцюбинського
1-й Кривоноса провулок	1-й провулок Кривоноса
1-й Крилова в’їзд	1-й вʼїзд Крилова
1-й Крилова провулок	1-й провулок Крилова
1-й Кропоткіна провулок	1-й провулок Кропоткіна
1-й Купайла проїзд	1-й проїзд Купайла
1-й Кутузова провулок	1-й провулок Кутузова
1-й Кушніра провулок	1-й провулок Кушніра
1-й Леніна провулок	1-й провулок Леніна
1-й Леонтовича провулок	1-й провулок Леонтовича
1-й Лермонтова провулок	1-й провулок Лермонтова
1-й Лермонтова тупик	1-й тупик Лермонтова
1-й Лисенка провулок	1-й провулок Лисенка
1-й Литвиненка провулок	1-й провулок Литвиненка
1-й Литвиненка тупик	1-й тупик Литвиненка
1-й Ломоносова провулок	1-й провулок Ломоносова
1-й Мазепи провулок	1-й провулок Мазепи
1-й Макаренка провулок	1-й провулок Макаренка
1-й Макаренка проїзд	1-й проїзд Макаренка
1-й Максимовича проїзд	1-й проїзд Максимовича
1-й Малюги провулок	1-й провулок Малюги
1-й Мануїльського провулок	1-й провулок Мануїльського
1-й Матросова в'їзд	1-й вʼїзд Матросова
1-й Матросова провулок	1-й провулок Матросова
1-й Маяковського провулок	1-й провулок Маяковського
1-й Мирошниченка провулок	1-й провулок Мирошниченка
1-й Мічуріна в’їзд	1-й вʼїзд Мічуріна
1-й Мічуріна провулок	1-й провулок Мічуріна
1-й Мічуріна тупик	1-й тупик Мічуріна
1-й Міщенка провулок	1-й провулок Міщенка
1-й Москвіна провулок	1-й провулок Москвіна
1-й Нахімова провулок	1-й провулок Нахімова
1-й Нахімова тупик	1-й тупик Нахімова
1-й Некрасова в’їзд	1-й вʼїзд Некрасова
1-й Некрасова провулок	1-й провулок Некрасова
1-й Одоєвського тупик	1-й тупик Одоєвського
1-й Островського провулок	1-й провулок Островського
1-й Павленка провулок	1-й провулок Павленка
1-й Пархоменка провулок	1-й провулок Пархоменка
1-й Пестеля провулок	1-й провулок Пестеля
1-й Петровського в’їзд	1-й вʼїзд Петровського
1-й Петровського провулок	1-й провулок Петровського
1-й Пирогова провулок	1-й провулок Пирогова
1-й Піонтковського провулок	1-й провулок Піонтковського
1-й Покровського провулок	1-й провулок Покровського
1-й Поповича провулок	1-й провулок Поповича
1-й Постишева провулок	1-й провулок Постишева
1-й Постишева проїзд	1-й проїзд Постишева
1-й Пушкіна провулок	1-й провулок Пушкіна
1-й Радищева провулок	1-й провулок Радищева
1-й Рилєєва провулок	1-й провулок Рилєєва
1-й Руданського провулок	1-й провулок Руданського
1-й Сагайдачного провулок	1-й провулок Сагайдачного
1-й Свердлова провулок	1-й провулок Свердлова
1-й Серафимовича провулок	1-й провулок Серафимовича
1-й Сковороди провулок	1-й провулок Сковороди
1-й Степанюка провулок	1-й провулок Степанюка
1-й Стеценка провулок	1-й провулок Стеценка
1-й Суворова провулок	1-й провулок Суворова
1-й Сурикова провулок	1-й провулок Сурикова
1-й Тельмана провулок	1-й провулок Тельмана
1-й Тімірязєва провулок	1-й провулок Тімірязєва
1-й Толстого провулок	1-й провулок Толстого
1-й Толстого тупик	1-й тупик Толстого
1-й Тропініна провулок	1-й провулок Тропініна
1-й Тухачевського провулок	1-й провулок Тухачевського
1-й Ульянова провулок	1-й провулок Ульянова
1-й Ушакова провулок	1-й провулок Ушакова
1-й Ушинського провулок	1-й провулок Ушинського
1-й Франка провулок	1-й провулок Франка
1-й Фурманова провулок	1-й провулок Фурманова
1-й Чайковського провулок	1-й провулок Чайковського
1-й Чапаєва провулок	1-й провулок Чапаєва
1-й Чернишевського провулок	1-й провулок Чернишевського
1-й Черняховського провулок	1-й провулок Черняховського
1-й Черняховського проїзд	1-й проїзд Черняховського
1-й Чехова провулок	1-й провулок Чехова
1-й Чехова проїзд	1-й проїзд Чехова
1-й Чкалова провулок	1-й провулок Чкалова
1-й Чкалова тупик	1-й тупик Чкалова
1-й Шаумяна проїзд	1-й проїзд Шаумяна
1-й Шевченка провулок	1-й провулок Шевченка
1-й Шевченка проїзд	1-й проїзд Шевченка
1-й Шишкіна провулок	1-й провулок Шишкіна
1-й Щорса провулок	1-й провулок Щорса
1-й Щорса тупик	1-й тупик Щорса
1-й Ющенка провулок	1-й провулок Ющенка
2-га Пирогова вулиця	2-га вулиця Пирогова
2-й Айвазовського провулок	2-й провулок Айвазовського
2-й Амундсена провулок	2-й провулок Амундсена
2-й Байрона в’їзд	2-й вʼїзд Байрона
2-й Бестужева провулок	2-й провулок Бестужева
2-й Бєлінського провулок	2-й провулок Бєлінського
2-й Блюхера провулок	2-й провулок Блюхера
2-й Боженка провулок	2-й провулок Боженка
2-й Бойка провулок	2-й провулок Бойка
2-й Будьонного провулок	2-й провулок Будьонного
2-й Ватутіна провулок	2-й провулок Ватутіна
2-й Вишневського провулок	2-й провулок Вишневського
2-й Воровського провулок	2-й провулок Воровського
2-й Воронкова провулок	2-й провулок Воронкова
2-й Ворошилова провулок	2-й провулок Ворошилова
2-й Гагаріна провулок	2-й провулок Гагаріна
2-й Гайдара провулок	2-й провулок Гайдара
2-й Герцена провулок	2-й провулок Герцена
2-й Глазунова провулок	2-й провулок Глазунова
2-й Глінки провулок	2-й провулок Глінки
2-й Гоголя провулок	2-й провулок Гоголя
2-й Гонти провулок	2-й провулок Гонти
2-й Горького провулок	2-й провулок Горького
2-й Грибоєдова провулок	2-й провулок Грибоєдова
2-й Громова провулок	2-й провулок Громова
2-й Грушевського провулок	2-й провулок Грушевського
2-й Димитрова провулок	2-й провулок Димитрова
2-й Довженка провулок	2-й провулок Довженка
2-й Докучаєва проїзд	2-й проїзд Докучаєва
2-й Дубініна провулок	2-й провулок Дубініна
2-й Дунаєвського провулок	2-й провулок Дунаєвського
2-й Дундича провулок	2-й провулок Дундича
2-й Енгельса провулок	2-й провулок Енгельса
2-й Жукова провулок	2-й провулок Жукова
2-й Задніпровського провулок	2-й провулок Задніпровського
2-й Захарченка провулок	2-й провулок Захарченка
2-й Зелінського провулок	2-й провулок Зелінського
2-й Іванова провулок	2-й провулок Іванова
2-й Калініна провулок	2-й провулок Калініна
2-й Карбишева провулок	2-й провулок Карбишева
2-й Карбишева проїзд	2-й проїзд Карбишева
2-й Кармелюка провулок	2-й провулок Кармелюка
2-й Кірова провулок	2-й провулок Кірова
2-й Ковпака провулок	2-й провулок Ковпака
2-й Комарова провулок	2-й провулок Комарова
2-й Коновальця провулок	2-й провулок Коновальця
2-й Корнєва провулок	2-й провулок Корнєва
2-й Короленка провулок	2-й провулок Короленка
2-й Корольова провулок	2-й провулок Корольова
2-й Котляревського провулок	2-й провулок Котляревського
2-й Коцюбинського провулок	2-й провулок Коцюбинського
2-й Кривоноса провулок	2-й провулок Кривоноса
2-й Крилова в’їзд	2-й вʼїзд Крилова
2-й Крилова провулок	2-й провулок Крилова
2-й Купайла проїзд	2-й проїзд Купайла
2-й Кутузова провулок	2-й провулок Кутузова
2-й Леніна провулок	2-й провулок Леніна
2-й Лермонтова провулок	2-й провулок Лермонтова
2-й Лермонтова тупик	2-й тупик Лермонтова
2-й Лисенка провулок	2-й провулок Лисенка
2-й Лібкнехта провулок	2-й провулок Лібкнехта
2-й Ломоносова провулок	2-й провулок Ломоносова
2-й Мазепи провулок	2-й провулок Мазепи
2-й Макаренка провулок	2-й провулок Макаренка
2-й Макаренка проїзд	2-й проїзд Макаренка
2-й Максимовича проїзд	2-й проїзд Максимовича
2-й Мануїльського провулок	2-й провулок Мануїльського
2-й Матросова в'їзд	2-й вʼїзд Матросова
2-й Матросова провулок	2-й провулок Матросова
2-й Маяковського провулок	2-й провулок Маяковського
2-й Мічуріна в’їзд	2-й вʼїзд Мічуріна
2-й Мічуріна провулок	2-й провулок Мічуріна
2-й Мічуріна тупик	2-й тупик Мічуріна
2-й Москвіна провулок	2-й провулок Москвіна
2-й Нахімова провулок	2-й провулок Нахімова
2-й Нахімова тупик	2-й тупик Нахімова
2-й Некрасова провулок	2-й провулок Некрасова
2-й О.Теліги провулок	2-й провулок О.Теліги
2-й Одоєвського тупик	2-й тупик Одоєвського
2-й Островського провулок	2-й провулок Островського
2-й Павленка проїзд	2-й проїзд Павленка
2-й Пархоменка провулок	2-й провулок Пархоменка
2-й Пестеля провулок	2-й провулок Пестеля
2-й Петровського в’їзд	2-й вʼїзд Петровського
2-й Петровського провулок	2-й провулок Петровського
2-й Пирогова провулок	2-й провулок Пирогова
2-й Піонтковського провулок	2-й провулок Піонтковського
2-й Постишева провулок	2-й провулок Постишева
2-й Постишева проїзд	2-й проїзд Постишева
2-й Пушкіна провулок	2-й провулок Пушкіна
2-й Радищева провулок	2-й провулок Радищева
2-й Рєпіна провулок	2-й провулок Рєпіна
2-й Рилєєва провулок	2-й провулок Рилєєва
2-й Римського-Корсакова провулок	2-й провулок Римського-Корсакова
2-й Сагайдачного провулок	2-й провулок Сагайдачного
2-й Саєнка провулок	2-й провулок Саєнка
2-й Свердлова провулок	2-й провулок Свердлова
2-й Серафимовича провулок	2-й провулок Серафимовича
2-й Сковороди провулок	2-й провулок Сковороди
2-й Станіславського провулок	2-й провулок Станіславського
2-й Степанюка провулок	2-й провулок Степанюка
2-й Стеценка провулок	2-й провулок Стеценка
2-й Суворова провулок	2-й провулок Суворова
2-й Тельмана провулок	2-й провулок Тельмана
2-й Тімірязєва провулок	2-й провулок Тімірязєва
2-й Толстого провулок	2-й провулок Толстого
2-й Тропініна провулок	2-й провулок Тропініна
2-й Тухачевського провулок	2-й провулок Тухачевського
2-й Ульянова провулок	2-й провулок Ульянова
2-й Ушакова провулок	2-й провулок Ушакова
2-й Ушинського провулок	2-й провулок Ушинського
2-й Федьковича провулок	2-й провулок Федьковича
2-й Франка провулок	2-й провулок Франка
2-й Франка тупик	2-й тупик Франка
2-й Фурманова провулок	2-й провулок Фурманова
2-й Цюрупи провулок	2-й провулок Цюрупи
2-й Чайковського провулок	2-й провулок Чайковського
2-й Чапаєва провулок	2-й провулок Чапаєва
2-й Черняховського провулок	2-й провулок Черняховського
2-й Черняховського проїзд	2-й проїзд Черняховського
2-й Чехова провулок	2-й провулок Чехова
2-й Чехова проїзд	2-й проїзд Чехова
2-й Чкалова провулок	2-й провулок Чкалова
2-й Чкалова тупик	2-й тупик Чкалова
2-й Шаумяна проїзд	2-й проїзд Шаумяна
2-й Шевченка провулок	2-й провулок Шевченка
2-й Шишкіна провулок	2-й провулок Шишкіна
2-й Шолохова провулок	2-й провулок Шолохова
2-й Щорса провулок	2-й провулок Щорса
2-й Щорса тупик	2-й тупик Щорса
2-тий Сагайдачного провулок	2-й провулок Сагайдачного
200-річчя Шевченка вулиця	вулиця 200-річчя Шевченка
200-річчя Шевченка провулок	провулок 200-річчя Шевченка
3-ая Пирогова вулиця	3-тя вулиця Пирогова
3-й Амундсена провулок	3-й провулок Амундсена
3-й Бєлінського провулок	3-й провулок Бєлінського
3-й Блюхера провулок	3-й провулок Блюхера
3-й Боженка провулок	3-й провулок Боженка
3-й Бойка провулок	3-й провулок Бойка
3-й Вишневського провулок	3-й провулок Вишневського
3-й Ворошилова провулок	3-й провулок Ворошилова
3-й Гагаріна провулок	3-й провулок Гагаріна
3-й Глінки провулок	3-й провулок Глінки
3-й Гоголя провулок	3-й провулок Гоголя
3-й Горького провулок	3-й провулок Горького
3-й Грушевського провулок	3-й провулок Грушевського
3-й Дунаєвського провулок	3-й провулок Дунаєвського
3-й Дундича провулок	3-й провулок Дундича
3-й Енгельса провулок	3-й провулок Енгельса
3-й Задніпровського провулок	3-й провулок Задніпровського
3-й Калініна провулок	3-й провулок Калініна
3-й Карбишева провулок	3-й провулок Карбишева
3-й Карбишева проїзд	3-й проїзд Карбишева
3-й Комарова провулок	3-й провулок Комарова
3-й Короленка провулок	3-й провулок Короленка
3-й Кривоноса провулок	3-й провулок Кривоноса
3-й Крилова провулок	3-й провулок Крилова
3-й Купайла проїзд	3-й проїзд Купайла
3-й Лермонтова провулок	3-й провулок Лермонтова
3-й Лермонтова тупик	3-й тупик Лермонтова
3-й Ломоносова провулок	3-й провулок Ломоносова
3-й Максимовича проїзд	3-й проїзд Максимовича
3-й Мануїльського провулок	3-й провулок Мануїльського
3-й Матросова провулок	3-й провулок Матросова
3-й Мічуріна в’їзд	3-й вʼїзд Мічуріна
3-й Мічуріна тупик	3-й тупик Мічуріна
3-й Нахімова провулок	3-й провулок Нахімова
3-й Некрасова провулок	3-й провулок Некрасова
3-й Одоєвського тупик	3-й тупик Одоєвського
3-й Пестеля провулок	3-й провулок Пестеля
3-й Пирогова провулок	3-й провулок Пирогова
3-й Постишева провулок	3-й провулок Постишева
3-й Пушкіна провулок	3-й провулок Пушкіна
3-й Руданського провулок	3-й провулок Руданського
3-й Сагайдачного провулок	3-й провулок Сагайдачного
3-й Серафимовича провулок	3-й провулок Серафимовича
3-й Сковороди провулок	3-й провулок Сковороди
3-й Тимірязєва провулок	3-й провулок Тимірязєва
3-й Тухачевського провулок	3-й провулок Тухачевського
3-й Фурманова провулок	3-й провулок Фурманова
3-й Ціолковського провулок	3-й провулок Ціолковського
3-й Чапаєва провулок	3-й провулок Чапаєва
3-й Черняховського проїзд	3-й проїзд Черняховського
3-й Чехова провулок	3-й провулок Чехова
3-й Чехова проїзд	3-й проїзд Чехова
3-й Чкалова провулок	3-й провулок Чкалова
3-й Чкалова тупик	3-й тупик Чкалова
3-й Шевченка провулок	3-й провулок Шевченка
3-й Шишкіна провулок	3-й провулок Шишкіна
3-й Щорса провулок	3-й провулок Щорса
3-тий Сагайдачного провулок	3-й провулок Сагайдачного
4-ий Чкалова тупик	4-й тупик Чкалова
4-й Бєлінського провулок	4-й провулок Бєлінського
4-й Богуна провулок	4-й провулок Богуна
4-й Бойка провулок	4-й провулок Бойка
4-й Гагаріна провулок	4-й провулок Гагаріна
4-й Гоголя провулок	4-й провулок Гоголя
4-й Козака провулок	4-й провулок Козака
4-й Комарова провулок	4-й провулок Комарова
4-й Лермонтова тупик	4-й тупик Лермонтова
4-й Мануїльського провулок	4-й провулок Мануїльського
4-й Пушкіна провулок	4-й провулок Пушкіна
4-й Руданського провулок	4-й провулок Руданського
4-й Сковороди провулок	4-й провулок Сковороди
4-й Тимірязєва провулок	4-й провулок Тимірязєва
4-й Чапаєва провулок	4-й провулок Чапаєва
4-й Черняховського проїзд	4-й проїзд Черняховського
4-й Чкалова провулок	4-й провулок Чкалова
4-й Щорса провулок	4-й провулок Щорса
4-тий Сагайдачного провулок	4-й провулок Сагайдачного
5-й Богуна провулок	5-й провулок Богуна
5-й Гагаріна провулок	5-й провулок Гагаріна
5-й Гоголя провулок	5-й провулок Гоголя
5-й Довженка провулок	5-й провулок Довженка
5-й Комарова провулок	5-й провулок Комарова
5-й Лермонтова тупик	5-й тупик Лермонтова
5-й Тимірязєва провулок	5-й провулок Тимірязєва
5-й Черняховського проїзд	5-й проїзд Черняховського
5-й Щорса провулок	5-й провулок Щорса
6-й Богуна провулок	6-й провулок Богуна
6-й Гагаріна провулок	6-й провулок Гагаріна
6-й Довженка провулок	6-й провулок Довженка
6-й Черняховського проїзд	6-й проїзд Черняховського
6-й Щорса провулок	6-й провулок Щорса
7-й Козака провулок	7-й провулок Козака