1 Махнівський провулок	1-й Махнівський провулок
1-й Аеропортівський провулок	1-й Аеропортівський провулок
1-й Альтинський провулок	1-й Альтинський провулок
1-й Балтський провулок	1-й Балтський провулок
1-й Барашівський провулок	1-й Барашівський провулок
1-й Барський провулок	1-й Барський провулок
1-й Берегометський провулок	1-й Берегометський провулок
1-й Бережинський провулок	1-й Бережинський провулок
1-й Бірюковський провулок	1-й Бірюковський провулок
1-й Богунівський провулок	1-й Богунівський провулок
1-й Вапняковий провулок	1-й Вапняковий провулок
1-й Вижницький провулок	1-й Вижницький провулок
1-й Військоматський провулок	1-й Військоматський провулок
1-й Вільський провулок	1-й Вільський провулок
1-й Возненський провулок	1-й Возненський провулок
1-й Володимирівський провулок	1-й Володимирівський провулок
1-й Волчанський провулок	1-й Волчанський провулок
1-й Гайдамацький провулок	1-й Гайдамацький провулок
1-й Генетичний провулок	1-й Генетичний провулок
1-й Глинський провулок	1-й Глинський провулок
1-й Груньський провулок	1-й Груньський провулок
1-й Димківський провулок	1-й Димківський провулок
1-й Дорошенківський в’їзд	1-й Дорошенківський вʼїзд
1-й Дорошенківський провулок	1-й Дорошенківський провулок
1-й Дробильний провулок	1-й Дробильний провулок
1-й Евенський провулок	1-й Евенський провулок
1-й Журавський провулок	1-й Журавський провулок
1-й Заорільський провулок	1-й Заорільський провулок
1-й Засульський провулок	1-й Засульський провулок
1-й Інтернатський провулок	1-й Інтернатський провулок
1-й Казнівський провулок	1-й Казнівський провулок
1-й Капітульний провулок	1-й Капітульний провулок
1-й Каракульний провулок	1-й Каракульний провулок
1-й Кипарисний провулок	1-й Кипарисний провулок
1-й Кирпичний тупик	1-й Кирпичний тупик
1-й Китобійний провулок	1-й Китобійний провулок
1-й Кільченський провулок	1-й Кільченський провулок
1-й Ключевий провулок	1-й Ключевий провулок
1-й Книжковецький проїзд	1-й Книжковецький проїзд
1-й Колеусівський провулок	1-й Колеусівський провулок
1-й Колісниченківський провулок	1-й Колісниченківський провулок
1-й Колонний провулок	1-й Колонний провулок
1-й Котеджний проїзд	1-й Котеджний проїзд
1-й Котласький проїзд	1-й Котласький проїзд
1-й Крошенський провулок	1-й Крошенський провулок
1-й Лазаретний провулок	1-й Лазаретний провулок
1-й Левадний тупик	1-й Левадний тупик
1-й Легпромівський провулок	1-й Легпромівський провулок
1-й Лелеківський провулок	1-й Лелеківський провулок
1-й Лелечий проїзд	1-й Лелечий проїзд
1-й Лірницький провулок	1-й Лірницький провулок
1-й Лісопарківський провулок	1-й Лісопарківський провулок
1-й Лузанівський провулок	1-й Лузанівський провулок
1-й Луковецький провулок	1-й Луковецький провулок
1-й Магазинний провулок	1-й Магазинний провулок
1-й Малоомелянівський провулок	1-й Малоомелянівський провулок
1-й Маршовий провулок	1-й Маршовий провулок
1-й Матеріальний провулок	1-й Матеріальний провулок
1-й Механізаторський провулок	1-й Механізаторський провулок
1-й Налічний провулок	1-й Налічний провулок
1-й Немишлянський в’їзд	1-й Немишлянський вʼїзд
1-й Нескучний в'їзд	1-й Нескучний вʼїзд
1-й Нижньогиївський узвіз	1-й Нижньогиївський узвіз
1-й Нижньодністровський провулок	1-й Нижньодністровський провулок
1-й Нижньосадовий провулок	1-й Нижньосадовий провулок
1-й Низгірецький провулок	1-й Низгірецький провулок
1-й Новогоголівський провулок	1-й Новогоголівський провулок
1-й Новогоголівський проїзд	1-й Новогоголівський проїзд
1-й Новонерубайський провулок	1-й Новонерубайський провулок
1-й Новопівнічний провулок	1-й Новопівнічний провулок
1-й Носівський провулок	1-й Носівський провулок
1-й Озаринецький тупик	1-й Озаринецький тупик
1-й Оружейний провулок	1-й Оружейний провулок
1-й Павликівський провулок	1-й Павликівський провулок
1-й Паравозний провулок	1-й Паравозний провулок
1-й Петренківський в’їзд	1-й Петренківський вʼїзд
1-й Петренківський провулок	1-й Петренківський провулок
1-й Петренківський проїзд	1-й Петренківський проїзд
1-й Пічугінський провулок	1-й Пічугінський провулок
1-й Постніковський провулок	1-й Постніковський провулок
1-й Придунайський провулок	1-й Придунайський провулок
1-й приуданський провулок	1-й приуданський провулок
1-й проєктний провулок	1-й проєктний провулок
1-й Протипохилий провулок	1-й Протипохилий провулок
1-й Професійний провулок	1-й Професійний провулок
1-й Прудний провулок	1-й Прудний провулок
1-й Раднаркомівський провулок	1-й Раднаркомівський провулок
1-й Рембудівський проїзд	1-й Рембудівський проїзд
1-й Розумовський провулок	1-й Розумовський провулок
1-й Саговський провулок	1-й Саговський провулок
1-й Садово-проїзний провулок	1-й Садово-проїзний провулок
1-й Сирітський провулок	1-й Сирітський провулок
1-й Сільскогосподарський провулок	1-й Сільскогосподарський провулок
1-й Скляний провулок	1-й Скляний провулок
1-й Скнилівський провулок	1-й Скнилівський провулок
1-й Смоківський провулок	1-й Смоківський провулок
1-й Старовський в’їзд	1-й Старовський вʼїзд
1-й Староленківський провулок	1-й Староленківський провулок
1-й Староруднянський провулок	1-й Староруднянський провулок
1-й Суничний проїзд	1-й Суничний проїзд
1-й Східчастий провулок	1-й Східчастий провулок
1-й Таловий провулок	1-й Таловий провулок
1-й Тираспільський в’їзд	1-й Тираспільський вʼїзд
1-й Тіняковський провулок	1-й Тіняковський провулок
1-й Удайський провулок	1-й Удайський провулок
1-й Ходорівський провулок	1-й Ходорівський провулок
1-й Чернігівсьуий провулок	1-й Чернігівсьуий провулок
1-й Шаргородський провулок	1-й Шаргородський провулок
1-й Шатрищанський провулок	1-й Шатрищанський провулок
1-й Ялинівський провулок	1-й Ялинівський провулок
10-й Скнилівський провулок	10-й Скнилівський провулок
11-й Лутугінський проїзд	11-й Лутугінський проїзд
2-й Альтинський провулок	2-й Альтинський провулок
2-й Балтський провулок	2-й Балтський провулок
2-й Барашівський провулок	2-й Барашівський провулок
2-й Барський провулок	2-й Барський провулок
2-й Біробіджанський проїзд	2-й Біробіджанський проїзд
2-й Бірюковський провулок	2-й Бірюковський провулок
2-й Богунівський провулок	2-й Богунівський провулок
2-й Вижницький провулок	2-й Вижницький провулок
2-й Військоматський провулок	2-й Військоматський провулок
2-й Вільський провулок	2-й Вільський провулок
2-й Волчанський провулок	2-й Волчанський провулок
2-й Генетичний провулок	2-й Генетичний провулок
2-й Глинський провулок	2-й Глинський провулок
2-й гостинний в'їзд	2-й гостинний вʼїзд
2-й Груньський провулок	2-й Груньський провулок
2-й Димківський провулок	2-й Димківський провулок
2-й Дорошенківський в’їзд	2-й Дорошенківський вʼїзд
2-й Дорошенківський провулок	2-й Дорошенківський провулок
2-й Дробильний провулок	2-й Дробильний провулок
2-й Дубнинський провулок	2-й Дубнинський провулок
2-й Евенський провулок	2-й Евенський провулок
2-й Журавський провулок	2-й Журавський провулок
2-й заливний провулок	2-й заливний провулок
2-й Заорільський провулок	2-й Заорільський провулок
2-й Інтернатський провулок	2-й Інтернатський провулок
2-й Казнівський провулок	2-й Казнівський провулок
2-й Капітульний провулок	2-й Капітульний провулок
2-й Каракульний провулок	2-й Каракульний провулок
2-й Кипарисний провулок	2-й Кипарисний провулок
2-й Кисилівський провулок	2-й Кисилівський провулок
2-й Китаєвський провулок	2-й Китаєвський провулок
2-й Китобійний провулок	2-й Китобійний провулок
2-й Кільченський провулок	2-й Кільченський провулок
2-й Кладбищенський провулок	2-й Кладбищенський провулок
2-й Ключевий провулок	2-й Ключевий провулок
2-й Книжковецький проїзд	2-й Книжковецький проїзд
2-й Колеусівський провулок	2-й Колеусівський провулок
2-й Колісниченківський провулок	2-й Колісниченківський провулок
2-й Колонний провулок	2-й Колонний провулок
2-й Котеджний проїзд	2-й Котеджний проїзд
2-й Котласький проїзд	2-й Котласький проїзд
2-й Крошенський провулок	2-й Крошенський провулок
2-й Лазаретний провулок	2-й Лазаретний провулок
2-й Легпромівський провулок	2-й Легпромівський провулок
2-й Лелеківський провулок	2-й Лелеківський провулок
2-й Лелечий проїзд	2-й Лелечий проїзд
2-й Лірницький провулок	2-й Лірницький провулок
2-й Лісопарківський провулок	2-й Лісопарківський провулок
2-й Лубчицький провулок	2-й Лубчицький провулок
2-й Луковецький провулок	2-й Луковецький провулок
2-й Лутугінський проїзд	2-й Лутугінський проїзд
2-й Магазинний провулок	2-й Магазинний провулок
2-й Малоомелянівський провулок	2-й Малоомелянівський провулок
2-й Маршовий провулок	2-й Маршовий провулок
2-й Матеріальний провулок	2-й Матеріальний провулок
2-й Мичуринский тупик	2-й Мичуринский тупик
2-й Налічний провулок	2-й Налічний провулок
2-й Немишлянський в’їзд	2-й Немишлянський вʼїзд
2-й Нижньогиївський в’їзд	2-й Нижньогиївський вʼїзд
2-й Нижньогиївський узвіз	2-й Нижньогиївський узвіз
2-й Нижньодністровський провулок	2-й Нижньодністровський провулок
2-й Нижньосадовий провулок	2-й Нижньосадовий провулок
2-й Низгірецький провулок	2-й Низгірецький провулок
2-й Новогоголівський провулок	2-й Новогоголівський провулок
2-й Новогоголівський проїзд	2-й Новогоголівський проїзд
2-й Новонерубайський провулок	2-й Новонерубайський провулок
2-й Новопівнічний провулок	2-й Новопівнічний провулок
2-й Озаринецький тупик	2-й Озаринецький тупик
2-й Петренківський в’їзд	2-й Петренківський вʼїзд
2-й Петренківський провулок	2-й Петренківський провулок
2-й Петренківський проїзд	2-й Петренківський проїзд
2-й Підгаєцький провулок	2-й Підгаєцький провулок
2-й Пічугінський провулок	2-й Пічугінський провулок
2-й Постниківський провулок	2-й Постниківський провулок
2-й Придунайський провулок	2-й Придунайський провулок
2-й Прирічковий провулок	2-й Прирічковий провулок
2-й проєктний провулок	2-й проєктний провулок
2-й Протипохилий провулок	2-й Протипохилий провулок
2-й Професійний провулок	2-й Професійний провулок
2-й Прудний провулок	2-й Прудний провулок
2-й Рембудівський проїзд	2-й Рембудівський проїзд
2-й Розумовський провулок	2-й Розумовський провулок
2-й Саговський провулок	2-й Саговський провулок
2-й Садово-проїзний провулок	2-й Садово-проїзний провулок
2-й Сирітський провулок	2-й Сирітський провулок
2-й Скляний провулок	2-й Скляний провулок
2-й Скнилівський провулок	2-й Скнилівський провулок
2-й Смоківський провулок	2-й Смоківський провулок
2-й Староверещаківський в’їзд	2-й Староверещаківський вʼїзд
2-й Староруднянський провулок	2-й Староруднянський провулок
2-й Суничний проїзд	2-й Суничний проїзд
2-й Таловий провулок	2-й Таловий провулок
2-й Тираспільський в’їзд	2-й Тираспільський вʼїзд
2-й Тіняковський провулок	2-й Тіняковський провулок
2-й Топорівький провулок	2-й Топорівький провулок
2-й Удайський провулок	2-й Удайський провулок
2-й Февральський провулок	2-й Февральський провулок
2-й Ходорівський провулок	2-й Ходорівський провулок
2-й Чагорський провулок	2-й Чагорський провулок
2-й Шаргородський провулок	2-й Шаргородський провулок
2-й Шатрищанський провулок	2-й Шатрищанський провулок
2-й Ялинівський провулок	2-й Ялинівський провулок
2-й Ярківський провулок	2-й Ярківський провулок
3-й Баглійський провулок	3-й Баглійський провулок
3-й Балтський провулок	3-й Балтський провулок
3-й Барський провулок	3-й Барський провулок
3-й Біробіджанський проїзд	3-й Біробіджанський проїзд
3-й Вапняковий провулок	3-й Вапняковий провулок
3-й Вижницький провулок	3-й Вижницький провулок
3-й Вільський провулок	3-й Вільський провулок
3-й Генетичний провулок	3-й Генетичний провулок
3-й Груньський провулок	3-й Груньський провулок
3-й Заорільський провулок	3-й Заорільський провулок
3-й Канатний провулок	3-й Канатний провулок
3-й Каракульний провулок	3-й Каракульний провулок
3-й Кипарисний провулок	3-й Кипарисний провулок
3-й Книжковецький проїзд	3-й Книжковецький проїзд
3-й Колісниченківський провулок	3-й Колісниченківський провулок
3-й Колонний провулок	3-й Колонний провулок
3-й Котеджний проїзд	3-й Котеджний проїзд
3-й Крошенський провулок	3-й Крошенський провулок
3-й Легпромівський провулок	3-й Легпромівський провулок
3-й Лелеківський провулок	3-й Лелеківський провулок
3-й Магазинний провулок	3-й Магазинний провулок
3-й Малоомелянівський провулок	3-й Малоомелянівський провулок
3-й Налічний провулок	3-й Налічний провулок
3-й Немишлянський в’їзд	3-й Немишлянський вʼїзд
3-й Нижньогиївський узвіз	3-й Нижньогиївський узвіз
3-й Нижньодністровський провулок	3-й Нижньодністровський провулок
3-й Новогоголівський провулок	3-й Новогоголівський провулок
3-й Новонерубайський провулок	3-й Новонерубайський провулок
3-й Петренківський проїзд	3-й Петренківський проїзд
3-й Похилий провулок	3-й Похилий провулок
3-й Придунайський провулок	3-й Придунайський провулок
3-й Прирічковий провулок	3-й Прирічковий провулок
3-й Проектуємий провулок	3-й Проектуємий провулок
3-й Рембудівський проїзд	3-й Рембудівський проїзд
3-й Садово-проїзний провулок	3-й Садово-проїзний провулок
3-й Садовопроїзний провулок	3-й Садовопроїзний провулок
3-й Скляний провулок	3-й Скляний провулок
3-й Скнилівський провулок	3-й Скнилівський провулок
3-й Смоківський проїзд	3-й Смоківський проїзд
3-й Східчастий провулок	3-й Східчастий провулок
3-й Тираспільський в’їзд	3-й Тираспільський вʼїзд
3-й Удайський провулок	3-й Удайський провулок
3-й Уляновський провулок	3-й Уляновський провулок
3-й Хаджибеєвський провулок	3-й Хаджибеєвський провулок
3-й Ходорівський провулок	3-й Ходорівський провулок
3-й Чагорський провулок	3-й Чагорський провулок
3-й Шаргородський провулок	3-й Шаргородський провулок
3-й Шатрищанський провулок	3-й Шатрищанський провулок
4-й Аеропортівський провулок	4-й Аеропортівський провулок
4-й Балтський провулок	4-й Балтський провулок
4-й Біробіджанський проїзд	4-й Біробіджанський проїзд
4-й Вільський провулок	4-й Вільський провулок
4-й Каракульний провулок	4-й Каракульний провулок
4-й Книжковецький проїзд	4-й Книжковецький проїзд
4-й Колеусівський провулок	4-й Колеусівський провулок
4-й Колонний провулок	4-й Колонний провулок
4-й Кошевий провулок	4-й Кошевий провулок
4-й Крошенський провулок	4-й Крошенський провулок
4-й Легпромівський провулок	4-й Легпромівський провулок
4-й Лутугінський проїзд	4-й Лутугінський проїзд
4-й Магазинний провулок	4-й Магазинний провулок
4-й Малоомелянівський провулок	4-й Малоомелянівський провулок
4-й Налічний провулок	4-й Налічний провулок
4-й Нижньогиївський узвіз	4-й Нижньогиївський узвіз
4-й Нижньогієвський спуск	4-й Нижньогієвський спуск
4-й Петренківський проїзд	4-й Петренківський проїзд
4-й Садово-проїзний провулок	4-й Садово-проїзний провулок
4-й Скнилівський провулок	4-й Скнилівський провулок
4-й Тираспільський в’їзд	4-й Тираспільський вʼїзд
4-й Ходорівський провулок	4-й Ходорівський провулок
5-й Аеропортівський провулок	5-й Аеропортівський провулок
5-й Балтський провулок	5-й Балтський провулок
5-й Книжковецький проїзд	5-й Книжковецький проїзд
5-й Колеусівський провулок	5-й Колеусівський провулок
5-й Лутугінський проїзд	5-й Лутугінський проїзд
5-й Магазинний провулок	5-й Магазинний провулок
5-й Малоомелянівський провулок	5-й Малоомелянівський провулок
5-й Налічний провулок	5-й Налічний провулок
5-й Немишлянський в’їзд	5-й Немишлянський вʼїзд
5-й Нижньогиївський узвіз	5-й Нижньогиївський узвіз
5-й Проектуємий провулок	5-й Проектуємий провулок
5-й Садовопроїзний провулок	5-й Садовопроїзний провулок
5-й Скнилівський провулок	5-й Скнилівський провулок
6-й Аеропортівський провулок	6-й Аеропортівський провулок
6-й Балтський провулок	6-й Балтський провулок
6-й Книжковецький проїзд	6-й Книжковецький проїзд
6-й Колеусівський провулок	6-й Колеусівський провулок
6-й Котеджний проїзд	6-й Котеджний проїзд
6-й Лутугінський проїзд	6-й Лутугінський проїзд
6-й Малоомелянівський провулок	6-й Малоомелянівський провулок
6-й Налічний провулок	6-й Налічний провулок
6-й Немишлянський в’їзд	6-й Немишлянський вʼїзд
6-й Нижньогиївський узвіз	6-й Нижньогиївський узвіз
6-й Скнилівський провулок	6-й Скнилівський провулок
7-й Котеджний проїзд	7-й Котеджний проїзд
7-й Лутугінський проїзд	7-й Лутугінський проїзд
7-й Малоомелянівський провулок	7-й Малоомелянівський провулок
7-й Налічний провулок	7-й Налічний провулок
7-й Скнилівський провулок	7-й Скнилівський провулок
8-й Балтський провулок	8-й Балтський провулок
8-й Малоомелянівський провулок	8-й Малоомелянівський провулок
8-й Скнилівський провулок	8-й Скнилівський провулок
9-й Скнилівський провулок	9-й Скнилівський провулок