
1-й Авіаторської тупик	1-й тупик Авіаторської
1-й Автомобілістів проїзд	1-й проїзд Автомобілістів
1-й Аптекарської провулок	1-й провулок Аптекарської
1-й Бадаєва провулок	1-й провулок Бадаєва
1-й Берегової провулок	1-й провулок Берегової
1-й Борисівки провулок	1-й провулок Борисівки
1-й Борисяка провулок	1-й провулок Борисяка
1-й Будівельників провулок	1-й провулок Будівельників
1-й Бульбенка провулок	1-й провулок Бульбенка
1-й Вахрамеєва провулок	1-й провулок Вахрамеєва
1-й Верейського проїзд	1-й проїзд Верейського
1-й Весніна провулок	1-й провулок Весніна
1-й Високовича провулок	1-й провулок Високовича
1-й Відпочинку провулок	1-й провулок Відпочинку
1-й Відродження провулок	1-й провулок Відродження
1-й Г.Морозової провулок	1-й провулок Г. Морозової
1-й Г.Морозової проїзд	1-й проїзд Г. Морозової
1-й Декабристів провулок	1-й провулок Декабристів
1-й Джамбула провулок	1-й провулок Джамбула
1-й Дружби провулок	1-й провулок Дружби
1-й Дружби тупик	1-й тупик Дружби
1-й Енергетиків провулок	1-й провулок Енергетиків
1-й Енергетиків проїзд	1-й проїзд Енергетиків
1-й Жилярді в’їзд	1-й вʼїзд Жилярді
1-й Журналістів проїзд	1-й проїзд Журналістів
1-й Загребелля провулок	1-й провулок Загребелля
1-й Злагоди провулок	1-й провулок Злагоди
1-й Зорге провулок	1-й провулок Зорге
1-й Кам’янопотіцької провулок	1-й провулок Камʼянопотіцької
1-й Карасика провулок	1-й провулок Карасика
1-й Ковалевської провулок	1-й провулок Ковалевської
1-й Комінтерну провулок	1-й провулок Комінтерну
1-й Комунарівської провулок	1-й провулок Комунарівської
1-й Константиновича провулок	1-й провулок Константиновича
1-й Константиновича проїзд	1-й проїзд Константиновича
1-й Космонавтів провулок	1-й провулок Космонавтів
1-й Костенюк провулок	1-й провулок Костенюк
1-й Круглицької провулок	1-й провулок Круглицької
1-й Крупської провулок	1-й провулок Крупської
1-й Леваневського провулок	1-й провулок Леваневського
1-й Лідової провулок	1-й провулок Лідової
1-й Макаренко провулок	1-й провулок Макаренко
1-й Максютова провулок	1-й провулок Максютова
1-й Меліораторів проїзд	1-й проїзд Меліораторів
1-й Механізаторів провулок	1-й провулок Механізаторів
1-й Мєчнікова провулок	1-й провулок Мєчнікова
1-й Миру провулок	1-й провулок Миру
1-й Монастирської провулок	1-й провулок Монастирської
1-й Мрії проїзд	1-й проїзд Мрії
1-й Надії провулок	1-й провулок Надії
1-й Незалежності в’їзд	1-й вʼїзд Незалежності
1-й Незалежності провулок	1-й провулок Незалежності
1-й Незнайка провулок	1-й провулок Незнайка
1-й Нової провулок	1-й провулок Нової
1-й Новоселецької провулок	1-й провулок Новоселецької
1-й Орджонікідзе провулок	1-й провулок Орджонікідзе
1-й Осипенко провулок	1-й провулок Осипенко
1-й Перемоги провулок	1-й провулок Перемоги
1-й Північно-Кільцевої провулок	1-й провулок Північно-Кільцевої
1-й Полубудкіна провулок	1-й провулок Полубудкіна
1-й Праці провулок	1-й провулок Праці
1-й Проїзд проїзд	1-й проїзд
1-й Проспект вулиця	вулиця 1-й Проспект
1-й Просужого провулок	1-й провулок Просужого
1-й Раскової провулок	1-й провулок Раскової
1-й Рахматуліна провулок	1-й провулок Рахматуліна
1-й Рятувальників провулок	1-й провулок Рятувальників
1-й Садової провулок	1-й провулок Садової
1-й Сарнавської провулок	1-й провулок Сарнавської
1-й Свободи провулок	1-й провулок Свободи
1-й Східно-дальній провулок	1-й Східно-Дальній провулок
1-й Танкистів провулок	1-й провулок Танкістів
1-й Танкістів провулок	1-й провулок Танкістів
1-й Текстильників провулок	1-й провулок Текстильників
1-й Технологів проїзд	1-й проїзд Технологів
1-й Топольського провулок	1-й провулок Топольського
1-й Трублаїні провулок	1-й провулок Трублаїні
1-й Трутовського провулок	1-й провулок Трутовського
1-й Тупик провулок	провулок 1-й Тупик
1-й Успенсько-Троїцької провулок	1-й провулок Успенсько-Троїцької
1-й Фрунзе провулок	1-й провулок Фрунзе
1-й Харчовиків проїзд	1-й проїзд Харчовиків
1-й Хіміків проїзд	1-й проїзд Хіміків
1-й Цукровиків проїзд	1-й проїзд Цукровиків
1-й Челюскінців в’їзд	1-й вʼїзд Челюскінців
1-й Челюскінців провулок	1-й провулок Челюскінців
1-й Червоногірської провулок	1-й провулок Червоногірської
1-й Чхаїдзе провулок	1-й провулок Чхаїдзе
1-й Штепіна провулок	1-й провулок Штепіна
1-й Щасливої провулок	1-й провулок Щасливої
1-й Юннатів провулок	1-й провулок Юннатів
1-й Юності провулок	1-й провулок Юності
100-й квартал вулиця	вулиця 100-й Квартал
102-й Кілометр вулиця	вулиця 102-й Кілометр
1139-й Кілометр провулок	провулок 1139-й Кілометр
115-й Квартал вулиця	вулиця 115-й Квартал
2-й Автомобілістів проїзд	2-й проїзд Автомобілістів
2-й Аптекарської провулок	2-й провулок Аптекарської
2-й Арзамакіна провулок	2-й провулок Арзамакіна
2-й Артема провулок	2-й провулок Артема
2-й Берегової провулок	2-й провулок Берегової
2-й Борисівки провулок	2-й провулок Борисівки
2-й Будівельників провулок	2-й провулок Будівельників
2-й Бульбенка провулок	2-й провулок Бульбенка
2-й Вахрамеєва провулок	2-й провулок Вахрамеєва
2-й Верейського проїзд	2-й проїзд Верейського
2-й Весніна провулок	2-й провулок Весніна
2-й Відпочинку провулок	2-й провулок Відпочинку
2-й Відродження провулок	2-й провулок Відродження
2-й Г.Морозової провулок	2-й провулок Г. Морозової
2-й Джамбула провулок	2-й провулок Джамбула
2-й Дружби провулок	2-й провулок Дружби
2-й Дружби тупик	2-й тупик Дружби
2-й Енергетиків провулок	2-й провулок Енергетиків
2-й Енергетиків проїзд	2-й проїзд Енергетиків
2-й Ентузіастів провулок	2-й провулок Ентузіастів
2-й Жилярді в’їзд	2-й вʼїзд Жилярді
2-й Журналістів проїзд	2-й проїзд Журналістів
2-й Загребелля провулок	2-й провулок Загребелля
2-й Злагоди провулок	2-й провулок Злагоди
2-й Змагання провулок	2-й провулок Змагання
2-й Зорге провулок	2-й провулок Зорге
2-й Кам’янопотіцької провулок	2-й провулок Камʼянопотіцької
2-й Карасика провулок	2-й провулок Карасика
2-й Кілометр вулиця	вулиця 2-й Кілометр
2-й Ковалевської провулок	2-й провулок Ковалевської
2-й Колачевського провулок	2-й провулок Колачевського
2-й Колгоспної провулок	2-й провулок Колгоспної
2-й Комінтерну провулок	2-й провулок Комінтерну
2-й Костанді провулок	2-й провулок Костанді
2-й Костенюк провулок	2-й провулок Костенюк
2-й Кочмарського провулок	2-й провулок Кочмарського
2-й Круглицької провулок	2-й провулок Круглицької
2-й Крупської провулок	2-й провулок Крупської
2-й Леваневського провулок	2-й провулок Леваневського
2-й Лідової провулок	2-й провулок Лідової
2-й Макаренко провулок	2-й провулок Макаренко
2-й Максютова провулок	2-й провулок Максютова
2-й Меліораторів проїзд	2-й проїзд Меліораторів
2-й Метеорологічної провулок	2-й провулок Метеорологічної
2-й Механізаторів провулок	2-й провулок Механізаторів
2-й Мєчнікова провулок	2-й провулок Мєчнікова
2-й Миру провулок	2-й провулок Миру
2-й Монастирської провулок	2-й провулок Монастирської
2-й Мрії проїзд	2-й проїзд Мрії
2-й Надії провулок	2-й провулок Надії
2-й Надрічної провулок	2-й провулок Надрічної
2-й Незалежності в’їзд	2-й вʼїзд Незалежності
2-й Незалежності провулок	2-й провулок Незалежності
2-й Незнайка провулок	2-й провулок Незнайка
2-й Нової провулок	2-й провулок Нової
2-й Новоселецької провулок	2-й провулок Новоселецької
2-й Олійниці провулок	2-й провулок Олійниці
2-й Орджонікідзе провулок	2-й провулок Орджонікідзе
2-й Осипенко провулок	2-й провулок Осипенко
2-й Перемоги провулок	2-й провулок Перемоги
2-й Північно-Кільцевої провулок	2-й провулок Північно-Кільцевої
2-й Полубудкіна провулок	2-й провулок Полубудкіна
2-й Проїзд проїзд	2-й проїзд
2-й Проспект вулиця	вулиця 2-й Проспект
2-й Просужого провулок	2-й провулок Просужого
2-й Раскової провулок	2-й провулок Раскової
2-й Рахматуліна провулок	2-й провулок Рахматуліна
2-й Ремінця провулок	2-й провулок Ремінця
2-й Річників провулок	2-й провулок Річників
2-й Роменської провулок	2-й провулок Роменської
2-й Рятувальників провулок	2-й провулок Рятувальників
2-й Садової провулок	2-й провулок Садової
2-й Сарнавської провулок	2-й провулок Сарнавської
2-й Свободи провулок	2-й провулок Свободи
2-й Соборної провулок	2-й провулок Соборної
2-й Совнаркома провулок	2-й провулок Совнаркома
2-й Ступіна провулок	2-й провулок Ступіна
2-й Східно-дальній провулок	2-й Східно-Дальній провулок 
2-й Танкистів провулок	2-й провулок Танкістів
2-й Танкістів провулок	2-й провулок Танкістів
2-й Технологів проїзд	2-й проїзд Технологів
2-й Топольського провулок	2-й провулок Топольського
2-й Трублаїні провулок	2-й провулок Трублаїні
2-й Трутовського провулок	2-й провулок Трутовського
2-й Тупик провулок	2-й провулок Тупик
2-й Тургєнєва провулок	2-й провулок Тургєнєва
2-й Успенсько-Троїцької провулок	2-й провулок Успенсько-Троїцької
2-й Фрунзе провулок	2-й провулок Фрунзе
2-й Харчовиків проїзд	2-й проїзд Харчовиків
2-й Хіміків проїзд	2-й проїзд Хіміків
2-й Цукровиків проїзд	2-й проїзд Цукровиків
2-й Челюскінців в’їзд	2-й вʼїзд Челюскінців
2-й Челюскінців провулок	2-й провулок Челюскінців
2-й Червоногірської провулок	2-й провулок Червоногірської
2-й Черепанових провулок	2-й провулок Черепанових
2-й Чхаїдзе провулок	2-й провулок Чхаїдзе
2-й Ширшова провулок	2-й провулок Ширшова
2-й Штепіна провулок	2-й провулок Штепіна
2-й Юннатів провулок	2-й провулок Юннатів
2-й Юності провулок	2-й провулок Юності
3-й Автомобілістів проїзд	3-й проїзд Автомобілістів
3-й Артема провулок	3-й провулок Артема
3-й Берегової провулок	3-й провулок Берегової
3-й Борисівки провулок	3-й провулок Борисівки
3-й Будівельників провулок	3-й провулок Будівельників
3-й Вахрамеєва провулок	3-й провулок Вахрамеєва
3-й Верейського проїзд	3-й проїзд Верейського
3-й Весніна провулок	3-й провулок Весніна
3-й Воїнів-Визволителів провулок	3-й провулок Воїнів-Визволителів
3-й Войкова провулок	3-й провулок Войкова
3-й Г.Морозової провулок	3-й провулок Г. Морозової
3-й Джамбула провулок	3-й провулок Джамбула
3-й Дружби провулок	3-й провулок Дружби
3-й Жилярді в’їзд	3-й вʼїзд Жилярді
3-й Загребелля провулок	3-й провулок Загребелля
3-й Карасика провулок	3-й провулок Карасика
3-й кілометр вулиця	вулиця 3-й кілометр
3-й Комінтерн вулиця	вулиця 3-й Комінтерн
3-й Комінтерну провулок	3-й провулок Комінтерну
3-й Костанді провулок	3-й провулок Костанді
3-й Круглицької провулок	3-й провулок Круглицької
3-й Леваневського провулок	3-й провулок Леваневського
3-й Макаренко провулок	3-й провулок Макаренко
3-й Максютова провулок	3-й провулок Максютова
3-й Механізаторів провулок	3-й провулок Механізаторів
3-й Миру провулок	3-й провулок Миру
3-й Мрії проїзд	3-й проїзд Мрії
3-й Надії провулок	3-й провулок Надії
3-й Надії проїзд	3-й проїзд Надії
3-й Нафтовиків провулок	3-й провулок Нафтовиків
3-й Незалежності провулок	3-й провулок Незалежності
3-й Перемоги провулок	3-й провулок Перемоги
3-й Північно-Кільцевої провулок	3-й провулок Північно-Кільцевої
3-й Праці провулок	3-й провулок Праці
3-й Пригородської провулок	3-й провулок Пригородської
3-й Проїзд проїзд	3-й проїзд
3-й Проспект вулиця	вулиця 3-й Проспект
3-й Просужого провулок	3-й провулок Просужого
3-й Раскової провулок	3-й провулок Раскової
3-й Рятувальників провулок	3-й провулок Рятувальників
3-й Садової провулок	3-й провулок Садової
3-й Свободи провулок	3-й провулок Свободи
3-й Соборної провулок	3-й провулок Соборної
3-й Східно-дальній провулок	3-й Східно-Дальній провулок
3-й Танкистів провулок	3-й провулок Танкістів
3-й Танкістів провулок	3-й провулок Танкістів
3-й Технологів проїзд	3-й проїзд Технологів
3-й Травневої провулок	3-й провулок Травневої
3-й Трутовського провулок	3-й провулок Трутовського
3-й Тупик провулок	провулок 3-й Тупик
3-й Харчовиків проїзд	3-й проїзд Харчовиків
3-й Хіміків проїзд	3-й проїзд Хіміків
3-й Цукровиків проїзд	3-й проїзд Цукровиків
3-й Челюскінців в’їзд	3-й вʼїзд Челюскінців
3-й Черепанових провулок	3-й провулок Черепанових
3-й Ширшова провулок	3-й провулок Ширшова
3-й Штепіна провулок	3-й провулок Штепіна
3-й Юннатів провулок	3-й провулок Юннатів
4-й Автомобілістів проїзд	4-й проїзд Автомобілістів
4-й Артема провулок	4-й провулок Артема
4-й Будівельників провулок	4-й провулок Будівельників
4-й Бульбенка провулок	4-й провулок Бульбенка
4-й Верейського проїзд	4-й проїзд Верейського
4-й Джамбула провулок	4-й провулок Джамбула
4-й Енергетиків проїзд	4-й проїзд Енергетиків
4-й Круглицької провулок	4-й провулок Круглицької
4-й Максютова провулок	4-й провулок Максютова
4-й Мрії проїзд	4-й проїзд Мрії
4-й Перемоги провулок	4-й провулок Перемоги
4-й Пригородської провулок	4-й провулок Пригородської
4-й Раскової провулок	4-й провулок Раскової
4-й Рятувальників провулок	4-й провулок Рятувальників
4-й Сарнавської провулок	4-й провулок Сарнавської
4-й Східно-дальній провулок	4-й Східно-Дальній провулок
4-й Трубіцина проїзд	4-й проїзд Трубіцина
4-й Успенсько-Троїцької провулок	4-й провулок Успенсько-Троїцької
4-й Цукровиків проїзд	4-й проїзд Цукровиків
4-й Челюскінців в’їзд	4-й вʼїзд Челюскінців
4-й Щасливої провулок	4-й провулок Щасливої
4-й Ярмаркової провулок	4-й провулок Ярмаркової
5-й Автомобілістів проїзд	5-й проїзд Автомобілістів
5-й Артема провулок	5-й провулок Артема
5-й Будівельників провулок	5-й провулок Будівельників
5-й Верейського проїзд	5-й проїзд Верейського
5-й Мрії проїзд	5-й проїзд Мрії
5-й Пригородської провулок	5-й провулок Пригородської
5-й Рятувальників провулок	5-й провулок Рятувальників
5-й Сарнавської провулок	5-й провулок Сарнавської
6-й Автомобілістів проїзд	6-й проїзд Автомобілістів
6-й Артема провулок	6-й провулок Артема
6-й Будівельників провулок	6-й провулок Будівельників
6-й Верейського проїзд	6-й проїзд Верейського
6-й Джамбула провулок	6-й провулок Джамбула
6-й Лукіяновича провулок	6-й провулок Лукіяновича
6-й Максютова провулок	6-й провулок Максютова
6-й Мрії проїзд	6-й проїзд Мрії
6-й Пригородської провулок	6-й провулок Пригородської
6-й Рятувальників провулок	6-й провулок Рятувальників
6-й Садовопроїзній провулок	6-й провулок Садовопроїзній
6-й Сарнавської провулок	6-й провулок Сарнавської
7-й Автомобілістів проїзд	7-й проїзд Автомобілістів
7-й Артема провулок	7-й провулок Артема
7-й Верейського проїзд	7-й проїзд Верейського
7-й Максютова провулок	7-й провулок Максютова
7-й Мрії проїзд	7-й проїзд Мрії
7-й Рятувальників провулок	7-й провулок Рятувальників
7-й Сарнавської провулок	7-й провулок Сарнавської
8-й Автомобілістів проїзд	8-й проїзд Автомобілістів
8-й Верейського проїзд	8-й проїзд Верейського
8-й квартал вулиця	вулиця 8-й Квартал
8-й Максютова провулок	8-й провулок Максютова
8-й Мрії проїзд	8-й проїзд Мрії
8-й Рятувальників провулок	8-й провулок Рятувальників
9-й Верейського проїзд	9-й проїзд Верейського
9-й Максютова провулок	9-й провулок Максютова
9-й Мрії проїзд	9-й проїзд Мрії
9-й Проїзд проїзд	9-й проїзд