1 Головний провулок	1-й Головний провулок
1 Загребельний провулок	1-й Загребельний провулок
1 Ірпіньський провулок	1-й Ірпінський провулок
1 Московський провулок	1-й Московський провулок
1 Ніжинський проїзд	1-й Ніжинський проїзд
1 Покровський провулок	1-й Покровський провулок
1 провулок Першотравневий	1-й Першотравневий провулок
1 шахтерский тупик	1-й Шахтарський тупик
1-ий Колгоспний провулок	1-й Колгоспний провулок
1-ий Садовий провулок	1-й Садовий провулок
1-ий Садовий тупик	1-й Садовий тупик
1-й Абрикосовий провулок	1-й Абрикосовий провулок
1-й Авіаційний провулок	1-й Авіаційний провулок
1-й Аграрний тупик	1-й Аграрний тупик
1-й Аеродромний провулок	1-й Аеродромний провулок
1-й Алебастровий провулок	1-й Алебастровий провулок
1-й Амурський провулок	1-й Амурський провулок
1-й Ангарський проїзд	1-й Ангарський проїзд
1-й Андріївський провулок	1-й Андріївський провулок
1-й Аравійський в’їзд	1-й Аравійський вʼїзд
1-й Арктичний провулок	1-й Арктичний провулок
1-й Артилерійський провулок	1-й Артилерійський провулок
1-й Базарний провулок	1-й Базарний провулок
1-й Балтійський провулок	1-й Балтійський провулок
1-й Барвінковий проїзд	1-й Барвінковий проїзд
1-й Басейний провулок	1-й Басейний провулок
1-й Баштанський провулок	1-й Баштанський провулок
1-й Бердичівський провулок	1-й Бердичівський провулок
1-й Береговий провулок	1-й Береговий провулок
1-й Березівський провулок	1-й Березівський провулок
1-й Березовий провулок	1-й Березовий провулок
1-й Березовий проїзд	1-й Березовий проїзд
1-й Бібліотечний тупик	1-й Бібліотечний тупик
1-й Богунський провулок	1-й Богунський провулок
1-й Богунський проїзд	1-й Богунський проїзд
1-й Бойовий провулок	1-й Бойовий провулок
1-й Болгарський провулок	1-й Болгарський провулок
1-й Болгарський проїзд	1-й Болгарський проїзд
1-й Бортницький провулок	1-й Бортницький провулок
1-й Ботанічний провулок	1-й Ботанічний провулок
1-й Братський провулок	1-й Братський провулок
1-й Брестський провулок	1-й Брестський провулок
1-й Бузковий провулок	1-й Бузковий провулок
1-й Бузковий проїзд	1-й Бузковий проїзд
1-й Буковинський провулок	1-й Буковинський провулок
1-й Бульварний провулок	1-й Бульварний провулок
1-й Валовий провулок	1-й Валовий провулок
1-й Варшавський провулок	1-й Варшавський провулок
1-й Вербовий провулок	1-й Вербовий провулок
1-й Верстатний в’їзд	1-й Верстатний вʼїзд
1-й Верхній проїзд	1-й Верхній проїзд
1-й Веселий провулок	1-й Веселий провулок
1-й Весняний провулок	1-й Весняний провулок
1-й Вечірній провулок	1-й Вечірній провулок
1-й Виноградний провулок	1-й Виноградний провулок
1-й Винокурний провулок	1-й Винокурний провулок
1-й Високовольтний в’їзд	1-й Високовольтний вʼїзд
1-й Високогірний проїзд	1-й Високогірний проїзд
1-й Вишневий провулок	1-й Вишневий провулок
1-й Віденський провулок	1-й Віденський провулок
1-й Вільний провулок	1-й Вільний провулок
1-й Вінницький провулок	1-й Вінницький провулок
1-й Вовчанський провулок	1-й Вовчанський провулок
1-й Водопійний провулок	1-й Водопійний провулок
1-й Водопровідний провулок	1-й Водопровідний провулок
1-й Воздвиженський провулок	1-й Воздвиженський провулок
1-й Вокзальний провулок	1-й Вокзальний провулок
1-й Волгоградський провулок	1-й Волгоградський провулок
1-й Волочаївський провулок	1-й Волочаївський провулок
1-й Врожайний проїзд	1-й Врожайний проїзд
1-й Газетний провулок	1-й Газетний провулок
1-й Географічний проїзд	1-й Географічний проїзд
1-й Георгіївський в’їзд	1-й Георгіївський вʼїзд
1-й Гоголівський провулок	1-й Гоголівський провулок
1-й Горіхівський провулок	1-й Горіхівський провулок
1-й Горіховий проїзд	1-й Горіховий проїзд
1-й Горовий провулок	1-й Горовий провулок
1-й Госпітальний провулок	1-й Госпітальний провулок
1-й Гостинний в'їзд	1-й Гостинний вʼїзд
1-й Гранітний провулок	1-й Гранітний провулок
1-й Грідротехнічний проїзд	1-й Грідротехнічний проїзд
1-й Ґданський провулок	1-й Ґданський провулок
1-й Ґданський тупик	1-й Ґданський тупик
1-й Далекий провулок	1-й Далекий провулок
1-й Данилівський провулок	1-й Данилівський провулок
1-й Дачний провулок	1-й Дачний провулок
1-й Деповський провулок	1-й Деповський провулок
1-й Деповський тупик	1-й Деповський тупик
1-й Деревообробний провулок	1-й Деревообробний провулок
1-й Джерельний провулок	1-й Джерельний провулок
1-й Дніпровський провулок	1-й Дніпровський провулок
1-й Дніпровський проїзд	1-й Дніпровський проїзд
1-й Дружний провулок	1-й Дружний провулок
1-й Дунайський провулок	1-й Дунайський провулок
1-й Електронний провулок	1-й Електронний провулок
1-й Електронний проїзд	1-й Електронний проїзд
1-й Житловий провулок	1-й Житловий провулок
1-й Житній провулок	1-й Житній провулок
1-й Житомирський провулок	1-й Житомирський провулок
1-й Жовтневий в’їзд	1-й Жовтневий вʼїзд
1-й Жовтневий провулок	1-й Жовтневий провулок
1-й Заводський провулок	1-й Заводський провулок
1-й Заводський тупик	1-й Заводський тупик
1-й Завокзальний провулок	1-й Завокзальний провулок
1-й Загребельний провулок	1-й Загребельний провулок
1-й Заливний провулок	1-й Заливний провулок
1-й Залізничний провулок	1-й Залізничний провулок
1-й Замковий провулок	1-й Замковий провулок
1-й Заозерний провулок	1-й Заозерний провулок
1-й Зарічний провулок	1-й Зарічний провулок
1-й Затишний тупик	1-й Затишний тупик
1-й Західний провулок	1-й Західний провулок
1-й Збаразький провулок	1-й Збаразький провулок
1-й Звенигородський провулок	1-й Звенигородський провулок
1-й Звенигородський проїзд	1-й Звенигородський проїзд
1-й Звягельський провулок	1-й Звягельський провулок
1-й Зелений провулок	1-й Зелений провулок
1-й Зеленодільський проїзд	1-й Зеленодільський проїзд
1-й Зерновий проїзд	1-й Зерновий проїзд
1-й Зірковий проїзд	1-й Зірковий проїзд
1-й Золотий в’їзд	1-й Золотий вʼїзд
1-й Золочівський провулок	1-й Золочівський провулок
1-й Зоологічний провулок	1-й Зоологічний провулок
1-й Інгульський провулок	1-й Інгульський провулок
1-й Індустріальний провулок	1-й Індустріальний провулок
1-й Індустріальний тупик	1-й Індустріальний тупик
1-й Іподромний провулок	1-й Іподромний провулок
1-й Істомінський провулок	1-й Істомінський провулок
1-й Калинівський провулок	1-й Калинівський провулок
1-й Калиновий провулок	1-й Калиновий провулок
1-й Кам’янецький проїзд	1-й Камʼянецький проїзд
1-й Кар’єрний провулок	1-й Карʼєрний провулок
1-й Карпатський провулок	1-й Карпатський провулок
1-й Карпатський проїзд	1-й Карпатський проїзд
1-й Каховський провулок	1-й Каховський провулок
1-й Каховський проїзд	1-й Каховський проїзд
1-й Каштановий провулок	1-й Каштановий провулок
1-й Каштановий проїзд	1-й Каштановий проїзд
1-й Кварцівський провулок	1-й Кварцівський провулок
1-й Квітковий провулок	1-й Квітковий провулок
1-й Квітневий провулок	1-й Квітневий провулок
1-й Квітучий провулок	1-й Квітучий провулок
1-й Керамічний провулок	1-й Керамічний провулок
1-й Керченський провулок	1-й Керченський провулок
1-й Київський провулок	1-й Київський провулок
1-й Київський проїзд	1-й Київський проїзд
1-й Київський тупик	1-й Київський тупик
1-й Кільцевий провулок	1-й Кільцевий провулок
1-й Кіровський провулок	1-й Кіровський провулок
1-й Кобзарський провулок	1-й Кобзарський провулок
1-й Ковальський провулок	1-й Ковальський провулок
1-й Козацький провулок	1-й Козацький провулок
1-й Колгоспний провулок	1-й Колгоспний провулок
1-й Колективний провулок	1-й Колективний провулок
1-й Комсомольський провулок	1-й Комсомольський провулок
1-й Комсомольський проїзд	1-й Комсомольський проїзд
1-й Комунальний провулок	1-й Комунальний провулок
1-й Комунарський провулок	1-й Комунарський провулок
1-й Кооперативний провулок	1-й Кооперативний провулок
1-й Короткий тупик	1-й Короткий тупик
1-й Кохнівський проїзд	1-й Кохнівський проїзд
1-й Красносільський провулок	1-й Красносільський провулок
1-й Кременецький провулок	1-й Кременецький провулок
1-й Кривий провулок	1-й Кривий провулок
1-й Кримський провулок	1-й Кримський провулок
1-й Кришталевий провулок	1-й Кришталевий провулок
1-й Кронштадтський провулок	1-й Кронштадтський провулок
1-й Круговий провулок	1-й Круговий провулок
1-й Курганний провулок	1-й Курганний провулок
1-й Курортний провулок	1-й Курортний провулок
1-й Курсовий провулок	1-й Курсовий провулок
1-й Кутаїський в’їзд	1-й Кутаїський вʼїзд
1-й Лазурний провулок	1-й Лазурний провулок
1-й Лазьківський в’їзд	1-й Лазьківський вʼїзд
1-й Лановий провулок	1-й Лановий провулок
1-й Ленінський провулок	1-й Ленінський провулок
1-й Ливарний провулок	1-й Ливарний провулок
1-й Ливарний тупик	1-й Ливарний тупик
1-й Липневий проїзд	1-й Липневий проїзд
1-й Лисогірський в’їзд	1-й Лисогірський вʼїзд
1-й Лісний провулок	1-й Лісний провулок
1-й Лісо-Степовий провулок	1-й Лісо-Степовий провулок
1-й Лісовий провулок	1-й Лісовий провулок
1-й Лозовий провулок	1-й Лозовий провулок
1-й Луганський провулок	1-й Луганський провулок
1-й Луговий провулок	1-й Луговий провулок
1-й Луговий проїзд	1-й Луговий проїзд
1-й Лучанський провулок	1-й Лучанський провулок
1-й Лютневий провулок	1-й Лютневий провулок
1-й Майський провулок	1-й Майський провулок
1-й Малий провулок	1-й Малий провулок
1-й Малокохнівський тупик	1-й Малокохнівський тупик
1-й Мар’янівський провулок	1-й Марʼянівський провулок
1-й Маріупольський провулок	1-й Маріупольський провулок
1-й Маячний провулок	1-й Маячний провулок
1-й Медовий провулок	1-й Медовий провулок
1-й Медовий проїзд	1-й Медовий проїзд
1-й Мельничний провулок	1-й Мельничний провулок
1-й Метеорологічний провулок	1-й Метеорологічний провулок
1-й Микільський провулок	1-й Микільський провулок
1-й Миколаївський провулок	1-й Миколаївський провулок
1-й Мирний провулок	1-й Мирний провулок
1-й Мисливський провулок	1-й Мисливський провулок
1-й Михайлівський провулок	1-й Михайлівський провулок
1-й Мінеральний провулок	1-й Мінеральний провулок
1-й Мічуринський провулок	1-й Мічуринський провулок
1-й Молдавський провулок	1-й Молдавський провулок
1-й Молодіжний провулок	1-й Молодіжний провулок
1-й Молодогвардійський провулок	1-й Молодогвардійський провулок
1-й Московський провулок	1-й Московський провулок
1-й Мостовий провулок	1-й Мостовий провулок
1-й Моторний провулок	1-й Моторний провулок
1-й Набережний провулок	1-й Набережний провулок
1-й Набережний тупик	1-й Набережний тупик
1-й Нагірний провулок	1-й Нагірний провулок
1-й Нектарний провулок	1-й Нектарний провулок
1-й Неманський проїзд	1-й Неманський проїзд
1-й Нижній провулок	1-й Нижній провулок
1-й Низовий провулок	1-й Низовий провулок
1-й Ніжинський проїзд	1-й Ніжинський проїзд
1-й Новий провулок	1-й Новий провулок
1-й Новополонський провулок	1-й Новополонський провулок
1-й Новоприміський проїзд	1-й Новоприміський проїзд
1-й Новоселівський провулок	1-й Новоселівський провулок
1-й Овражний провулок	1-й Овражний провулок
1-й Одеський провулок	1-й Одеський провулок
1-й Озерний провулок	1-й Озерний провулок
1-й Озерний тупик	1-й Озерний тупик
1-й Олександрівський провулок	1-й Олександрівський провулок
1-й Олександрійський провулок	1-й Олександрійський провулок
1-й Олексіївський в’їзд	1-й Олексіївський вʼїзд
1-й Омський в’їзд	1-й Омський вʼїзд
1-й Омський провулок	1-й Омський провулок
1-й Онезький проїзд	1-й Онезький проїзд
1-й Орловський проїзд	1-й Орловський проїзд
1-й Осінній провулок	1-й Осінній провулок
1-й Осінній проїзд	1-й Осінній проїзд
1-й Офіцерський провулок	1-й Офіцерський провулок
1-й Охтирський провулок	1-й Охтирський провулок
1-й Парковий провулок	1-й Парковий провулок
1-й Парковий проїзд	1-й Парковий проїзд
1-й Парниковий провулок	1-й Парниковий провулок
1-й Паровозний провулок	1-й Паровозний провулок
1-й Партизанський провулок	1-й Партизанський провулок
1-й Пасічний провулок	1-й Пасічний провулок
1-й Переїзний провулок	1-й Переїзний провулок
1-й Перекопський провулок	1-й Перекопський провулок
1-й Пересипський провулок	1-й Пересипський провулок
1-й Першотравневий провулок	1-й Першотравневий провулок
1-й Петрівський провулок	1-й Петрівський провулок
1-й Петровский тупик	1-й Петровский тупик
1-й Петропавлівський провулок	1-й Петропавлівський провулок
1-й Печерський провулок	1-й Печерський провулок
1-й Південний провулок	1-й Південний провулок
1-й Північний провулок	1-й Північний провулок
1-й Північно-Лінійний провулок	1-й Північно-Лінійний провулок
1-й Північно-Озерний провулок	1-й Північно-Озерний провулок
1-й Підгірний в’їзд	1-й Підгірний вʼїзд
1-й Піонерський провулок	1-й Піонерський провулок
1-й Піщаний в'їзд	1-й Піщаний вʼїзд
1-й Піщаний провулок	1-й Піщаний провулок
1-й Піщаний тупик	1-й Піщаний тупик
1-й Плідний провулок	1-й Плідний провулок
1-й Подолянський провулок	1-й Подолянський провулок
1-й Покровський провулок	1-й Покровський провулок
1-й Поліський провулок	1-й Поліський провулок
1-й Полтавський провулок	1-й Полтавський провулок
1-й Польовий провулок	1-й Польовий провулок
1-й Польовий проїзд	1-й Польовий проїзд
1-й Польський провулок	1-й Польський провулок
1-й Поперечний провулок	1-й Поперечний провулок
1-й Поштовий провулок	1-й Поштовий провулок
1-й Поштовий тупик	1-й Поштовий тупик
1-й Приамурський провулок	1-й Приамурський провулок
1-й Прибережний провулок	1-й Прибережний провулок
1-й Прибузький провулок	1-й Прибузький провулок
1-й Приморський провулок	1-й Приморський провулок
1-й Приорільський провулок	1-й Приорільський провулок
1-й Проїзний провулок	1-й Проїзний провулок
1-й Пролетарський провулок	1-й Пролетарський провулок
1-й Пролісковий проїзд	1-й Пролісковий проїзд
1-й Промисловий провулок	1-й Промисловий провулок
1-й Прорізний провулок	1-й Прорізний провулок
1-й Радіальний провулок	1-й Радіальний провулок
1-й Радянський провулок	1-й Радянський провулок
1-й Райгородський провулок	1-й Райгородський провулок
1-й Революційний провулок	1-й Революційний провулок
1-й Республіканський провулок	1-й Республіканський провулок
1-й Рибінський тупик	1-й Рибінський тупик
1-й Рівний провулок	1-й Рівний провулок
1-й Річковий провулок	1-й Річковий провулок
1-й Річний провулок	1-й Річний провулок
1-й Робітничий провулок	1-й Робітничий провулок
1-й Робочий провулок	1-й Робочий провулок
1-й Рогатинський провулок	1-й Рогатинський провулок
1-й Рогизнянський провулок	1-й Рогизнянський провулок
1-й Рожевий проїзд	1-й Рожевий проїзд
1-й Роздільний провулок	1-й Роздільний провулок
1-й Рокитнянський провулок	1-й Рокитнянський провулок
1-й Романківський провулок	1-й Романківський провулок
1-й Ромашковий проїзд	1-й Ромашковий проїзд
1-й Роменський в’їзд	1-й Роменський вʼїзд
1-й Рудниковий провулок	1-й Рудниковий провулок
1-й Руднянський провулок	1-й Руднянський провулок
1-й Садівничий проїзд	1-й Садівничий проїзд
1-й Садовий провулок	1-й Садовий провулок
1-й Самаркандський в’їзд	1-й Самаркандський вʼїзд
1-й Санаторний провулок	1-й Санаторний провулок
1-й Свято-Миколаївська провулок	1-й Свято-Миколаївська провулок
1-й Святошинський провулок	1-й Святошинський провулок
1-й Севастопольський провулок	1-й Севастопольський провулок
1-й Селянський провулок	1-й Селянський провулок
1-й Семенівський провулок	1-й Семенівський провулок
1-й Силікатний провулок	1-й Силікатний провулок
1-й Сичівський в’їзд	1-й Сичівський вʼїзд
1-й Сінний провулок	1-й Сінний провулок
1-й Скіфський провулок	1-й Скіфський провулок
1-й Слов’янський провулок	1-й Словʼянський провулок
1-й Смілянський провулок	1-й Смілянський провулок
1-й Смолянський провулок	1-й Смолянський провулок
1-й Соборний провулок	1-й Соборний провулок
1-й Соколовський провулок	1-й Соколовський провулок
1-й Солонцюватий провулок	1-й Солонцюватий провулок
1-й Соляний провулок	1-й Соляний провулок
1-й Сонячний провулок	1-й Сонячний провулок
1-й Сосновий провулок	1-й Сосновий провулок
1-й Софіївський провулок	1-й Софіївський провулок
1-й Сочинський провулок	1-й Сочинський провулок
1-й Спартаківський провулок	1-й Спартаківський провулок
1-й Спасо-Преображенський провулок	1-й Спасо-Преображенський провулок
1-й Спаський проїзд	1-й Спаський проїзд
1-й Старокиївський провулок	1-й Старокиївський провулок
1-й Старокиївський проїзд	1-й Старокиївський проїзд
1-й Стаханівський провулок	1-й Стаханівський провулок
1-й Стахановський провулок	1-й Стахановський провулок
1-й Степовий провулок	1-й Степовий провулок
1-й Стрийський провулок	1-й Стрийський провулок
1-й Стрілецький в’їзд	1-й Стрілецький вʼїзд
1-й Студентський провулок	1-й Студентський провулок
1-й Сумський провулок	1-й Сумський провулок
1-й Східний провулок	1-й Східний провулок
1-й Таврійський провулок	1-й Таврійський провулок
1-й Таганський провулок	1-й Таганський провулок
1-й Танковий проїзд	1-й Танковий проїзд
1-й Театральний провулок	1-й Театральний провулок
1-й Тепличний провулок	1-й Тепличний провулок
1-й Терновий провулок	1-й Терновий провулок
1-й Тетерівський провулок	1-й Тетерівський провулок
1-й Товариський провулок	1-й Товариський провулок
1-й Товариський проїзд	1-й Товариський проїзд
1-й Топольний провулок	1-й Топольний провулок
1-й Тракторний провулок	1-й Тракторний провулок
1-й Трамвайний провулок	1-й Трамвайний провулок
1-й Транзитний провулок	1-й Транзитний провулок
1-й Трипільський провулок	1-й Трипільський провулок
1-й Троїцький провулок	1-й Троїцький провулок
1-й Трояндовий провулок	1-й Трояндовий провулок
1-й Трубний провулок	1-й Трубний провулок
1-й Трудовий провулок	1-й Трудовий провулок
1-й Тупиковий провулок	1-й Тупиковий провулок
1-й Тясминський провулок	1-й Тясминський провулок
1-й Ударний провулок	1-й Ударний провулок
1-й Удянський в’їзд	1-й Удянський вʼїзд
1-й Український провулок	1-й Український провулок
1-й Уманський провулок	1-й Уманський провулок
1-й Упорний провулок	1-й Упорний провулок
1-й Успенський провулок	1-й Успенський провулок
1-й Учительський провулок	1-й Учительський провулок
1-й Фабричний провулок	1-й Фабричний провулок
1-й Фіалковий провулок	1-й Фіалковий провулок
1-й Фізкультурний провулок	1-й Фізкультурний провулок
1-й Фруктовий провулок	1-й Фруктовий провулок
1-й Харківський провулок	1-й Харківський провулок
1-й Хвойний провулок	1-й Хвойний провулок
1-й Хімічний провулок	1-й Хімічний провулок
1-й Хлібний провулок	1-й Хлібний провулок
1-й Хмельовий провулок	1-й Хмельовий провулок
1-й Хорольський тупик	1-й Хорольський тупик
1-й Хотинський провулок	1-й Хотинський провулок
1-й Хуторський проїзд	1-й Хуторський проїзд
1-й Цегельний провулок	1-й Цегельний провулок
1-й Центральний провулок	1-й Центральний провулок
1-й Цимлянський тупик	1-й Цимлянський тупик
1-й Чапаєвський провулок	1-й Чапаєвський провулок
1-й Червоний провулок	1-й Червоний провулок
1-й Червоноармійський провулок	1-й Червоноармійський провулок
1-й Червонопрапорний тупик	1-й Червонопрапорний тупик
1-й Червоностудентський провулок	1-й Червоностудентський провулок
1-й Черемховий проїзд	1-й Черемховий проїзд
1-й Черемшиновий провулок	1-й Черемшиновий провулок
1-й Чернігівський провулок	1-й Чернігівський провулок
1-й Чигиринський провулок	1-й Чигиринський провулок
1-й Чоботарський в’їзд	1-й Чоботарський вʼїзд
1-й Чорнобаївський провулок	1-й Чорнобаївський провулок
1-й Чорноморський провулок	1-й Чорноморський провулок
1-й Чугуївський в’їзд	1-й Чугуївський вʼїзд
1-й Чугуївський провулок	1-й Чугуївський провулок
1-й Чумацький провулок	1-й Чумацький провулок
1-й Чумацький проїзд	1-й Чумацький проїзд
1-й Шахтарський тупик	1-й Шахтарський тупик
1-й Шевченківський провулок	1-й Шевченківський провулок
1-й Шипинський провулок	1-й Шипинський провулок
1-й Широкий провулок	1-й Широкий провулок
1-й Шкільний провулок	1-й Шкільний провулок
1-й Шовковичний в’їзд	1-й Шовковичний вʼїзд
1-й Шосейний провулок	1-й Шосейний провулок
1-й Щасливий провулок	1-й Щасливий провулок
1-й Щедрий провулок	1-й Щедрий провулок
1-й Ювілейний провулок	1-й Ювілейний провулок
1-й Яблуневий провулок	1-й Яблуневий провулок
1-й Ягідний проїзд	1-й Ягідний проїзд
1-й Ялтинський провулок	1-й Ялтинський провулок
1-й Ярмарковий провулок	1-й Ярмарковий провулок
1-й Ясеновий провулок	1-й Ясеновий провулок
1-й Яснополянський провулок	1-й Яснополянський провулок
10-й Аеродромний проїзд	10-й Аеродромний проїзд
10-й Дачний провулок	10-й Дачний провулок
10-й Заярний провулок	10-й Заярний провулок
10-й Каштановий провулок	10-й Каштановий провулок
10-й Ленінський провулок	10-й Ленінський провулок
10-й Озерний провулок	10-й Озерний провулок
10-й Північно-Озерний провулок	10-й Північно-Озерний провулок
10-й Піонерський провулок	10-й Піонерський провулок
10-й Січовий проїзд	10-й Січовий проїзд
10-й Софіївський проїзд	10-й Софіївський проїзд
10-й Тракторний провулок	10-й Тракторний провулок
10-й Хорольський тупик	10-й Хорольський тупик
11-й Аеродромний провулок	11-й Аеродромний провулок
11-й Дачний провулок	11-й Дачний провулок
11-й Ленінський провулок	11-й Ленінський провулок
11-й Північно-Озерний провулок	11-й Північно-Озерний провулок
11-й Січовий проїзд	11-й Січовий проїзд
11-й Софіївський проїзд	11-й Софіївський проїзд
11-й Чорноморський провулок	11-й Чорноморський провулок
12-й Аеродромний провулок	12-й Аеродромний провулок
12-й Ленінський провулок	12-й Ленінський провулок
12-й Січовий проїзд	12-й Січовий проїзд
12-й Чорноморський провулок	12-й Чорноморський провулок
13-й Аеродромний провулок	13-й Аеродромний провулок
13-й Чорноморський провулок	13-й Чорноморський провулок
14-й Аеродромний провулок	14-й Аеродромний провулок
17-й Польовий провулок	17-й Польовий провулок
18-й Польовий провулок	18-й Польовий провулок
19-й Польовий провулок	19-й Польовий провулок
2-й Авіаційний провулок	2-й Авіаційний провулок
2-й Аграрний тупик	2-й Аграрний тупик
2-й Аеродромний провулок	2-й Аеродромний провулок
2-й Алебастровий провулок	2-й Алебастровий провулок
2-й Ангарський проїзд	2-й Ангарський проїзд
2-й Андріївський провулок	2-й Андріївський провулок
2-й Аравійський в’їзд	2-й Аравійський вʼїзд
2-й Арктичний провулок	2-й Арктичний провулок
2-й Артилерійський провулок	2-й Артилерійський провулок
2-й Базарний провулок	2-й Базарний провулок
2-й Банний провулок	2-й Банний провулок
2-й Барвінковий проїзд	2-й Барвінковий проїзд
2-й Басейний провулок	2-й Басейний провулок
2-й Баштанський провулок	2-й Баштанський провулок
2-й Бердичівський провулок	2-й Бердичівський провулок
2-й Береговий провулок	2-й Береговий провулок
2-й Березовий провулок	2-й Березовий провулок
2-й Березовий проїзд	2-й Березовий проїзд
2-й Бібліотечний тупик	2-й Бібліотечний тупик
2-й Благовіщенський провулок	2-й Благовіщенський провулок
2-й Богунський провулок	2-й Богунський провулок
2-й Богунський проїзд	2-й Богунський проїзд
2-й Бойовий провулок	2-й Бойовий провулок
2-й Болгарський провулок	2-й Болгарський провулок
2-й Болгарський проїзд	2-й Болгарський проїзд
2-й Бортницький провулок	2-й Бортницький провулок
2-й Ботанічний провулок	2-й Ботанічний провулок
2-й Братиславський провулок	2-й Братиславський провулок
2-й Братський провулок	2-й Братський провулок
2-й Братський проїзд	2-й Братський проїзд
2-й Брестський провулок	2-й Брестський провулок
2-й Будівельний в’їзд	2-й Будівельний вʼїзд
2-й Будівельний провулок	2-й Будівельний провулок
2-й Бузковий провулок	2-й Бузковий провулок
2-й Бузковий проїзд	2-й Бузковий проїзд
2-й Бульварний провулок	2-й Бульварний провулок
2-й Валовий провулок	2-й Валовий провулок
2-й Варшавський провулок	2-й Варшавський провулок
2-й Верстатний в’їзд	2-й Верстатний вʼїзд
2-й Веселий провулок	2-й Веселий провулок
2-й Весняний провулок	2-й Весняний провулок
2-й Вечірній провулок	2-й Вечірній провулок
2-й Виноградний провулок	2-й Виноградний провулок
2-й Винокурний провулок	2-й Винокурний провулок
2-й Високовольтний в’їзд	2-й Високовольтний вʼїзд
2-й Високогірний проїзд	2-й Високогірний проїзд
2-й Вишневий провулок	2-й Вишневий провулок
2-й Віденський провулок	2-й Віденський провулок
2-й Вільний провулок	2-й Вільний провулок
2-й Вінницький провулок	2-й Вінницький провулок
2-й Вовчанський провулок	2-й Вовчанський провулок
2-й Водопійний провулок	2-й Водопійний провулок
2-й Водопровідний провулок	2-й Водопровідний провулок
2-й Воздвиженський провулок	2-й Воздвиженський провулок
2-й Вокзальний провулок	2-й Вокзальний провулок
2-й Волгоградський провулок	2-й Волгоградський провулок
2-й Вологодський в’їзд	2-й Вологодський вʼїзд
2-й Георгіївський в’їзд	2-й Георгіївський вʼїзд
2-й Гетьманський провулок	2-й Гетьманський провулок
2-й Гірський провулок	2-й Гірський провулок
2-й Гоголівський провулок	2-й Гоголівський провулок
2-й Головний провулок	2-й Головний провулок
2-й Горіхівський провулок	2-й Горіхівський провулок
2-й Горіховий провулок	2-й Горіховий провулок
2-й Горіховий проїзд	2-й Горіховий проїзд
2-й Горовий провулок	2-й Горовий провулок
2-й Городній провулок	2-й Городній провулок
2-й Госпітальний провулок	2-й Госпітальний провулок
2-й Гранітний провулок	2-й Гранітний провулок
2-й Ґданський провулок	2-й Ґданський провулок
2-й Ґданський тупик	2-й Ґданський тупик
2-й Далекий проїзд	2-й Далекий проїзд
2-й Данилівський провулок	2-й Данилівський провулок
2-й Дачний провулок	2-й Дачний провулок
2-й Дворцовий провулок	2-й Дворцовий провулок
2-й Деповський в’їзд	2-й Деповський вʼїзд
2-й Деповський провулок	2-й Деповський провулок
2-й Деповський тупик	2-й Деповський тупик
2-й Деревообробний провулок	2-й Деревообробний провулок
2-й Дніпровський провулок	2-й Дніпровський провулок
2-й Дніпровський проїзд	2-й Дніпровський проїзд
2-й Донецький провулок	2-й Донецький провулок
2-й Дружний провулок	2-й Дружний провулок
2-й Дубовецький провулок	2-й Дубовецький провулок
2-й Дунайський провулок	2-й Дунайський провулок
2-й Електронний провулок	2-й Електронний провулок
2-й Житловий провулок	2-й Житловий провулок
2-й Житній провулок	2-й Житній провулок
2-й Житомирський провулок	2-й Житомирський провулок
2-й Жовтневий в’їзд	2-й Жовтневий вʼїзд
2-й Жовтневий провулок	2-й Жовтневий провулок
2-й Журавлівський в’їзд	2-й Журавлівський вʼїзд
2-й Заводський провулок	2-й Заводський провулок
2-й Заводський тупик	2-й Заводський тупик
2-й Завокзальний провулок	2-й Завокзальний провулок
2-й Загребельний провулок	2-й Загребельний провулок
2-й Залізничний провулок	2-й Залізничний провулок
2-й Замковий провулок	2-й Замковий провулок
2-й Заозерний провулок	2-й Заозерний провулок
2-й Запорізький провулок	2-й Запорізький провулок
2-й Зарічний провулок	2-й Зарічний провулок
2-й Затишний тупик	2-й Затишний тупик
2-й Західний провулок	2-й Західний провулок
2-й Збаразький провулок	2-й Збаразький провулок
2-й Звенигородський проїзд	2-й Звенигородський проїзд
2-й Звягельський провулок	2-й Звягельський провулок
2-й Зелений провулок	2-й Зелений провулок
2-й Зеленодільський проїзд	2-й Зеленодільський проїзд
2-й Земний провулок	2-й Земний провулок
2-й Зерновий проїзд	2-й Зерновий проїзд
2-й Зінцевий провулок	2-й Зінцевий провулок
2-й Зірковий проїзд	2-й Зірковий проїзд
2-й Златопільський провулок	2-й Златопільський провулок
2-й Золотий в’їзд	2-й Золотий вʼїзд
2-й Золотий провулок	2-й Золотий провулок
2-й Золочівський провулок	2-й Золочівський провулок
2-й Ізюмський провулок	2-й Ізюмський провулок
2-й Інгульський провулок	2-й Інгульський провулок
2-й Індустріальний провулок	2-й Індустріальний провулок
2-й Індустріальний тупик	2-й Індустріальний тупик
2-й Іподромний провулок	2-й Іподромний провулок
2-й Ісаївський в’їзд	2-й Ісаївський вʼїзд
2-й Істомінський провулок	2-й Істомінський провулок
2-й Кавказький проїзд	2-й Кавказький проїзд
2-й Калиновий провулок	2-й Калиновий провулок
2-й Кам’янецький проїзд	2-й Камʼянецький проїзд
2-й Кар’єрний провулок	2-й Карʼєрний провулок
2-й Карпатський провулок	2-й Карпатський провулок
2-й Карпатський проїзд	2-й Карпатський проїзд
2-й Каховський провулок	2-й Каховський провулок
2-й Каштановий провулок	2-й Каштановий провулок
2-й Каштановий проїзд	2-й Каштановий проїзд
2-й Кварцівський провулок	2-й Кварцівський провулок
2-й Квітневий провулок	2-й Квітневий провулок
2-й Квітучий провулок	2-й Квітучий провулок
2-й Керамічний провулок	2-й Керамічний провулок
2-й Керченський провулок	2-й Керченський провулок
2-й Київський провулок	2-й Київський провулок
2-й Кільцевий провулок	2-й Кільцевий провулок
2-й Клубний провулок	2-й Клубний провулок
2-й Кобзарський провулок	2-й Кобзарський провулок
2-й Ковальський провулок	2-й Ковальський провулок
2-й Козацький в’їзд	2-й Козацький вʼїзд
2-й Козацький провулок	2-й Козацький провулок
2-й Колгоспний провулок	2-й Колгоспний провулок
2-й Колективний провулок	2-й Колективний провулок
2-й Комсомольський провулок	2-й Комсомольський провулок
2-й Комунальний провулок	2-й Комунальний провулок
2-й Кооперативний провулок	2-й Кооперативний провулок
2-й Короткий тупик	2-й Короткий тупик
2-й Кохнівський проїзд	2-й Кохнівський проїзд
2-й Краснодарський провулок	2-й Краснодарський провулок
2-й Красносільський провулок	2-й Красносільський провулок
2-й Кременецький провулок	2-й Кременецький провулок
2-й Кривий провулок	2-й Кривий провулок
2-й Криворізький провулок	2-й Криворізький провулок
2-й Кримський провулок	2-й Кримський провулок
2-й Кришталевий провулок	2-й Кришталевий провулок
2-й Кронштадтський провулок	2-й Кронштадтський провулок
2-й Круговий провулок	2-й Круговий провулок
2-й Куликовський провулок	2-й Куликовський провулок
2-й Курганний провулок	2-й Курганний провулок
2-й Курортний провулок	2-й Курортний провулок
2-й Курсовий провулок	2-й Курсовий провулок
2-й Кустанайський провулок	2-й Кустанайський провулок
2-й Кутаїський в’їзд	2-й Кутаїський вʼїзд
2-й Лазурний провулок	2-й Лазурний провулок
2-й Лазьківський в’їзд	2-й Лазьківський вʼїзд
2-й Лановий провулок	2-й Лановий провулок
2-й Ленінський провулок	2-й Ленінський провулок
2-й Лермонтовський провулок	2-й Лермонтовський провулок
2-й Ливарний провулок	2-й Ливарний провулок
2-й Лиманний провулок	2-й Лиманний провулок
2-й Липневий проїзд	2-й Липневий проїзд
2-й Лисогірський в’їзд	2-й Лисогірський вʼїзд
2-й Литовський провулок	2-й Литовський провулок
2-й Лікарський провулок	2-й Лікарський провулок
2-й Лінійний провулок	2-й Лінійний провулок
2-й Лісо-Степовий провулок	2-й Лісо-Степовий провулок
2-й Лісовий провулок	2-й Лісовий провулок
2-й Луговий провулок	2-й Луговий провулок
2-й Луговий проїзд	2-й Луговий проїзд
2-й Лутугинський проїзд	2-й Лутугинський проїзд
2-й Лучанський провулок	2-й Лучанський провулок
2-й Львівський провулок	2-й Львівський провулок
2-й Лютневий провулок	2-й Лютневий провулок
2-й Майський провулок	2-й Майський провулок
2-й Макіївський в’їзд	2-й Макіївський вʼїзд
2-й Малогорошківський провулок	2-й Малогорошківський провулок
2-й Малокохнівський тупик	2-й Малокохнівський тупик
2-й Мар’янівський провулок	2-й Марʼянівський провулок
2-й Маріупольський провулок	2-й Маріупольський провулок
2-й Маріупольський проїзд	2-й Маріупольський проїзд
2-й Маячний провулок	2-й Маячний провулок
2-й Медовий провулок	2-й Медовий провулок
2-й Медовий проїзд	2-й Медовий проїзд
2-й Мельничний провулок	2-й Мельничний провулок
2-й Метеорологічний провулок	2-й Метеорологічний провулок
2-й Микільський провулок	2-й Микільський провулок
2-й Миколаївський провулок	2-й Миколаївський провулок
2-й Мирний провулок	2-й Мирний провулок
2-й Мисливський провулок	2-й Мисливський провулок
2-й Михайлівський провулок	2-й Михайлівський провулок
2-й Мінеральний провулок	2-й Мінеральний провулок
2-й Мічурінський провулок	2-й Мічурінський провулок
2-й Молдавський провулок	2-й Молдавський провулок
2-й Молодіжний провулок	2-й Молодіжний провулок
2-й Молодогвардійський провулок	2-й Молодогвардійський провулок
2-й Морський провулок	2-й Морський провулок
2-й Мостовий провулок	2-й Мостовий провулок
2-й Моторний провулок	2-й Моторний провулок
2-й Набережний провулок	2-й Набережний провулок
2-й Набережний тупик	2-й Набережний тупик
2-й Нагірний провулок	2-й Нагірний провулок
2-й Нектарний провулок	2-й Нектарний провулок
2-й Неманський проїзд	2-й Неманський проїзд
2-й Нижній провулок	2-й Нижній провулок
2-й Ніжинський проїзд	2-й Ніжинський проїзд
2-й Новоприміський проїзд	2-й Новоприміський проїзд
2-й Новоселівський провулок	2-й Новоселівський провулок
2-й Ногайський провулок	2-й Ногайський провулок
2-й Овражний провулок	2-й Овражний провулок
2-й Одеський провулок	2-й Одеський провулок
2-й Озерний провулок	2-й Озерний провулок
2-й Олександрівський провулок	2-й Олександрівський провулок
2-й Олександрійський провулок	2-й Олександрійський провулок
2-й Олексіївський в’їзд	2-й Олексіївський вʼїзд
2-й Омський в’їзд	2-й Омський вʼїзд
2-й Омський провулок	2-й Омський провулок
2-й Онезький проїзд	2-й Онезький проїзд
2-й Орловський проїзд	2-й Орловський проїзд
2-й Орський провулок	2-й Орський провулок
2-й Осінній провулок	2-й Осінній провулок
2-й Офіцерський провулок	2-й Офіцерський провулок
2-й Охтирський провулок	2-й Охтирський провулок
2-й Парковий провулок	2-й Парковий провулок
2-й Парковий проїзд	2-й Парковий проїзд
2-й Парниковий провулок	2-й Парниковий провулок
2-й Паровозний провулок	2-й Паровозний провулок
2-й Партизанський провулок	2-й Партизанський провулок
2-й Пасічний провулок	2-й Пасічний провулок
2-й Перекопський провулок	2-й Перекопський провулок
2-й Першотравневий провулок	2-й Першотравневий провулок
2-й Петрівський провулок	2-й Петрівський провулок
2-й Петровский тупик	2-й Петровский тупик
2-й Печерський провулок	2-й Печерський провулок
2-й Південний провулок	2-й Південний провулок
2-й Північний провулок	2-й Північний провулок
2-й Північний тупик	2-й Північний тупик
2-й Північно-Лінійний провулок	2-й Північно-Лінійний провулок
2-й Північно-Озерний провулок	2-й Північно-Озерний провулок
2-й Підгірний в’їзд	2-й Підгірний вʼїзд
2-й Піонерський провулок	2-й Піонерський провулок
2-й Пісочний провулок	2-й Пісочний провулок
2-й Піщаний в'їзд	2-й Піщаний вʼїзд
2-й Піщаний провулок	2-й Піщаний провулок
2-й Піщаний тупик	2-й Піщаний тупик
2-й Подолянський провулок	2-й Подолянський провулок
2-й Покровський провулок	2-й Покровський провулок
2-й Поліський провулок	2-й Поліський провулок
2-й Полтавський провулок	2-й Полтавський провулок
2-й Польовий в’їзд	2-й Польовий вʼїзд
2-й Польовий провулок	2-й Польовий провулок
2-й Польський провулок	2-й Польський провулок
2-й Поперечний провулок	2-й Поперечний провулок
2-й Поштовий провулок	2-й Поштовий провулок
2-й Поштовий тупик	2-й Поштовий тупик
2-й Приамурський провулок	2-й Приамурський провулок
2-й Прибережний провулок	2-й Прибережний провулок
2-й Прибузький провулок	2-й Прибузький провулок
2-й Приморський провулок	2-й Приморський провулок
2-й Приорільський провулок	2-й Приорільський провулок
2-й Проїзний провулок	2-й Проїзний провулок
2-й Пролетарський провулок	2-й Пролетарський провулок
2-й Променевий провулок	2-й Променевий провулок
2-й Прорізний провулок	2-й Прорізний провулок
2-й Радгоспний провулок	2-й Радгоспний провулок
2-й Радіальний провулок	2-й Радіальний провулок
2-й Радіотехнічний провулок	2-й Радіотехнічний провулок
2-й Радянський провулок	2-й Радянський провулок
2-й Райгородський провулок	2-й Райгородський провулок
2-й Райгородський проїзд	2-й Райгородський проїзд
2-й Ракетний провулок	2-й Ракетний провулок
2-й Революційний провулок	2-й Революційний провулок
2-й Рибінський тупик	2-й Рибінський тупик
2-й Річковий провулок	2-й Річковий провулок
2-й Річний провулок	2-й Річний провулок
2-й Робітничий провулок	2-й Робітничий провулок
2-й Робочий провулок	2-й Робочий провулок
2-й Рогатинський провулок	2-й Рогатинський провулок
2-й Рогізнянський провулок	2-й Рогізнянський провулок
2-й Рожевий проїзд	2-й Рожевий проїзд
2-й Рокитнянський провулок	2-й Рокитнянський провулок
2-й Романківський провулок	2-й Романківський провулок
2-й Ромашковий проїзд	2-й Ромашковий проїзд
2-й Роменський в’їзд	2-й Роменський вʼїзд
2-й Рудниковий провулок	2-й Рудниковий провулок
2-й Руднянський провулок	2-й Руднянський провулок
2-й Садівничий проїзд	2-й Садівничий проїзд
2-й Садовий провулок	2-й Садовий провулок
2-й Самаркандський в’їзд	2-й Самаркандський вʼїзд
2-й Санаторний провулок	2-й Санаторний провулок
2-й Свято-Миколаївська провулок	2-й Свято-Миколаївська провулок
2-й Свято-Миколаївський провулок	2-й Свято-Миколаївський провулок
2-й Святошинський провулок	2-й Святошинський провулок
2-й Севастопольський провулок	2-й Севастопольський провулок
2-й Селецький провулок	2-й Селецький провулок
2-й Семенівський провулок	2-й Семенівський провулок
2-й Силікатний провулок	2-й Силікатний провулок
2-й Сичівський в’їзд	2-й Сичівський вʼїзд
2-й Сінний провулок	2-й Сінний провулок
2-й Скіфський провулок	2-й Скіфський провулок
2-й Слов’янський провулок	2-й Словʼянський провулок
2-й Смілянський провулок	2-й Смілянський провулок
2-й Смолянський провулок	2-й Смолянський провулок
2-й Соборний провулок	2-й Соборний провулок
2-й Сокільницький в’їзд	2-й Сокільницький вʼїзд
2-й Соколовський провулок	2-й Соколовський провулок
2-й Соляний провулок	2-й Соляний провулок
2-й Сонячний провулок	2-й Сонячний провулок
2-й Сосновий провулок	2-й Сосновий провулок
2-й Софіївський провулок	2-й Софіївський провулок
2-й Сочинський провулок	2-й Сочинський провулок
2-й Спартаківський провулок	2-й Спартаківський провулок
2-й Спаський проїзд	2-й Спаський проїзд
2-й Старо-Кримський провулок	2-й Старо-Кримський провулок
2-й Старокиївський провулок	2-й Старокиївський провулок
2-й Старокиївський проїзд	2-й Старокиївський проїзд
2-й Старопоштовий провулок	2-й Старопоштовий провулок
2-й Стаханівський провулок	2-й Стаханівський провулок
2-й Стахановський провулок	2-й Стахановський провулок
2-й Степовий провулок	2-й Степовий провулок
2-й Стрийський провулок	2-й Стрийський провулок
2-й Стрілецький в’їзд	2-й Стрілецький вʼїзд
2-й Студентський провулок	2-й Студентський провулок
2-й Сумський провулок	2-й Сумський провулок
2-й Східний провулок	2-й Східний провулок
2-й Таборовий провулок	2-й Таборовий провулок
2-й Таврійський провулок	2-й Таврійський провулок
2-й Таганський провулок	2-й Таганський провулок
2-й Танковий проїзд	2-й Танковий проїзд
2-й Театральний провулок	2-й Театральний провулок
2-й Тепличний провулок	2-й Тепличний провулок
2-й Тетерівський провулок	2-й Тетерівський провулок
2-й Тираспольський провулок	2-й Тираспольський провулок
2-й Тихий провулок	2-й Тихий провулок
2-й Товариський проїзд	2-й Товариський проїзд
2-й Топольний провулок	2-й Топольний провулок
2-й Тракторний провулок	2-й Тракторний провулок
2-й Трамвайний провулок	2-й Трамвайний провулок
2-й Транзитний провулок	2-й Транзитний провулок
2-й Трипільський провулок	2-й Трипільський провулок
2-й Троїцький провулок	2-й Троїцький провулок
2-й Трояндовий провулок	2-й Трояндовий провулок
2-й Трубний провулок	2-й Трубний провулок
2-й Тупиковий провулок	2-й Тупиковий провулок
2-й Тупіковий провулок	2-й Тупіковий провулок
2-й Тясминський провулок	2-й Тясминський провулок
2-й Ударний провулок	2-й Ударний провулок
2-й Удянський в’їзд	2-й Удянський вʼїзд
2-й Український провулок	2-й Український провулок
2-й Український проїзд	2-й Український проїзд
2-й Уманський провулок	2-й Уманський провулок
2-й Університетський провулок	2-й Університетський провулок
2-й Упорний провулок	2-й Упорний провулок
2-й Усівський в’їзд	2-й Усівський вʼїзд
2-й Успенський провулок	2-й Успенський провулок
2-й Учительський провулок	2-й Учительський провулок
2-й Фабричний провулок	2-й Фабричний провулок
2-й Фіалковий провулок	2-й Фіалковий провулок
2-й Фізкультурний провулок	2-й Фізкультурний провулок
2-й Фруктовий провулок	2-й Фруктовий провулок
2-й Харківський провулок	2-й Харківський провулок
2-й Хвойний провулок	2-й Хвойний провулок
2-й Хімічний провулок	2-й Хімічний провулок
2-й Хмельовий провулок	2-й Хмельовий провулок
2-й Хорольський тупик	2-й Хорольський тупик
2-й Хотинський провулок	2-й Хотинський провулок
2-й Хуторський проїзд	2-й Хуторський проїзд
2-й Центральний провулок	2-й Центральний провулок
2-й Цимлянський тупик	2-й Цимлянський тупик
2-й Чапаєвський провулок	2-й Чапаєвський провулок
2-й Червоний провулок	2-й Червоний провулок
2-й Червоноармійський провулок	2-й Червоноармійський провулок
2-й Червонопрапорний тупик	2-й Червонопрапорний тупик
2-й Червоностудентський провулок	2-й Червоностудентський провулок
2-й Червонофлотський провулок	2-й Червонофлотський провулок
2-й Черемховий проїзд	2-й Черемховий проїзд
2-й Черемшиновий провулок	2-й Черемшиновий провулок
2-й Чигиринський провулок	2-й Чигиринський провулок
2-й Чоботарський в’їзд	2-й Чоботарський вʼїзд
2-й Чорнобаївський провулок	2-й Чорнобаївський провулок
2-й Чорноморський провулок	2-й Чорноморський провулок
2-й Чугуївський в’їзд	2-й Чугуївський вʼїзд
2-й Чугуївський провулок	2-й Чугуївський провулок
2-й Чуднівський провулок	2-й Чуднівський провулок
2-й Чумацький провулок	2-й Чумацький провулок
2-й Чумацький проїзд	2-й Чумацький проїзд
2-й Шахтарський тупик	2-й Шахтарський тупик
2-й Шевченківський провулок	2-й Шевченківський провулок
2-й Широкий провулок	2-й Широкий провулок
2-й Шкільний провулок	2-й Шкільний провулок
2-й Шосейний провулок	2-й Шосейний провулок
2-й Щасливий провулок	2-й Щасливий провулок
2-й Ювілейний провулок	2-й Ювілейний провулок
2-й Яблуневий провулок	2-й Яблуневий провулок
2-й Ягідний проїзд	2-й Ягідний проїзд
2-й Ярмарковий провулок	2-й Ярмарковий провулок
2-й Яснополянський провулок	2-й Яснополянський провулок
24-й Польовий провулок	24-й Польовий провулок
25-й Польовий провулок	25-й Польовий провулок
29-й Польовий провулок	29-й Польовий провулок
3-й Авіаційний провулок	3-й Авіаційний провулок
3-й Аграрний тупик	3-й Аграрний тупик
3-й Андріївський провулок	3-й Андріївський провулок
3-й Барвінковий проїзд	3-й Барвінковий проїзд
3-й Басейний провулок	3-й Басейний провулок
3-й Баштанський провулок	3-й Баштанський провулок
3-й Береговий провулок	3-й Береговий провулок
3-й Березівський провулок	3-й Березівський провулок
3-й Березневий провулок	3-й Березневий провулок
3-й Березовий провулок	3-й Березовий провулок
3-й Богунський проїзд	3-й Богунський проїзд
3-й Болгарський проїзд	3-й Болгарський проїзд
3-й Ботанічний провулок	3-й Ботанічний провулок
3-й Братський провулок	3-й Братський провулок
3-й Брестський провулок	3-й Брестський провулок
3-й Будівельний в’їзд	3-й Будівельний вʼїзд
3-й Будівельний провулок	3-й Будівельний провулок
3-й Бузковий провулок	3-й Бузковий провулок
3-й Варшавський провулок	3-й Варшавський провулок
3-й Верстатний в’їзд	3-й Верстатний вʼїзд
3-й Вечірній провулок	3-й Вечірній провулок
3-й Високогірний проїзд	3-й Високогірний проїзд
3-й Вишневий провулок	3-й Вишневий провулок
3-й Вільний провулок	3-й Вільний провулок
3-й Вінницький провулок	3-й Вінницький провулок
3-й Водопійний провулок	3-й Водопійний провулок
3-й Водопровідний провулок	3-й Водопровідний провулок
3-й Воздвиженський провулок	3-й Воздвиженський провулок
3-й Георгіївський в’їзд	3-й Георгіївський вʼїзд
3-й Гоголівський провулок	3-й Гоголівський провулок
3-й Головний провулок	3-й Головний провулок
3-й Горіхівський провулок	3-й Горіхівський провулок
3-й Горіховий проїзд	3-й Горіховий проїзд
3-й Городній провулок	3-й Городній провулок
3-й Госпітальний провулок	3-й Госпітальний провулок
3-й Ґданський провулок	3-й Ґданський провулок
3-й Далекий провулок	3-й Далекий провулок
3-й Деревообробний провулок	3-й Деревообробний провулок
3-й Дніпровський провулок	3-й Дніпровський провулок
3-й Дубовецький провулок	3-й Дубовецький провулок
3-й Житловий провулок	3-й Житловий провулок
3-й Житомирський провулок	3-й Житомирський провулок
3-й Жовтневий провулок	3-й Жовтневий провулок
3-й Журавлівський в’їзд	3-й Журавлівський вʼїзд
3-й Заводський провулок	3-й Заводський провулок
3-й Залізничний провулок	3-й Залізничний провулок
3-й Замковий провулок	3-й Замковий провулок
3-й Заозерний провулок	3-й Заозерний провулок
3-й Запорізький провулок	3-й Запорізький провулок
3-й Зарічний провулок	3-й Зарічний провулок
3-й Затишний тупик	3-й Затишний тупик
3-й Західний провулок	3-й Західний провулок
3-й Заярний проїзд	3-й Заярний проїзд
3-й Зелений провулок	3-й Зелений провулок
3-й Зеленодільський проїзд	3-й Зеленодільський проїзд
3-й Земний провулок	3-й Земний провулок
3-й Зерновий проїзд	3-й Зерновий проїзд
3-й Зінцевий провулок	3-й Зінцевий провулок
3-й Зірковий проїзд	3-й Зірковий проїзд
3-й Зміївський в’їзд	3-й Зміївський вʼїзд
3-й Золочівський провулок	3-й Золочівський провулок
3-й Індустріальний провулок	3-й Індустріальний провулок
3-й Ісаївський в’їзд	3-й Ісаївський вʼїзд
3-й Калиновий провулок	3-й Калиновий провулок
3-й Кам’янецький проїзд	3-й Камʼянецький проїзд
3-й Кар’єрний провулок	3-й Карʼєрний провулок
3-й Карпатський провулок	3-й Карпатський провулок
3-й Каспійський проїзд	3-й Каспійський проїзд
3-й Каховський провулок	3-й Каховський провулок
3-й Каштановий провулок	3-й Каштановий провулок
3-й Каштановий проїзд	3-й Каштановий проїзд
3-й Кварцівський провулок	3-й Кварцівський провулок
3-й Квітковий провулок	3-й Квітковий провулок
3-й Квітневий провулок	3-й Квітневий провулок
3-й Квітучий провулок	3-й Квітучий провулок
3-й Керамічний в’їзд	3-й Керамічний вʼїзд
3-й Керченський провулок	3-й Керченський провулок
3-й Київський провулок	3-й Київський провулок
3-й Козацький в'їзд	3-й Козацький вʼїзд
3-й Козацький в’їзд	3-й Козацький вʼїзд
3-й Козацький провулок	3-й Козацький провулок
3-й Колективний провулок	3-й Колективний провулок
3-й Комсомольський провулок	3-й Комсомольський провулок
3-й Кооперативний провулок	3-й Кооперативний провулок
3-й Короткий тупик	3-й Короткий тупик
3-й Кохнівський проїзд	3-й Кохнівський проїзд
3-й Красносільський провулок	3-й Красносільський провулок
3-й Кременецький провулок	3-й Кременецький провулок
3-й Криворізький провулок	3-й Криворізький провулок
3-й Кришталевий провулок	3-й Кришталевий провулок
3-й Кронштадтський провулок	3-й Кронштадтський провулок
3-й Круговий провулок	3-й Круговий провулок
3-й Курганний провулок	3-й Курганний провулок
3-й Курортний провулок	3-й Курортний провулок
3-й Лазурний провулок	3-й Лазурний провулок
3-й Лазьківський в’їзд	3-й Лазьківський вʼїзд
3-й Ленінський провулок	3-й Ленінський провулок
3-й Липневий проїзд	3-й Липневий проїзд
3-й Лисогірський в’їзд	3-й Лисогірський вʼїзд
3-й Лінійний провулок	3-й Лінійний провулок
3-й Лісо-Степовий провулок	3-й Лісо-Степовий провулок
3-й Лісовий провулок	3-й Лісовий провулок
3-й Луговий проїзд	3-й Луговий проїзд
3-й Лутугинський проїзд	3-й Лутугинський проїзд
3-й Майський провулок	3-й Майський провулок
3-й Макіївський в’їзд	3-й Макіївський вʼїзд
3-й Малокохнівський тупик	3-й Малокохнівський тупик
3-й Мар’янівський провулок	3-й Марʼянівський провулок
3-й Маріупольський провулок	3-й Маріупольський провулок
3-й Метеорологічний проїзд	3-й Метеорологічний проїзд
3-й Микільський провулок	3-й Микільський провулок
3-й Молдавський провулок	3-й Молдавський провулок
3-й Молодіжний провулок	3-й Молодіжний провулок
3-й Московський провулок	3-й Московський провулок
3-й Мостовий провулок	3-й Мостовий провулок
3-й Моторний провулок	3-й Моторний провулок
3-й Набережний провулок	3-й Набережний провулок
3-й Нагірний провулок	3-й Нагірний провулок
3-й Нектарний провулок	3-й Нектарний провулок
3-й Неманський проїзд	3-й Неманський проїзд
3-й Нижній провулок	3-й Нижній провулок
3-й Новоприміський проїзд	3-й Новоприміський проїзд
3-й Овражний провулок	3-й Овражний провулок
3-й Одеський провулок	3-й Одеський провулок
3-й Озерний провулок	3-й Озерний провулок
3-й Олександрійський провулок	3-й Олександрійський провулок
3-й Олімпійський провулок	3-й Олімпійський провулок
3-й Онезький проїзд	3-й Онезький проїзд
3-й Парковий провулок	3-й Парковий провулок
3-й Парковий проїзд	3-й Парковий проїзд
3-й Парниковий провулок	3-й Парниковий провулок
3-й Перекопський провулок	3-й Перекопський провулок
3-й Першотравневий провулок	3-й Першотравневий провулок
3-й Петрівський провулок	3-й Петрівський провулок
3-й Петровский тупик	3-й Петровский тупик
3-й Печерський провулок	3-й Печерський провулок
3-й Південний провулок	3-й Південний провулок
3-й Північний провулок	3-й Північний провулок
3-й Північно-Озерний провулок	3-й Північно-Озерний провулок
3-й Піонерський провулок	3-й Піонерський провулок
3-й Покровський провулок	3-й Покровський провулок
3-й Поліський провулок	3-й Поліський провулок
3-й Полтавський провулок	3-й Полтавський провулок
3-й Польовий провулок	3-й Польовий провулок
3-й Польський провулок	3-й Польський провулок
3-й Поперечний провулок	3-й Поперечний провулок
3-й Прибузький провулок	3-й Прибузький провулок
3-й Приморський провулок	3-й Приморський провулок
3-й Проїзний провулок	3-й Проїзний провулок
3-й Пролетарський провулок	3-й Пролетарський провулок
3-й Ракетний провулок	3-й Ракетний провулок
3-й Робочий провулок	3-й Робочий провулок
3-й Рогизнянський провулок	3-й Рогизнянський провулок
3-й Рокитнянський провулок	3-й Рокитнянський провулок
3-й Ромашковий проїзд	3-й Ромашковий проїзд
3-й Рудниковий провулок	3-й Рудниковий провулок
3-й Садівничий проїзд	3-й Садівничий проїзд
3-й Садовий провулок	3-й Садовий провулок
3-й Санаторний провулок	3-й Санаторний провулок
3-й Святошинський проїзд	3-й Святошинський проїзд
3-й Селецький провулок	3-й Селецький провулок
3-й Семенівський провулок	3-й Семенівський провулок
3-й Сінний провулок	3-й Сінний провулок
3-й Скіфський провулок	3-й Скіфський провулок
3-й Слов’янський провулок	3-й Словʼянський провулок
3-й Смолянський провулок	3-й Смолянський провулок
3-й Соборний провулок	3-й Соборний провулок
3-й Сокільницький в’їзд	3-й Сокільницький вʼїзд
3-й Соколовський провулок	3-й Соколовський провулок
3-й Сонячний провулок	3-й Сонячний провулок
3-й Сосновий провулок	3-й Сосновий провулок
3-й Софіївський провулок	3-й Софіївський провулок
3-й Спасо-Преображенський провулок	3-й Спасо-Преображенський провулок
3-й Спаський проїзд	3-й Спаський проїзд
3-й Старокиївський провулок	3-й Старокиївський провулок
3-й Старокиївський проїзд	3-й Старокиївський проїзд
3-й Стаханівський провулок	3-й Стаханівський провулок
3-й Стахановський провулок	3-й Стахановський провулок
3-й Степовий провулок	3-й Степовий провулок
3-й Стрийський провулок	3-й Стрийський провулок
3-й Східний провулок	3-й Східний провулок
3-й Таборовий провулок	3-й Таборовий провулок
3-й Таврійський провулок	3-й Таврійський провулок
3-й Таганський провулок	3-й Таганський провулок
3-й Танковий проїзд	3-й Танковий проїзд
3-й Тепличний провулок	3-й Тепличний провулок
3-й Топольний провулок	3-й Топольний провулок
3-й Травневий провулок	3-й Травневий провулок
3-й Трамвайний провулок	3-й Трамвайний провулок
3-й Транзитний провулок	3-й Транзитний провулок
3-й Трипільський провулок	3-й Трипільський провулок
3-й Тупиковий провулок	3-й Тупиковий провулок
3-й Ударний провулок	3-й Ударний провулок
3-й Український провулок	3-й Український провулок
3-й Український проїзд	3-й Український проїзд
3-й Уманський провулок	3-й Уманський провулок
3-й Усівський в’їзд	3-й Усівський вʼїзд
3-й Фізкультурний провулок	3-й Фізкультурний провулок
3-й Фруктовий провулок	3-й Фруктовий провулок
3-й Хімічний провулок	3-й Хімічний провулок
3-й Хорольський тупик	3-й Хорольський тупик
3-й Хуторський проїзд	3-й Хуторський проїзд
3-й Центральний провулок	3-й Центральний провулок
3-й Чапаєвський провулок	3-й Чапаєвський провулок
3-й Червоноармійський провулок	3-й Червоноармійський провулок
3-й Черемховий проїзд	3-й Черемховий проїзд
3-й Черемшиновий провулок	3-й Черемшиновий провулок
3-й Чигиринський провулок	3-й Чигиринський провулок
3-й Чорноморський провулок	3-й Чорноморський провулок
3-й Чугуївський в’їзд	3-й Чугуївський вʼїзд
3-й Чугуївський провулок	3-й Чугуївський провулок
3-й Чуднівський провулок	3-й Чуднівський провулок
3-й Чумацький провулок	3-й Чумацький провулок
3-й Шахтарський тупик	3-й Шахтарський тупик
3-й Шевченківський провулок	3-й Шевченківський провулок
3-й Шкільний провулок	3-й Шкільний провулок
3-й Шосейний провулок	3-й Шосейний провулок
3-й Ювілейний провулок	3-й Ювілейний провулок
3-й Ярмарковий провулок	3-й Ярмарковий провулок
3-й Яснополянський провулок	3-й Яснополянський провулок
4-ий Садовий провулок	4-й Садовий провулок
4-й Аграрний тупик	4-й Аграрний тупик
4-й Аеродромний провулок	4-й Аеродромний провулок
4-й Барвінковий проїзд	4-й Барвінковий проїзд
4-й Басейний провулок	4-й Басейний провулок
4-й Баштанський провулок	4-й Баштанський провулок
4-й Березівський провулок	4-й Березівський провулок
4-й Богунський проїзд	4-й Богунський проїзд
4-й Болгарський проїзд	4-й Болгарський проїзд
4-й Братський провулок	4-й Братський провулок
4-й Будівельний провулок	4-й Будівельний провулок
4-й Верстатний в’їзд	4-й Верстатний вʼїзд
4-й Вечірній провулок	4-й Вечірній провулок
4-й Винокурний провулок	4-й Винокурний провулок
4-й Високогірний проїзд	4-й Високогірний проїзд
4-й Вишневий провулок	4-й Вишневий провулок
4-й Георгіївський в’їзд	4-й Георгіївський вʼїзд
4-й Головний провулок	4-й Головний провулок
4-й Горіхівський провулок	4-й Горіхівський провулок
4-й Горіховий проїзд	4-й Горіховий проїзд
4-й Далекий провулок	4-й Далекий провулок
4-й Дачний провулок	4-й Дачний провулок
4-й Деревообробний провулок	4-й Деревообробний провулок
4-й Житловий провулок	4-й Житловий провулок
4-й Житомирський провулок	4-й Житомирський провулок
4-й Жовтневий провулок	4-й Жовтневий провулок
4-й Заводський провулок	4-й Заводський провулок
4-й Залізничний провулок	4-й Залізничний провулок
4-й Заозерний провулок	4-й Заозерний провулок
4-й Західний провулок	4-й Західний провулок
4-й Заярний проїзд	4-й Заярний проїзд
4-й Зелений провулок	4-й Зелений провулок
4-й Земний провулок	4-й Земний провулок
4-й Зерновий проїзд	4-й Зерновий проїзд
4-й Зірковий проїзд	4-й Зірковий проїзд
4-й Індустріальний провулок	4-й Індустріальний провулок
4-й Ісаївський в’їзд	4-й Ісаївський вʼїзд
4-й Каховський провулок	4-й Каховський провулок
4-й Каштановий провулок	4-й Каштановий провулок
4-й Квітневий провулок	4-й Квітневий провулок
4-й Керамічний в’їзд	4-й Керамічний вʼїзд
4-й Київський провулок	4-й Київський провулок
4-й Козацький провулок	4-й Козацький провулок
4-й Комсомольський провулок	4-й Комсомольський провулок
4-й Короткий тупик	4-й Короткий тупик
4-й Кременецький провулок	4-й Кременецький провулок
4-й Кришталевий провулок	4-й Кришталевий провулок
4-й Круговий провулок	4-й Круговий провулок
4-й Курортний провулок	4-й Курортний провулок
4-й Лазурний провулок	4-й Лазурний провулок
4-й Ленінський провулок	4-й Ленінський провулок
4-й Липневий проїзд	4-й Липневий проїзд
4-й Лисогірський в’їзд	4-й Лисогірський вʼїзд
4-й Лінійний провулок	4-й Лінійний провулок
4-й Лісо-Степовий провулок	4-й Лісо-Степовий провулок
4-й Лісовий провулок	4-й Лісовий провулок
4-й Лутугинський проїзд	4-й Лутугинський проїзд
4-й Майський провулок	4-й Майський провулок
4-й Малокохнівський тупик	4-й Малокохнівський тупик
4-й Маріупольський провулок	4-й Маріупольський провулок
4-й Микільський провулок	4-й Микільський провулок
4-й Нагірний провулок	4-й Нагірний провулок
4-й Неманський проїзд	4-й Неманський проїзд
4-й Одеський провулок	4-й Одеський провулок
4-й Озерний провулок	4-й Озерний провулок
4-й Олександрійський провулок	4-й Олександрійський провулок
4-й Олімпійський провулок	4-й Олімпійський провулок
4-й Онезький проїзд	4-й Онезький проїзд
4-й Парковий провулок	4-й Парковий провулок
4-й Парковий проїзд	4-й Парковий проїзд
4-й Парниковий провулок	4-й Парниковий провулок
4-й Першотравневий провулок	4-й Першотравневий провулок
4-й Печерський провулок	4-й Печерський провулок
4-й Південний провулок	4-й Південний провулок
4-й Північно-Озерний провулок	4-й Північно-Озерний провулок
4-й Піонерський провулок	4-й Піонерський провулок
4-й Поліський провулок	4-й Поліський провулок
4-й Польовий провулок	4-й Польовий провулок
4-й Прибузький провулок	4-й Прибузький провулок
4-й Приміський провулок	4-й Приміський провулок
4-й Радянський провулок	4-й Радянський провулок
4-й Ракетний провулок	4-й Ракетний провулок
4-й Робочий провулок	4-й Робочий провулок
4-й Рогизнянський провулок	4-й Рогизнянський провулок
4-й Ромашковий проїзд	4-й Ромашковий проїзд
4-й Садівничий проїзд	4-й Садівничий проїзд
4-й Садовий провулок	4-й Садовий провулок
4-й Сальський провулок	4-й Сальський провулок
4-й Селецький провулок	4-й Селецький провулок
4-й Семенівський провулок	4-й Семенівський провулок
4-й Слов'янський проїзд	4-й Словʼянський проїзд
4-й Слов’янський провулок	4-й Словʼянський провулок
4-й Смолянський провулок	4-й Смолянський провулок
4-й Соколовський провулок	4-й Соколовський провулок
4-й Соляний провулок	4-й Соляний провулок
4-й Софіївський проїзд	4-й Софіївський проїзд
4-й Стаханівський провулок	4-й Стаханівський провулок
4-й Степовий провулок	4-й Степовий провулок
4-й Стрийський провулок	4-й Стрийський провулок
4-й Студентський провулок	4-й Студентський провулок
4-й Таборовий провулок	4-й Таборовий провулок
4-й Таврійський провулок	4-й Таврійський провулок
4-й Танковий проїзд	4-й Танковий проїзд
4-й Топольний провулок	4-й Топольний провулок
4-й Тракторний провулок	4-й Тракторний провулок
4-й Транзитний провулок	4-й Транзитний провулок
4-й Український провулок	4-й Український провулок
4-й Уманський провулок	4-й Уманський провулок
4-й Фруктовий провулок	4-й Фруктовий провулок
4-й Хорольський тупик	4-й Хорольський тупик
4-й Центральний провулок	4-й Центральний провулок
4-й Чапаєвський провулок	4-й Чапаєвський провулок
4-й Червоноармійський провулок	4-й Червоноармійський провулок
4-й Черемховий проїзд	4-й Черемховий проїзд
4-й Чигиринський провулок	4-й Чигиринський провулок
4-й Чорноморський провулок	4-й Чорноморський провулок
4-й Чуднівський провулок	4-й Чуднівський провулок
4-й Шахтарський тупик	4-й Шахтарський тупик
4-й Ювілейний провулок	4-й Ювілейний провулок
5-ий Садовий провулок	5-й Садовий провулок
5-й Аеродромний провулок	5-й Аеродромний провулок
5-й Березівський провулок	5-й Березівський провулок
5-й Богунський проїзд	5-й Богунський проїзд
5-й Болгарський проїзд	5-й Болгарський проїзд
5-й Вечірній провулок	5-й Вечірній провулок
5-й Вишневий провулок	5-й Вишневий провулок
5-й Горіхівський провулок	5-й Горіхівський провулок
5-й Далекий провулок	5-й Далекий провулок
5-й Дачний провулок	5-й Дачний провулок
5-й Деревообробний провулок	5-й Деревообробний провулок
5-й Житомирський провулок	5-й Житомирський провулок
5-й Жовтневий провулок	5-й Жовтневий провулок
5-й Залізничний провулок	5-й Залізничний провулок
5-й Заозерний провулок	5-й Заозерний провулок
5-й Західний провулок	5-й Західний провулок
5-й Заярний проїзд	5-й Заярний проїзд
5-й Зелений провулок	5-й Зелений провулок
5-й Зеленодільський проїзд	5-й Зеленодільський проїзд
5-й Зірковий проїзд	5-й Зірковий проїзд
5-й Інгульський провулок	5-й Інгульський провулок
5-й Індустріальний провулок	5-й Індустріальний провулок
5-й Ісаївський в’їзд	5-й Ісаївський вʼїзд
5-й Кавказький проїзд	5-й Кавказький проїзд
5-й Каспійський провулок	5-й Каспійський провулок
5-й Каштановий провулок	5-й Каштановий провулок
5-й Квітневий провулок	5-й Квітневий провулок
5-й Керамічний в’їзд	5-й Керамічний вʼїзд
5-й Короткий тупик	5-й Короткий тупик
5-й Кременецький провулок	5-й Кременецький провулок
5-й Круговий провулок	5-й Круговий провулок
5-й Курортний провулок	5-й Курортний провулок
5-й Лазурний провулок	5-й Лазурний провулок
5-й Ленінський провулок	5-й Ленінський провулок
5-й Лісний провулок	5-й Лісний провулок
5-й Лісовий провулок	5-й Лісовий провулок
5-й Лутугинський проїзд	5-й Лутугинський проїзд
5-й Майський провулок	5-й Майський провулок
5-й Маріупольський провулок	5-й Маріупольський провулок
5-й Нагірний провулок	5-й Нагірний провулок
5-й Новоприміський проїзд	5-й Новоприміський проїзд
5-й Озерний провулок	5-й Озерний провулок
5-й Олімпійський провулок	5-й Олімпійський провулок
5-й Онезький проїзд	5-й Онезький проїзд
5-й Парниковий провулок	5-й Парниковий провулок
5-й Першотравневий провулок	5-й Першотравневий провулок
5-й Печерський провулок	5-й Печерський провулок
5-й Північно-Озерний провулок	5-й Північно-Озерний провулок
5-й Піонерський провулок	5-й Піонерський провулок
5-й Поліський провулок	5-й Поліський провулок
5-й Польовий провулок	5-й Польовий провулок
5-й Прибузький провулок	5-й Прибузький провулок
5-й Приміський в’їзд	5-й Приміський вʼїзд
5-й Садовий провулок	5-й Садовий провулок
5-й Семенівський провулок	5-й Семенівський провулок
5-й Слов'янський проїзд	5-й Словʼянський проїзд
5-й Слов’янський провулок	5-й Словʼянський провулок
5-й Смолянський провулок	5-й Смолянський провулок
5-й Соколовський провулок	5-й Соколовський провулок
5-й Соляний провулок	5-й Соляний провулок
5-й Софіївський проїзд	5-й Софіївський проїзд
5-й Студентський провулок	5-й Студентський провулок
5-й Східно-Дальній провулок	5-й Східно-Дальній провулок
5-й Танковий проїзд	5-й Танковий проїзд
5-й Топольний провулок	5-й Топольний провулок
5-й Тракторний провулок	5-й Тракторний провулок
5-й Транзитний провулок	5-й Транзитний провулок
5-й Уманський провулок	5-й Уманський провулок
5-й Фруктовий провулок	5-й Фруктовий провулок
5-й Хорольський тупик	5-й Хорольський тупик
5-й Центральний провулок	5-й Центральний провулок
5-й Чапаєвський провулок	5-й Чапаєвський провулок
5-й Червоноармійський провулок	5-й Червоноармійський провулок
5-й Черемховий проїзд	5-й Черемховий проїзд
6-ий Садовий провулок	6-й Садовий провулок
6-й Аеродромний провулок	6-й Аеродромний провулок
6-й Басейний провулок	6-й Басейний провулок
6-й Вечірній провулок	6-й Вечірній провулок
6-й Вишневий провулок	6-й Вишневий провулок
6-й Дачний провулок	6-й Дачний провулок
6-й Жовтневий провулок	6-й Жовтневий провулок
6-й Залізничний провулок	6-й Залізничний провулок
6-й Заозерний провулок	6-й Заозерний провулок
6-й Західний провулок	6-й Західний провулок
6-й Зеленодільський проїзд	6-й Зеленодільський проїзд
6-й Зірковий проїзд	6-й Зірковий проїзд
6-й Інгульський провулок	6-й Інгульський провулок
6-й Індустріальний провулок	6-й Індустріальний провулок
6-й Ісаївський в’їзд	6-й Ісаївський вʼїзд
6-й Каспійський провулок	6-й Каспійський провулок
6-й Квітневий провулок	6-й Квітневий провулок
6-й Київський провулок	6-й Київський провулок
6-й Короткий тупик	6-й Короткий тупик
6-й Круговий провулок	6-й Круговий провулок
6-й Курортний провулок	6-й Курортний провулок
6-й Лазурний провулок	6-й Лазурний провулок
6-й Ленінський провулок	6-й Ленінський провулок
6-й Лутугинський проїзд	6-й Лутугинський проїзд
6-й Маріупольський провулок	6-й Маріупольський провулок
6-й Нагірний провулок	6-й Нагірний провулок
6-й Озерний провулок	6-й Озерний провулок
6-й Олімпійський провулок	6-й Олімпійський провулок
6-й Омський проїзд	6-й Омський проїзд
6-й Онезький проїзд	6-й Онезький проїзд
6-й Північно-Озерний провулок	6-й Північно-Озерний провулок
6-й Піонерський провулок	6-й Піонерський провулок
6-й Польовий провулок	6-й Польовий провулок
6-й Садовий провулок	6-й Садовий провулок
6-й Семенівський провулок	6-й Семенівський провулок
6-й Слов’янський провулок	6-й Словʼянський провулок
6-й Соколовський провулок	6-й Соколовський провулок
6-й Соляний провулок	6-й Соляний провулок
6-й Софіївський проїзд	6-й Софіївський проїзд
6-й Східно-Дальній провулок	6-й Східно-Дальній провулок
6-й Танковий провулок	6-й Танковий провулок
6-й Топольний провулок	6-й Топольний провулок
6-й Транзитний провулок	6-й Транзитний провулок
6-й Хорольський тупик	6-й Хорольський тупик
6-й Чапаєвський провулок	6-й Чапаєвський провулок
6-й Черемховий проїзд	6-й Черемховий проїзд
7-й Аеродромний провулок	7-й Аеродромний провулок
7-й Березівський провулок	7-й Березівський провулок
7-й Воєнний провулок	7-й Воєнний провулок
7-й Жовтневий провулок	7-й Жовтневий провулок
7-й Західний провулок	7-й Західний провулок
7-й Індустріальний провулок	7-й Індустріальний провулок
7-й Кавказький проїзд	7-й Кавказький проїзд
7-й Каспійський провулок	7-й Каспійський провулок
7-й Каштановий провулок	7-й Каштановий провулок
7-й Квітневий провулок	7-й Квітневий провулок
7-й Київський провулок	7-й Київський провулок
7-й Короткий тупик	7-й Короткий тупик
7-й Круговий провулок	7-й Круговий провулок
7-й Ленінський провулок	7-й Ленінський провулок
7-й Нагірний провулок	7-й Нагірний провулок
7-й Озерний провулок	7-й Озерний провулок
7-й Олімпійський провулок	7-й Олімпійський провулок
7-й Омський проїзд	7-й Омський проїзд
7-й Онезький проїзд	7-й Онезький проїзд
7-й Північно-Озерний провулок	7-й Північно-Озерний провулок
7-й Піонерський провулок	7-й Піонерський провулок
7-й Польовий провулок	7-й Польовий провулок
7-й Садовий провулок	7-й Садовий провулок
7-й Січовий проїзд	7-й Січовий проїзд
7-й Соколовський провулок	7-й Соколовський провулок
7-й Соляний провулок	7-й Соляний провулок
7-й Софіївський проїзд	7-й Софіївський проїзд
7-й Танковий провулок	7-й Танковий провулок
7-й Тихий провулок	7-й Тихий провулок
7-й Тракторний провулок	7-й Тракторний провулок
7-й Транзитний провулок	7-й Транзитний провулок
7-й Хорольський тупик	7-й Хорольський тупик
7-й Чапаєвський провулок	7-й Чапаєвський провулок
7-й Черемховий проїзд	7-й Черемховий проїзд
8-й Аеродромний провулок	8-й Аеродромний провулок
8-й Дачний провулок	8-й Дачний провулок
8-й Кавказький проїзд	8-й Кавказький проїзд
8-й Квітневий провулок	8-й Квітневий провулок
8-й Ленінський провулок	8-й Ленінський провулок
8-й Озерний провулок	8-й Озерний провулок
8-й Омський проїзд	8-й Омський проїзд
8-й Північно-Озерний провулок	8-й Північно-Озерний провулок
8-й Піонерський провулок	8-й Піонерський провулок
8-й Польовий провулок	8-й Польовий провулок
8-й Січовий проїзд	8-й Січовий проїзд
8-й Слов’янський провулок	8-й Словʼянський провулок
8-й Софіївський проїзд	8-й Софіївський проїзд
8-й Танковий провулок	8-й Танковий провулок
8-й Тихий провулок	8-й Тихий провулок
8-й Хорольський тупик	8-й Хорольський тупик
8-й Чапаєвський провулок	8-й Чапаєвський провулок
8-й Чорноморський провулок	8-й Чорноморський провулок
8-й Ягідний проїзд	8-й Ягідний проїзд
9-й Аеродромний проїзд	9-й Аеродромний проїзд
9-й Дачний провулок	9-й Дачний провулок
9-й Квітневий провулок	9-й Квітневий провулок
9-й Ленінський провулок	9-й Ленінський провулок
9-й Озерний провулок	9-й Озерний провулок
9-й Омський проїзд	9-й Омський проїзд
9-й Північно-Озерний провулок	9-й Північно-Озерний провулок
9-й Піонерський провулок	9-й Піонерський провулок
9-й Січовий проїзд	9-й Січовий проїзд
9-й Софіївський проїзд	9-й Софіївський проїзд
9-й Танковий провулок	9-й Танковий провулок
9-й Хорольський тупик	9-й Хорольський тупик
9-й Чапаєвський провулок	9-й Чапаєвський провулок
Садовий №1 провулок	1-й Садовий провулок
Садовий №2 провулок	2-й Садовий провулок
Садовий №3 провулок	3-й Садовий провулок
Садовий №4 провулок	4-й Садовий провулок
Садовий №5 провулок	5-й Садовий провулок