А провулок	провулок А
Авіаторів провулок	провулок Авіаторів
Авіації провулок	провулок Авіації
Адамчика провулок	провулок Адамчика
Азовсталі провулок	провулок Азовсталі
Акацієвий провулок	Акацієвий провулок
Активіста провулок	провулок Активіста
Аляб’єва провулок	провулок Алябʼєва
Араф’єва провулок	провулок Арафʼєва
Аріпей провулок	провулок Аріпей
Архитектора Кобелєва провулок	провулок Архитектора Кобелєва
Архітекторів провулок	провулок Архітекторів
Аршенєвських провулок	провулок Аршенєвських
Аскольдів провулок	провулок Аскольдів
Атерлея провулок	провулок Атерлея
Б провулок	провулок Б
Бабусин провулок	Бабусин провулок
Бадаєва провулок	провулок Бадаєва
Базавлука провулок	провулок Базавлука
Бакинських Комісарів провулок	провулок Бакинських Комісарів
Бакінських Комісарів провулок	провулок Бакинських Комісарів
Барвистий провулок	провулок Барвистий
Бебюш Капон провулок	провулок Бебюш Капон
Безнадецьких провулок	провулок Безнадецьких
Берегині провулок	провулок Берегині
Берута провулок	провулок Берута
Бізе провулок	провулок Бізе
Білгород провулок	провулок Білгород
Білий провулок	Білий провулок
Білих акацій провулок	провулок Білих Акацій
Благоєва провулок	провулок Благоєва
Блискучий провулок	Блискучий провулок
Борзий провулок	Борзий провулок
Ботєва провулок	провулок Ботєва
Братній провулок	Братній провулок
Бреславських провулок	провулок Бреславських
Брилів провулок	Брилів провулок
Бугристий провулок	Бугристий провулок
Бурячий провулок	Бурячий провулок
Бутишів провулок	Бутишів провулок
Варлена провулок	провулок Варлена
Великих провулок	провулок Великих
Верижиці провулок	провулок Верижиці
Верхній провулок	Верхній провулок
Верхньовеселий провулок	Верхньовеселий провулок
Верхня Бережанка провулок	провулок Верхня Бережанка
Вершина провулок	провулок Вершина
Веселий провулок	Веселий провулок
Весняних Конвалій провулок	провулок Весняних Конвалій
Вечірній провулок	Вечірній провулок
Взуттєвий провулок	Взуттєвий провулок
Визволення Донбасу провулок	провулок Визволення Донбасу
Визволення провулок	провулок Визволення
Визволителів провулок	провулок Визволителів
Виноробів провулок	провулок Виноробів
Виробничий провулок	Виробничий провулок
Вишневої вулиці провулок	провулок Вишневої вулиці
Відкритий провулок	Відкритий провулок
Відомчий провулок	Відомчий провулок
Відпочинку провулок	провулок Відпочинку
Відродження провулок	провулок Відродження
Віліса Лаціса провулок	провулок Віліса Лаціса
Внутрішній провулок	Внутрішній провулок
Вовчий провулок	Вовчий провулок
Водіїв провулок	провулок Водіїв
Возз'єднання провулок	провулок Воззʼєднання
Возз’єднання провулок	провулок Воззʼєднання
Возничий провулок	Возничий провулок
Возʼєднання провулок	провулок Возʼєднання
Воїнів УПА провулок	провулок Воїнів УПА
Волонтерів провулок	провулок Волонтерів
Волошків провулок	провулок Волошків
Газети «Правда» провулок	провулок Газети «Правда»
Галанчикової провулок	провулок Галанчикової
Гастелло провулок	провулок Гастелло
Генерала Дерев’янка провулок	провулок Генерала Деревʼянка
Генералів Сухинських провулок	провулок Генералів Сухинських
Геологів провулок	провулок Геологів
Героїв Азову провулок	провулок Героїв Азову
Героїв Бреста провулок	провулок Героїв Бреста
Героїв Ворзеля провулок	провулок Героїв Ворзеля
Героїв Дніпра провулок	провулок Героїв Дніпра
Героїв Крут провулок	провулок Героїв Крут
Героїв Майдану провулок	провулок Героїв Майдану
Героїв Маріуполя провулок	провулок Героїв Маріуполя
Героїв провулок	провулок Героїв
Героїв УПА провулок	провулок Героїв УПА
Героїв Чорнобиля провулок	провулок Героїв Чорнобиля
ГЕС провулок	провулок ГЕС
Гєологічєскій провулок	Гєологічєскій провулок
Гирчичів провулок	провулок Гирчичів
Гіллястий провулок	Гіллястий провулок
Гірник провулок	провулок Гірник
Гірничий провулок	Гірничий провулок
Гірчичне Зерно провулок	провулок Гірчичне Зерно
Глинище провулок	провулок Глинище
Глухий провулок	Глухий провулок
Глушків провулок	провулок Глушків
Гнаровской провулок	провулок Гнаровской
Голлоші провулок	провулок Голлоші
Гольдбергів провулок	провулок Гольдбергів
Гольдфадена провулок	провулок Гольдфадена
Горб провулок	провулок Горб
Горлових провулок	провулок Горлових
Городній провулок	Городній провулок
Горчака провулок	провулок Горчака
Греків провулок	провулок Греків
Гризана провулок	провулок Гризана
Гризодубової провулок	провулок Гризодубової
Грузина провулок	провулок Грузина
Грунських провулок	провулок Грунських
Гурамішвілі провулок	провулок Гурамішвілі
Ґрохольських провулок	провулок Ґрохольських
Дальній провулок	Дальній провулок
Данте провулок	провулок Данте
Дарчі Керт провулок	провулок Дарчі Керт
Дегтяря провулок	провулок Дегтяря
Дехтяря провулок	провулок Дехтяря
Джамбула Джабаєва провулок	провулок Джамбула Джабаєва
Джамбула провулок	провулок Джамбула
Джерело провулок	провулок Джерело
Джинчарадзе провулок	провулок Джинчарадзе
Дитячий провулок	Дитячий провулок
Дівочий провулок	Дівочий провулок
Дільничий провулок	Дільничий провулок
Діхтяря провулок	провулок Діхтяря
Дніпробуду провулок	провулок Дніпробуду
Доблесті провулок	провулок Доблесті
Добра провулок	провулок Добра
Добрий провулок	Добрий провулок
Добровой провулок	провулок Добровой
Добровольчих Батальйонів провулок	провулок Добровольчих Батальйонів
Добросусідства провулок	провулок Добросусідства
Довгий провулок	Довгий провулок
Довжок провулок	провулок Довжок
Долинка провулок	провулок Долинка
Долорес Ібаррурі провулок	провулок Долорес Ібаррурі
Дордюка провулок	провулок Дордюка
Достатку провулок	провулок Достатку
Дригала провулок	провулок Дригала
Дробця провулок	провулок Дробця
Дружби Народів провулок	провулок Дружби Народів
Друзів провулок	провулок Друзів
Дьошина провулок	провулок Дьошина
Екскавації провулок	провулок Екскавації
Емінеску провулок	провулок Емінеску
Житній провулок	Житній провулок
Жовтий провулок	Жовтий провулок
Жовтневої вулиці провулок	провулок Жовтневої вулиці
Жовтневої Революції провулок	провулок Жовтневої Революції
Жовтня провулок	провулок Жовтня
Жолобок провулок	провулок Жолобок
Журливої провулок	провулок Журливої
Жухрая провулок	провулок Жухрая
За Рудкою провулок	провулок За Рудкою
Забрама провулок	провулок Забрама
Завгородній провулок	Завгородній провулок
Загора провулок	провулок Загора
Загородній провулок	Загородній провулок
Задніпровських провулок	провулок Задніпровських
Заїжджий провулок	Заїжджий провулок
Заїзджий провулок	Заїзджий провулок
Заїзжий провулок	Заїзжий провулок
Закритий провулок	Закритий провулок
Залізничної вулиці провулок	провулок Залізничної вулиці
Замістя провулок	провулок Замістя
Замковище провулок	провулок Замковище
Зарічанській провулок	Зарічанській провулок
Заріччя провулок	провулок Заріччя
Зарудка провулок	провулок Зарудка
Застава провулок	провулок Застава
Застіноцької провулок	провулок Застіноцької
Заячий провулок	Заячий провулок
Зв’язку провулок	провулок Звʼязку
Зваричі провулок	провулок Зваричі
Звеньєвий провулок	Звеньєвий провулок
Звивистий провулок	Звивистий провулок
Здоров’я провулок	провулок Здоровʼя
Здоровʼя провулок	провулок Здоровʼя
Зелена провулок	провулок Зелена
Зільберника провулок	провулок Зільберника
Змагання провулок	провулок Змагання
Знаменських провулок	провулок Знаменських
Зодчих провулок	провулок Зодчих
Золотий провулок	Золотий провулок
Золотистий провулок	Золотистий провулок
Золотоосінній провулок	Золотоосінній провулок
Зорге провулок	провулок Зорге
Зоря провулок	провулок Зоря
І провулок Надрічної	1-й провулок Надрічної
І.Франко провулок	провулок І. Франко
Ізвєстія провулок	провулок Ізвєстія
ІІ Дружби провулок	2-й провулок Дружби
ІІ-й Гоголь провулок	2-й провулок Гоголя
Індустріальної вулиці провулок	провулок Індустріальної вулиці
Інтернату провулок	провулок Інтернату
Йогансона провулок	провулок Йогансона
Кам’янка провулок	провулок Камʼянка
Каменярів провулок	провулок Каменярів
Каркашадзе провулок	провулок Каркашадзе
Квітучий провулок	Квітучий провулок
Кемеровскій провулок	провулок Кемеровскій
Кипучий провулок	Кипучий провулок
Кіквідзе провулок	провулок Кіквідзе
КІМа провулок	провулок КІМа
КІМу провулок	провулок КІМу
Клисів провулок	Клисів провулок
Княжий провулок	Княжий провулок
Князів Коріатовичів провулок	провулок Князів Коріатовичів
Князів Острозьких провулок	провулок Князів Острозьких
Князів Сангушків провулок	провулок Князів Сангушків
Князів Сангушко провулок	провулок Князів Сангушко
Кобера провулок	провулок Кобера
Козачий провулок	Козачий провулок
Коккінакі провулок	провулок Коккінакі
Коллонтай провулок	провулок Коллонтай
Коломієць провулок	провулок Коломієць
Колонтай провулок	провулок Колонтай
Колосистий провулок	Колосистий провулок
Комінтерну провулок	провулок Комінтерну
Комка провулок	провулок Комка
Комунарів провулок	провулок Комунарів
Коні провулок	провулок Коні
Конституції провулок	провулок Конституції
Кооперації провулок	провулок Кооперації
Корабелів провулок	провулок Корабелів
Коріатовичів провулок	провулок Коріатовичів
Корчі провулок	провулок Корчі
Косий провулок	Косий провулок
Космонавтів провулок	провулок Космонавтів
Коцка провулок	провулок Коцка
Крайній провулок	Крайній провулок
Крамничий провулок	провулок Крамничий
Красновських провулок	провулок Красновських
Красногірка провулок	провулок Красногірка
Кремнієвий провулок	Кремнієвий провулок
Кренкеля провулок	провулок Кренкеля
Криничуватий провулок	Криничуватий провулок
Круглий провулок	Круглий провулок
Крупськой провулок	провулок Крупськой
Крутий провулок	Крутий провулок
Крутнів Яр провулок	провулок Крутнів Яр
Кубинця провулок	провулок Кубинця
Кударя провулок	провулок Кударя
Кудрявий провулок	Кудрявий провулок
Куїнджі провулок	провулок Куїнджі
Куп'янській провулок	Купʼянській провулок
Курака провулок	провулок Курака
Кучаря провулок	провулок Кучаря
Кучерявий провулок	Кучерявий провулок
Куяльник провулок	провулок Куяльник
Ладо Кецховелі провулок	провулок Ладо Кецховелі
Лазо провулок	провулок Лазо
Лалаянца провулок	провулок Лалаянца
Ландау провулок	провулок Ландау
Ланок провулок	провулок Ланок
Левенца провулок	провулок Левенца
Ленських Подій провулок	провулок Ленських Подій
Либіді провулок	провулок Либіді
Лимарків провулок	провулок Лимарків
Линтварьових провулок	провулок Линтварьових
Лисинка провулок	провулок Лисинка
Лікаря Бланка провулок	провулок Лікаря Бланка
Ліселідзе провулок	провулок Ліселідзе
Лісовій провулок	провулок Лісовій
Лісорубів провулок	провулок Лісорубів
Літній провулок	провулок Літній
Логаша провулок	провулок Логаша
Льотчика Крутеня провулок	провулок Льотчика Крутеня
Лютневої Революції провулок	провулок Лютневої Революції
Лялі Убийвовк провулок	провулок Лялі Убийвовк
Майстрів провулок	провулок Майстрів
Малий провулок	провулок Малий
Малий Уж провулок	провулок Малий Уж
Мальовничий провулок	провулок Мальовничий
Мамадалієва провулок	провулок Мамадалієва
Марічка провулок	провулок Марічка
Марко Вовчок провулок	провулок Марко Вовчок
Матросів провулок	провулок Матросів
Махарадзе провулок	провулок Махарадзе
Медичній провулок	провулок Медичній
Медніка провулок	провулок Медніка
Менделеєва провулок	провулок Менделеєва
Металіста провулок	провулок Металіста
Металургів провулок	провулок Металургів
Миколаєва провулок	провулок Миколаєва
Миколаї Божук провулок	провулок Миколаї Божук
Милий провулок	провулок Милий
Милосердя провулок	провулок Милосердя
Мирній провулок	провулок Мирній
Миру провулок	провулок Миру
Мистецтва провулок	провулок Мистецтва
Митрака провулок	провулок Митрака
Міус провулок	провулок Міус
Могильчака провулок	провулок Могильчака
Мокрий провулок	провулок Мокрий
Молодіжної вулиці провулок	провулок Молодіжної вулиці
Молодої гвардії провулок	провулок Молодої гвардії
Москеті провулок	провулок Москеті
МЮДа провулок	провулок МЮДа
Навої провулок	провулок Навої
Надставної провулок	провулок Надставної
Народів провулок	провулок Народів
Народної Гвардії провулок	провулок Народної Гвардії
Незабутній провулок	провулок Незабутній
Нені провулок	провулок Нені
Неплія провулок	провулок Неплія
Неплюєва провулок	провулок Неплюєва
Нічика провулок	провулок Нічика
Нічлава провулок	провулок Нічлава
Нове Життя провулок	провулок Нове Життя
Нової провулок	провулок Нової
Новорибцівській провулок	провулок Новорибцівській
Новоселів провулок	провулок Новоселів
Оберігу провулок	провулок Оберігу
Обручаєва провулок	провулок Обручаєва
Огієвських провулок	провулок Огієвських
Огородній провулок	провулок Огородній
Огреба провулок	провулок Огреба
Оздоровчий провулок	провулок Оздоровчий
Озера Хасан провулок	провулок Озера Хасан
Ольговичів провулок	провулок Ольговичів
Онілової провулок	провулок Онілової
Орача провулок	провулок Орача
Ордженікідзе провулок	провулок Ордженікідзе
Орджонікідзе провулок	провулок Орджонікідзе
Орчик провулок	провулок Орчик
Осінній провулок	провулок Осінній
Осіньнній провулок	провулок Осіньнній
Осоавіахіма провулок	провулок Осоавіахіма
П’ятикопа вулиці провулок	провулок Пʼятикопа вулиці
П’ятисотенниць провулок	провулок Пʼятисотенниць
Партико провулок	провулок Партико
Парфилів провулок	провулок Парфилів
Пасаж провулок	провулок Пасаж
Пацаєва провулок	провулок Пацаєва
Пашенної провулок	провулок Пашенної
Переїзної провулок	провулок Переїзної
Першотравневй провулок	провулок Першотравневй
Першотравневої вулиці провулок	провулок Першотравневої вулиці
Першотравненвий провулок	провулок Першотравненвий
Петефі провулок	провулок Петефі
Пишканя провулок	провулок Пишканя
Підварок провулок	провулок Підварок
Підгородній провулок	провулок Підгородній
Пілотів провулок	провулок Пілотів
Піонерських Таборів провулок	провулок Піонерських Таборів
Піший провулок	провулок Піший
Пластунів провулок	провулок Пластунів
Повстання Броненосця Потьомкін провулок	провулок Повстання Броненосця Потьомкін
Повстання провулок	провулок Повстання
Поділ провулок	провулок Поділ
Поезії провулок	провулок Поезії
Полєтаєва провулок	провулок Полєтаєва
Полковника Бурляя провулок	провулок Полковника Бурляя
Полку Азов провулок	провулок Полку Азов
Пологий провулок	провулок Пологий
Поштарка провулок	провулок Поштарка
Праці провулок	провулок Праці
Прибой провулок	провулок Прибой
Пригородній провулок	провулок Пригородній
Пристань провулок	провулок Пристань
провулок А	провулок А
провулок Головний	провулок Головний
провулок Дружби народів	провулок Дружби народів
провулок Енергетиків	провулок Енергетиків
провулок Зелений	провулок Зелений
провулок Комсомольский	провулок Комсомольский
провулок Короткий	провулок Короткий
провулок Леси Украинки	провулок Леси Украинки
провулок Лісний	провулок Лісний
провулок Миру	провулок Миру
провулок Набережної вулиці	провулок Набережної вулиці
провулок Незалежності	провулок Незалежності
провулок Перемоги	провулок Перемоги
провулок Першотравневий	провулок Першотравневий
провулок Пипенка	провулок Пипенка
провулок Рад	провулок Рад
провулок Свободи	провулок Свободи
провулок Січових Стрільців	провулок Січових Стрільців
Проїжджий провулок	провулок Проїжджий
Проїзджий провулок	провулок Проїзджий
Проїзжий провулок	провулок Проїзжий
Прокоф’єва провулок	провулок Прокофʼєва
Пролетарській провулок	провулок Пролетарській
Променистий провулок	провулок Променистий
Просторий провулок	провулок Просторий
Профінтерну провулок	провулок Профінтерну
Прохожий провулок	провулок Прохожий
Прямий провулок	провулок Прямий
Пудівітра провулок	провулок Пудівітра
Пшеничка провулок	провулок Пшеничка
Рабочий провулок	провулок Рабочий
Радіо провулок	провулок Радіо
Радсело провулок	провулок Радсело
Рапної провулок	провулок Рапної
Рататюків провулок	провулок Рататюків
Рафієва провулок	провулок Рафієва
Ревазо Циклаурі провулок	провулок Ревазо Циклаурі
Революції провулок	провулок Революції
Ремісничий провулок	провулок Ремісничий
Решетів провулок	провулок Решетів
Рибачий провулок	провулок Рибачий
Рилеєва провулок	провулок Рилеєва
Різьбярів провулок	провулок Різьбярів
Робесп’єра провулок	провулок Робеспʼєра
Робітничий провулок	провулок Робітничий
Робітничий Провулок	Провулок Робітничий
Робітничій провулок	провулок Робітничій
Робочий провулок	провулок Робочий
родина Калішевських провулок	провулок родина Калішевських
Родини Пищевичів провулок	провулок Родини Пищевичів
Родини Рвачових провулок	провулок Родини Рвачових
Родини Русових провулок	провулок Родини Русових
Родини Смирнових провулок	провулок Родини Смирнових
Родини Якубовських провулок	провулок Родини Якубовських
Родючий провулок	провулок Родючий
Роївка провулок	провулок Роївка
Ромейка провулок	провулок Ромейка
Роменця провулок	провулок Роменця
Россіні провулок	провулок Россіні
Руставелі провулок	провулок Руставелі
Руфа провулок	провулок Руфа
Ручай провулок	провулок Ручай
Сакко і Ванцетті провулок	провулок Сакко і Ванцетті
Саносвітній провулок	провулок Саносвітній
Сапельника провулок	провулок Сапельника
Світанку провулок	провулок Світанку
Світлий провулок	провулок Світлий
Світло Шахтаря провулок	провулок Світло Шахтаря
Семенішина провулок	провулок Семенішина
Серго провулок	провулок Серго
Середній В’їзд провулок	провулок Середній Вʼїзд
Середній провулок	провулок Середній
Серп і Молот провулок	провулок Серп і Молот
Синюха провулок	провулок Синюха
Сімʼї Тарасевичів провулок	провулок Сімʼї Тарасевичів
Скелястий провулок	провулок Скелястий
Скоблі провулок	провулок Скоблі
Скульптора Вітрика провулок	провулок Скульптора Вітрика
Смоловика провулок	провулок Смоловика
Снайпера провулок	провулок Снайпера
Собачий провулок	провулок Собачий
Соколів провулок	провулок Соколів
Соколовських провулок	провулок Соколовських
Солеварів провулок	провулок Солеварів
Солонці провулок	провулок Солонці
Солонцюватий провулок	провулок Солонцюватий
Сонячної провулок	провулок Сонячної
Сорокаріччя Жовтня провулок	провулок Сорокаріччя Жовтня
Соцпраці провулок	провулок Соцпраці
Спадистий провулок	провулок Спадистий
Спєшнєва провулок	провулок Спєшнєва
Співочий провулок	провулок Співочий
Сріблястий провулок	провулок Сріблястий
Старий Вал провулок	провулок Старий Вал
Старий провулок	провулок Старий
Старий шлях провулок	провулок Старий шлях
Стасової провулок	провулок Стасової
Стачок провулок	провулок Стачок
Суржана провулок	провулок Суржана
Сухий Ізюмець провулок	провулок Сухий Ізюмець
Сухий провулок	провулок Сухий
Сухий Яр провулок	провулок Сухий Яр
Схід провулок	провулок Схід
Табукашвілі провулок	провулок Табукашвілі
Тайберів провулок	провулок Тайберів
Таймиру провулок	провулок Таймиру
Танєва провулок	провулок Танєва
Танєєва провулок	провулок Танєєва
Танкопія провулок	провулок Танкопія
Творчий провулок	провулок Творчий
Тевелєва провулок	провулок Тевелєва
Теренок провулок	провулок Теренок
Тєністий провулок	провулок Тєністий
Тихий провулок	провулок Тихий
Тищика провулок	провулок Тищика
Тімірязєва провулок	провулок Тімірязєва
Тірас провулок	провулок Тірас
Тобілевичів провулок	провулок Тобілевичів
Тольятті провулок	провулок Тольятті
Тонконіг провулок	провулок Тонконіг
Тополина провулок	провулок Тополина
Травневої провулок	провулок Травневої
Тракторної провулок	провулок Тракторної
Троянд провулок	провулок Троянд
Трублаїні провулок	провулок Трублаїні
Труда провулок	провулок Труда
Трудових резервів провулок	провулок Трудових резервів
Труща провулок	провулок Труща
Тупий провулок	провулок Тупий
Тупик провулок	провулок Тупик
Тупік провулок	провулок Тупік
Тургєнєва провулок	провулок Тургєнєва
Ударника провулок	провулок Ударника
Удачі провулок	провулок Удачі
Українських воїнів провулок	провулок Українських воїнів
Українських Матерів провулок	провулок Українських Матерів
Ульянових провулок	провулок Ульянових
Фабриціуса провулок	провулок Фабриціуса
Фабріціуса провулок	провулок Фабріціуса
Фадеєва провулок	провулок Фадеєва
Фалалеєва провулок	провулок Фалалеєва
Федько провулок	провулок Федько
Фіалок провулок	провулок Фіалок
Фізкультурника провулок	провулок Фізкультурника
Фікселя провулок	провулок Фікселя
Філодорів провулок	провулок Філодорів
Фісака провулок	провулок Фісака
Флоксов провулок	провулок Флоксов
Франко провулок	провулок Франко
Фруктових садів провулок	провулок Фруктових садів
Фрунзе провулок	провулок Фрунзе
Хазана провулок	провулок Хазана
Хвилястий провулок	провулок Хвилястий
Хитрий провулок	провулок Хитрий
Хитрий Ринок провулок	провулок Хитрий Ринок
Хіміків провулок	провулок Хіміків
Хлібороба провулок	провулок Хлібороба
Хліборобів провулок	провулок Хліборобів
Хмельницьке шосе провулок	провулок Хмельницьке шосе
Хрещатик провулок	провулок Хрещатик
Хриcтини Сушко провулок	провулок Христини Сушко
ХТЗ провулок	провулок ХТЗ
Хутір провулок	провулок Хутір
Цадика провулок	провулок Цадика
Центральної вулиці провулок	провулок Центральної вулиці
Циганика провулок	провулок Циганика
Цимбалів Яр провулок	провулок Цимбалів Яр
Цуперів провулок	провулок Цуперів
Чайкіної провулок	провулок Чайкіної
Червогоро Хреста провулок	провулок Червогоро Хреста
Червона Гірка провулок	провулок Червона Гірка
Червоних Зорь провулок	провулок Червоних Зорь
Червоних партизан провулок	провулок Червоних партизан
Червоних Партизан провулок	провулок Червоних Партизан
Червоних Троянд провулок	провулок Червоних Троянд
Червонія провулок	провулок Червонія
Черлінка провулок	провулок Черлінка
Чернечий провулок	провулок Чернечий
Чернявка провулок	провулок Чернявка
Чижевських провулок	провулок Чижевських
Чистий провулок	провулок Чистий
Чмилів провулок	провулок Чмилів
Чумак провулок	провулок Чумак
Шакала провулок	провулок Шакала
Шахтарів провулок	провулок Шахтарів
Шахунянца провулок	провулок Шахунянца
Шашко провулок	провулок Шашко
Шверніка провулок	провулок Шверніка
Шепотинника провулок	провулок Шепотинника
Шептицьких провулок	провулок Шептицьких
Шереметка провулок	провулок Шереметка
Шкільній провулок	провулок Шкільній
Шлях провулок	провулок Шлях
Шостопарк провулок	провулок Шостопарк
Штагера провулок	провулок Штагера
Щастя провулок	провулок Щастя
Щедрий провулок	провулок Щедрий
Южноуральскій провулок	провулок Южноуральскій
Юннатів провулок	провулок Юннатів
Яблочкіної провулок	провулок Яблочкіної
Якіра провулок	провулок Якіра
Ярий провулок	провулок Ярий
III Інтернаціоналу провулок	провулок III Інтернаціоналу
XX Партз’їзду провулок	провулок XX Партзʼїзду
XX-го Партз’їзду провулок	провулок XX-го Партзʼїзду