
А провулок	провулок А
Абай проспект	Абай проспект
Абдалієва вулиця	Абдалієва вулиця
Авальяні вулиця	Авальяні вулиця
Августо Донніні вулиця	Августо Донніні вулиця
Авіамістечко вулиця	Авіамістечко вулиця
Авіаторів вулиця	Авіаторів вулиця
Авіаторів провулок	Авіаторів провулок
Авіації вулиця	Авіації вулиця
Авіації площа	Авіації площа
Авіації провулок	Авіації провулок
Автобан Львів-Краковець	Автобан Львів-Краковець
Автобуду вулиця	Автобуду вулиця
автодорога Тернопіль-Стрий	автодорога Тернопіль-Стрий
Автодорога Умань-Краковець	Автодорога Умань-Краковець
автодорога Умань-Львів-Краковець	автодорога Умань-Львів-Краковець
Автодорога Харьков-Симферополь-	Автодорога Харьков-Симферополь-
Автодром Космічний	Автодром Космічний
Автолюбителів вулиця	Автолюбителів вулиця
Агабек-Заде вулиця	Агабек-Заде вулиця
Агап’єва вулиця	Агапʼєва вулиця
Агнії Барто вулиця	Агнії Барто вулиця
Агнона вулиця	Агнона вулиця
Аграрана вулиця	Аграрна вулиця
Агромістечко вулиця	Агромістечко вулиця
Адамчика провулок	Адамчика провулок
Адермаха вулиця	Адермаха вулиця
Адмірала Завойка вулиця	Адмірала Завойка вулиця
Адмірала Траверсе вулиця	Адмірала Траверсе вулиця
Адягош вулиця	Адягош вулиця
Аеродром вулиця	Аеродром вулиця
Аеродромне шосе	Аеродромне шосе
Аеронавтів вулиця	Аеронавтів вулиця
Аерофлоту вулиця	Аерофлоту вулиця
Азєва вулиця	Азєва вулиця
Азов'я квартал	Азовʼя квартал
Азовсталі вулиця	Азовсталі вулиця
Азовсталі провулок	Азовсталі провулок
Аіровое вулиця	Аіровое вулиця
Ай-Валенти-Богах (Гидротехническая)	Ай-Валенти-Богах (Гидротехническая)
Академія мистецтв	Академія мистецтв
Акац вулиця	Акац вулиця
Акацієва вулиця	Акацієва вулиця
Акацієвий провулок	Акацієвий провулок
Акації вулиця	Акації вулиця
Акацій вулиця	Акацій вулиця
Акацфа вулиця	Акацфа вулиця
Акіма вулиця	Акіма вулиця
Аккерман вулиця	Аккерман вулиця
Аксьонкіної вулиця	Аксьонкіної вулиця
Активіста провулок	Активіста провулок
Алвег вулиця	Алвег вулиця
Алеєва вулиця	Алеєва вулиця
Алеї вулиця	Алеї вулиця
Алексеевка - Павлово Поле	Алексеевка - Павлово Поле
Алея артилеристів	Алея артилеристів
Алея Афганців	Алея Афганців
Алея Ветеранів	Алея Ветеранів
Алея визволителів міста	Алея визволителів міста
Алея вулиця	Алея вулиця
Алея героїв	Алея героїв
Алея Героїв	Алея Героїв
Алея Героїв АТО	Алея Героїв АТО
Алея закоханих	Алея закоханих
Алея казок	Алея казок
алея лікарських трав	алея лікарських трав
Алея ліхтарів	Алея ліхтарів
Алея Миру вулиця	Алея Миру вулиця
Алея миру і єдності	Алея миру і єдності
Алея муз	Алея муз
Алея мучеників	Алея мучеників
Алея Пам’яті	Алея Памʼяті
Алея парасольок	Алея парасольок
Алея письменників	Алея письменників
Алея праведників	Алея праведників
Алея Путейка	Алея Путейка
Алея Сакур	Алея Сакур
Алея скульптур	Алея скульптур
Алея слави	Алея слави
Алея художників	Алея художників
Алєєксєєва вулиця	Алєєксєєва вулиця
Алиме Абденнаново	Алиме Абденнаново
Алих роз вулиця	Алих роз вулиця
Алімпія Галика вулиця	Алімпія Галика вулиця
Алфатар вулиця	Алфатар вулиця
Алчевських вулиця	Алчевських вулиця
Алшо Мікефалва вулиця	Алшо Мікефалва вулиця
Алшокерт вулиця	Алшокерт вулиця
Альпийские луга	Альпийские луга
Алюмінієва вулиця	Алюмінієва вулиця
Аляб’єва в’їзд	Аляб’єва вʼїзд
Аляб’єва вулиця	Алябʼєва вулиця
Аляб’єва провулок	Алябʼєва провулок
Америка вулиця	Америка вулиця
Ананьїна вулиця	Ананьїна вулиця
Ангеліної вулиця	Ангеліної вулиця
Андріоллі пасаж	Андріоллі пасаж
Андруса вулиця	Андруса вулиця
Андрущишиних вулиця	Андрущишиних вулиця
Анжея Хцюка вулиця	Анжея Хцюка вулиця
Анруд вулиця	Анруд вулиця
Антонінка вулиця	Антонінка вулиця
Антоніо Бланко алея	Антоніо Бланко алея
Антоніо-Бланко вулиця	Антоніо-Бланко вулиця
Апша вулиця	Апша вулиця
Араф’єва провулок	Арафʼєва провулок
Арвата вулиця	Арвата вулиця
Аргунових вулиця	Аргунових вулиця
Ардов вулиця	Ардов вулиця
Ареф’єва вулиця	Арефʼєва вулиця
Аріпей провулок	Аріпей провулок
Армії вулиця	Армії вулиця
Армії УНР вулиця	Армії УНР вулиця
Аросєва вулиця	Аросєва вулиця
Артозєєва вулиця	Артозєєва вулиця
Архитектора Кобелєва вулиця	Архитектора Кобелєва вулиця
Архитектора Кобелєва провулок	Архитектора Кобелєва провулок
Архітектора Бургіньйона вулиця	Архітектора Бургіньйона вулиця
Архітектора Дольніка вулиця	Архітектора Дольніка вулиця
Архітектора Кобелєва вулиця	Архітектора Кобелєва вулиця
Архітекторів вулиця	Архітекторів вулиця
Архітекторів провулок	Архітекторів провулок
Аршенєвських провулок	Аршенєвських провулок
Асало вулиця	Асало вулиця
Асаулюка вулиця	Асаулюка вулиця
Асаф’єва вулиця	Асафʼєва вулиця
Аскольдів провулок	Аскольдів провулок
Асталоша вулиця	Асталоша вулиця
Атерлея вулиця	Атерлея вулиця
Атерлея провулок	Атерлея провулок
Аттіло вулиця	Аттіло вулиця
Афган сектор	Афган сектор
Ахієзерів вулиця	Ахієзерів вулиця
Ахромєєва вулиця	Ахромєєва вулиця
Б провулок	Б провулок
Б'єжика вулиця	Бʼєжика вулиця
Ба Лев	Ба Лев
Баблідзе вулиця	Баблідзе вулиця
Баботка вулиця	Баботка вулиця
Бабусин провулок	Бабусин провулок
Бабушкина тупик	Бабушкина тупик
Бавикі вулиця	Бавикі вулиця
Багата вулиця	Багата вулиця
Баглія вулиця	Баглія вулиця
Бадаєва вулиця	Бадаєва вулиця
Бадаєва провулок	Бадаєва провулок
База вулиця	База вулиця
Базавлука провулок	Базавлука провулок
Базанової вулиця	Базанової вулиця
Базарная вулиця	Базарная вулиця
Базилєєва вулиця	Базилєєва вулиця
Базів Кут вулиця	Базів Кут вулиця
Баївка вулиця	Баївка вулиця
Байка вулиця	Байка вулиця
Байрам вулиця	Байрам вулиця
Бакинских комиссаров вулиця	Бакинских комиссаров вулиця
Бакинських Комісарів вулиця	Бакинських Комісарів вулиця
Бакинських Комісарів площа	Бакинських Комісарів площа
Бакинських Комісарів провулок	Бакинських Комісарів провулок
Бакінських Комісарів вулиця	Бакінських Комісарів вулиця
Бакінських Комісарів провулок	Бакінських Комісарів провулок
Бакоцино вулиця	Бакоцино вулиця
Бакшеєва вулиця	Бакшеєва вулиця
Балаєва вулиця	Балаєва вулиця
БАМ вулиця	БАМ вулиця
Бані вулиця	Бані вулиця
Барабася вулиця	Барабася вулиця
Барабаш вулиця	Барабаш вулиця
Барабашів вулиця	Барабашів вулиця
Барахтія вулиця	Барахтія вулиця
Барвиста вулиця	Барвиста вулиця
Барвистий провулок	Барвистий провулок
Барвіновка вулиця	Барвіновка вулиця
Барвінських вулиця	Барвінських вулиця
Баржака вулиця	Баржака вулиця
Барила вулиця	Барила вулиця
Бариш вулиця	Бариш вулиця
Барляєва вулиця	Барляєва вулиця
Батарея вулиця	Батарея вулиця
Батаршина вулиця	Батаршина вулиця
Батиря вулиця	Батиря вулиця
Батіг вулиця	Батіг вулиця
Батракової вулиця	Батракової вулиця
Батурко вулиця	Батурко вулиця
Батька вулиця	Батька вулиця
Батьківщина вулиця	Батьківщина вулиця
Бахірєва вулиця	Бахірєва вулиця
Бахметьєва вулиця	Бахметьєва вулиця
Бахрушина вулиця	Бахрушина вулиця
Бачинських вулиця	Бачинських вулиця
Башта вулиця	Башта вулиця
Баюка вулиця	Баюка вулиця
Бебюш Капон провулок	Бебюш Капон провулок
Бежика вулиця	Бежика вулиця
Безводня вулиця	Безводня вулиця
Безкаравайної вулиця	Безкаравайної вулиця
Безкрайня вулиця	Безкрайня вулиця
Безнадецьких провулок	Безнадецьких провулок
Безпалько вулиця	Безпалько вулиця
Безрадецької вулиця	Безрадецької вулиця
Безрук вулиця	Безрук вулиця
Бейкешчобо вулиця	Бейкешчобо вулиця
Бейли Іллейша вулиця	Бейли Іллейша вулиця
Беке вулиця	Беке вулиця
Белая будка тупик	Белая будка тупик
Бельмаж вулиця	Бельмаж вулиця
Бенделіані вулиця	Бенделіані вулиця
Бендяка вулиця	Бендяка вулиця
Берві вулиця	Берві вулиця
Бердо вулиця	Бердо вулиця
Бердуха хутір	Бердуха хутір
Берег вулиця	Берег вулиця
Берег моря	Берег моря
Берегдаровці вулиця	Берегдаровці вулиця
Берегині провулок	Берегині провулок
Берегівщина вулиця	Берегівщина вулиця
Береговщиина вулиця	Береговщиина вулиця
Береґовець вулиця	Береґовець вулиця
Бережанка вулиця	Бережанка вулиця
Бережок вулиця	Бережок вулиця
Березена вулиця	Березена вулиця
Березнегувата вулиця	Березнегувата вулиця
Березня вулиця	Березня вулиця
Березняк вулиця	Березняк вулиця
Березовка вулиця	Березовка вулиця
Берзіня вулиця	Берзіня вулиця
Беркоса в’їзд	Беркоса вʼїзд
Беркоса вулиця	Беркоса вулиця
Берута вулиця	Берута вулиця
Берута провулок	Берута провулок
Берчені вулиця	Берчені вулиця
Берiнга вулиця	Берінга вулиця
Бесарабія вулиця	Бесарабія вулиця
Бєгоулєва вулиця	Бєгоулєва вулиця
Бистрячок вулиця	Бистрячок вулиця
Біблика вулиця	Біблика вулиця
Бігуча вулиця	Бігуча вулиця
Бізе вулиця	Бізе вулиця
Бізе провулок	Бізе провулок
Білгород вулиця	Білгород вулиця
Білгород провулок	Білгород провулок
Біле Джерело вулиця	Біле Джерело вулиця
Білий місток	Білий місток
Білий провулок	Білий провулок
Білика вулиця	Білика вулиця
Білих Акацій вулиця	Білих Акацій вулиця
Білих акацій провулок	Білих акацій провулок
Білокоровицьке шосе	Білокоровицьке шосе
Білокур вулиця	Білокур вулиця
Білосток вулиця	Білосток вулиця
Білостоцьких вулиця	Білостоцьких вулиця
Білчина вулиця	Білчина вулиця
Більче-Волиця вулиця	Більче-Волиця вулиця
Біляївка в'їзд	Біляївка вʼїзд
Біляївка вулиця	Біляївка вулиця
Бірок вулиця	Бірок вулиця
Благовіщення вулиця	Благовіщення вулиця
Благодиря вулиця	Благодиря вулиця
Благоєва вулиця	Благоєва вулиця
Благоєва провулок	Благоєва провулок
Блажевич вулиця	Блажевич вулиця
Бланка вулиця	Бланка вулиця
Блашкуна вулиця	Блашкуна вулиця
Блискучий провулок	Блискучий провулок
Бобрових вулиця	Бобрових вулиця
Богата вулиця	Богата вулиця
Богойка вулиця	Богойка вулиця
Богомольца вулиця	Богомольца вулиця
Богунія вулиця	Богунія вулиця
Богуславка вулиця	Богуславка вулиця
Бодинька вулиця	Бодинька вулиця
Бодянських вулиця	Бодянських вулиця
Божків Яр вулиця	Божків Яр вулиця
Бойківчанка вулиця	Бойківчанка вулиця
Бойко вулиця	Бойко вулиця
Бойчак вулиця	Бойчак вулиця
Бокія вулиця	Бокія вулиця
Бокорашилор вулиця	Бокорашилор вулиця
Болгарка вулиця	Болгарка вулиця
Болденюка вулиця	Болденюка вулиця
Болдусєва вулиця	Болдусєва вулиця
Болоня вулиця	Болоня вулиця
Болота вулиця	Болота вулиця
Болотиста вулиця	Болотиста вулиця
Большак вулиця	Большак вулиця
Большая Кольцевая	Большая Кольцевая
Большая серия	Большая серия
Болярка вулиця	Болярка вулиця
Болятка вулиця	Болятка вулиця
Борзий провулок	Борзий провулок
Борисівька вулиця	Борисівька вулиця
Борисових вулиця	Борисових вулиця
Бориспольця вулиця	Бориспольця вулиця
Бористеня вулиця	Бористеня вулиця
Борисяка вулиця	Борисяка вулиця
Боричів Тік вулиця	Боричів Тік вулиця
Боричів узвіз	Боричів узвіз
Боркан вулиця	Боркан вулиця
Борканюка вулиця	Борканюка вулиця
Боровиця вулиця	Боровиця вулиця
Бородіно вулиця	Бородіно вулиця
Борсоєва вулиця	Борсоєва вулиця
Борчі вулиця	Борчі вулиця
Бособрода вулиця	Бособрода вулиця
Босонога Стежка	Босонога Стежка
Ботєва провулок	Ботєва провулок
Боярських Майстрів вулиця	Боярських Майстрів вулиця
Браво урочище	Браво урочище
Бразильця вулиця	Бразильця вулиця
Браїка вулиця	Браїка вулиця
Бранця вулиця	Бранця вулиця
Братеничі вулиця	Братеничі вулиця
Братерства вулиця	Братерства вулиця
Братив Сугаків вулиця	Братив Сугаків вулиця
Братній провулок	Братній провулок
Братня вулиця	Братня вулиця
Братьев Айвазовских	Братьев Айвазовских
Братьев Целио	Братьев Целио
Брачуна вулиця	Брачуна вулиця
Брезаноці площа	Брезаноці площа
Бреславських провулок	Бреславських провулок
Бридька вулиця	Бридька вулиця
Брикеля вулиця	Брикеля вулиця
Брилів провулок	Брилів провулок
Брилів Шлях вулиця	Брилів Шлях вулиця
Бринька вулиця	Бринька вулиця
Брів-ла-Гайард вулиця	Брів-ла-Гайард вулиця
Брід Маклая	Брід Маклая
брід на косу	брід на косу
Брідок вулиця	Брідок вулиця
Бровещина вулиця	Бровещина вулиця
Бровків тупик	Бровків тупик
Брод летний	Брод летний
Бродок вулиця	Бродок вулиця
Бродських вулиця	Бродських вулиця
Броненосця «Потьомкін» вулиця	Броненосця «Потьомкін» вулиця
Броненосця Потьомкін вулиця	Броненосця Потьомкін вулиця
Бронзоса вулиця	Бронзоса вулиця
Бруно вулиця	Бруно вулиця
Брюховця вулиця	Брюховця вулиця
Бугаївка вулиця	Бугаївка вулиця
Бугриста вулиця	Бугриста вулиця
Бугристий провулок	Бугристий провулок
Буда вулиця	Буда вулиця
Будаєва вулиця	Будаєва вулиця
Будая вулиця	Будая вулиця
Будинки МПС вулиця	Будинки МПС вулиця
Будинку Відпочинку вулиця	Будинку Відпочинку вулиця
Будинок відпочинку	Будинок відпочинку
Будинок Відпочинку вулиця	Будинок Відпочинку вулиця
Будинок побуту	Будинок побуту
Будителів вулиця	Будителів вулиця
Будівельниа вулиця	Будівельниа вулиця
Будівельника Забурдаєва проспект	Будівельника Забурдаєва проспект
Будівельникі вулиця	Будівельникі вулиця
Будівника вулиця	Будівника вулиця
Будіндустрії вулиця	Будіндустрії вулиця
Будникової вулиця	Будникової вулиця
Будьогоно вулиця	Будьогоно вулиця
Будьоннівських Партизан вулиця	Будьоннівських Партизан вулиця
Бузника вулиця	Бузника вулиця
Букаєва вулиця	Букаєва вулиця
Буковель - пл. Томнатик	Буковель - пл. Томнатик
Буковина вулиця	Буковина вулиця
Буковинка вулиця	Буковинка вулиця
Буковиця вулиця	Буковиця вулиця
Булгаркерт вулиця	Булгаркерт вулиця
бульв. Будівельників	бульв. Будівельників
бульвар Гидронавтов	бульвар Гидронавтов
Бульвар Золотий берег	Бульвар Золотий берег
бульвар Золотой берег	бульвар Золотой берег
бульвар Ивана Франко	бульвар Ивана Франко
бульвар Ленина	бульвар Ленина
бульвар Миру	бульвар Миру
Бульвар Миру вулиця	Бульвар Миру вулиця
бульвар Пионеров	бульвар Пионеров
бульвар Пушкина	бульвар Пушкина
бульвар Трактористов	бульвар Трактористов
Бульвар Юности	Бульвар Юности
Бураковка вулиця	Бураковка вулиця
Бурачека вулиця	Бурачека вулиця
Бурга вулиця	Бурга вулиця
Буревісника вулиця	Буревісника вулиця
Бурзі вулиця	Бурзі вулиця
Бурих вулиця	Бурих вулиця
Буркут вулиця	Буркут вулиця
Буркута вулиця	Буркута вулиця
Бурякопункт вулиця	Бурякопункт вулиця
Бурячий провулок	Бурячий провулок
Бутишів провулок	Бутишів провулок
Буханець вулиця	Буханець вулиця
бухта Капсель	бухта Капсель
Буча вулиця	Буча вулиця
Бучацькі Гаї вулиця	Бучацькі Гаї вулиця
Бучиха вулиця	Бучиха вулиця
Буштрук вулиця	Буштрук вулиця
В’ячеслава Малі вулиця	Вʼячеслава Малі вулиця
В’ячеслава Чонровола вулиця	Вʼячеслава Чонровола вулиця
Вабля вулиця	Вабля вулиця
Вавилових вулиця	Вавилових вулиця
Вавілових вулиця	Вавілових вулиця
Вагина вулиця	Вагина вулиця
Вагона вулиця	Вагона вулиця
Вадас вулиця	Вадас вулиця
Вайгеля вулиця	Вайгеля вулиця
Вайнагія вулиця	Вайнагія вулиця
Вайнерів вулиця	Вайнерів вулиця
Вайсера вулиця	Вайсера вулиця
Вакарів вулиця	Вакарів вулиця
Валько вулиця	Валько вулиця
Вальсроде вулиця	Вальсроде вулиця
Валявка вулиця	Валявка вулиця
Ванагса вулиця	Ванагса вулиця
Ванцетті вулиця	Ванцетті вулиця
Ванцетті тупик	Ванцетті тупик
Вапнякове селище	Вапнякове селище
Вараш мікрорайон	Вараш мікрорайон
Варейкіса вулиця	Варейкіса вулиця
Варена вулиця	Варена вулиця
Варзара вулиця	Варзара вулиця
Варлена провулок	Варлена провулок
Вароді вулиця	Вароді вулиця
Вародія вулиця	Вародія вулиця
Варошдерек площа	Варошдерек площа
Вартових Неба вулиця	Вартових Неба вулиця
Варуш вулиця	Варуш вулиця
Василенкове Поле вулиця	Василенкове Поле вулиця
Василенкове Поле тупик	Василенкове Поле тупик
Василия Черного	Василия Черного
Васильєвих вулиця	Васильєвих вулиця
Васильєвка вулиця	Васильєвка вулиця
Васкула вулиця	Васкула вулиця
Васляєва вулиця	Васляєва вулиця
Васюніних вулиця	Васюніних вулиця
Ватоліної вулиця	Ватоліної вулиця
Ватутина квартал	Ватутина квартал
Вахрамеєва вулиця	Вахрамеєва вулиця
Вацетіса вулиця	Вацетіса вулиця
Вашартер вулиця	Вашартер вулиця
Вашут вулиця	Вашут вулиця
Веденєєва вулиця	Веденєєва вулиця
Ведмежий вулиця	Ведмежий вулиця
Ведмежий край	Ведмежий край
Веленце вулиця	Веленце вулиця
Велетень вулиця	Велетень вулиця
Велика Безкупчина вулиця	Велика Безкупчина вулиця
Велика вулиця	Велика вулиця
Велика Гольма вулиця	Велика Гольма вулиця
Велика Гряда вулиця	Велика Гряда вулиця
Велика Лубянка вулиця	Велика Лубянка вулиця
Велика Лунка вулиця	Велика Лунка вулиця
Велика Нараївка вулиця	Велика Нараївка вулиця
Велика Слобідка вулиця	Велика Слобідка вулиця
Велика Царинка вулиця	Велика Царинка вулиця
Велике кільце	Велике кільце
Велике коло	Велике коло
Велике Передмістя вулиця	Велике Передмістя вулиця
Великих провулок	Великих провулок
Великодня вулиця	Великодня вулиця
Величкіної вулиця	Величкіної вулиця
Величко вулиця	Величко вулиця
Велодоріжка ТНТУ	Велодоріжка ТНТУ
Велодорожка Пятихатки - Сокольники	Велодорожка Пятихатки - Сокольники
Венгерщина вулиця	Венгерщина вулиця
Веприк вулиця	Веприк вулиця
Вербанця вулиця	Вербанця вулиця
Вербник вулиця	Вербник вулиця
Вербоноля вулиця	Вербоноля вулиця
Верді вулиця	Верді вулиця
Веремієвої вулиця	Веремієвої вулиця
Верені вулиця	Верені вулиця
Веретка вулиця	Веретка вулиця
Верешморті вулиця	Верешморті вулиця
Верижиці провулок	Верижиці провулок
Верке вулиця	Верке вулиця
Верке тупик	Верке тупик
Веркепорт вулиця	Веркепорт вулиця
Верлана вулиця	Верлана вулиця
Вероне вулиця	Вероне вулиця
Верхнє Мікро	Верхнє Мікро
Верхні Кіреші вулиця	Верхні Кіреші вулиця
Верхні Лаканці	Верхні Лаканці
Верхній блок вулиця	Верхній блок вулиця
Верхній в’їзд	Верхній вʼїзд
Верхній вал вулиця	Верхній вал вулиця
Верхній Вал вулиця	Верхній Вал вулиця
Верхній Зворець вулиця	Верхній Зворець вулиця
Верхній Кінець вулиця	Верхній Кінець вулиця
Верхній масив	Верхній масив
Верхній міст	Верхній міст
Верхній Підгай вулиця	Верхній Підгай вулиця
Верхній провулок	Верхній провулок
Верхній тупик	Верхній тупик
Верхньовеселий провулок	Верхньовеселий провулок
Верхня алея	Верхня алея
Верхня Бережанка провулок	Верхня Бережанка провулок
Верхня вулиця	Верхня вулиця
Верхня Гребля вулиця	Верхня Гребля вулиця
Верхня Слобідка вулиця	Верхня Слобідка вулиця
Верхня Чабанка вулиця	Верхня Чабанка вулиця
Верховина вулиця	Верховина вулиця
Вершина провулок	Вершина провулок
Весела вулиця	Весела вулиця
Весела Дача вулиця	Весела Дача вулиця
Веселий в’їзд	Веселий вʼїзд
Веселий провулок	Веселий провулок
Веселий проїзд	Веселий проїзд
Веселка вулиця	Веселка вулиця
Весилий Хутір вулиця	Весилий Хутір вулиця
Весіння вулиця	Весіння вулиця
Весіча вулиця	Весіча вулиця
Весняних Конвалій провулок	Весняних Конвалій провулок
Веснянка вулиця	Веснянка вулиця
Ветаптека Зоомаркет	Ветаптека Зоомаркет
Вечірній бульвар	Вечірній бульвар
Вечірній провулок	Вечірній провулок
Вечірня вулиця	Вечірня вулиця
Взуттєва вулиця	Взуттєва вулиця
Взуттєвий провулок	Взуттєвий провулок
Виа феррата	Виа феррата
Вибрика вулиця	Вибрика вулиця
Вигін вулиця	Вигін вулиця
Вигнанка вулиця	Вигнанка вулиця
Вигода вулиця	Вигода вулиця
Вигон вулиця	Вигон вулиця
Вигуляра вулиця	Вигуляра вулиця
Видригана вулиця	Видригана вулиця
Видумка вулиця	Видумка вулиця
Вижула вулиця	Вижула вулиця
Визволення вулиця	Визволення вулиця
Визволення Донбасу вулиця	Визволення Донбасу вулиця
Визволення Донбасу провулок	Визволення Донбасу провулок
Визволення Донбасу проспект	Визволення Донбасу проспект
Визволення майдан	Визволення майдан
Визволення площа	Визволення площа
Визволення провулок	Визволення провулок
Визволителів бульвар	Визволителів бульвар
Визволителів в’їзд	Визволителів вʼїзд
Визволителів вулиця	Визволителів вулиця
Визволителів Донбасу проспект	Визволителів Донбасу проспект
Визволителів провулок	Визволителів провулок
Визволителів проспект	Визволителів проспект
Виїзд з АЗС	Виїзд з АЗС
Викладачів вулиця	Викладачів вулиця
Викреста вулиця	Викреста вулиця
Виксюка вулиця	Виксюка вулиця
Винниця вулиця	Винниця вулиця
Виноробів вулиця	Виноробів вулиця
Виноробів провулок	Виноробів провулок
Випробувачів вулиця	Випробувачів вулиця
Вираг вулиця	Вираг вулиця
Виробничий провулок	Виробничий провулок
Висаджена вулиця	Висаджена вулиця
Виселок вулиця	Виселок вулиця
Висока вулиця	Висока вулиця
Височанка вулиця	Височанка вулиця
Вись вулиця	Вись вулиця
Вихорєва вулиця	Вихорєва вулиця
Вишивана вулиця	Вишивана вулиця
Вишиванка вулиця	Вишиванка вулиця
Вишневецьких вулиця	Вишневецьких вулиця
Вишневої вулиці провулок	Вишневої вулиці провулок
Вишня вулиця	Вишня вулиця
Вівальді вулиця	Вівальді вулиця
Відважних вулиця	Відважних вулиця
Відважних тупик	Відважних тупик
Віддалена вулиця	Віддалена вулиця
Відкрита вулиця	Відкрита вулиця
Відкритий провулок	Відкритий провулок
Відомчий провулок	Відомчий провулок
Відоняка вулиця	Відоняка вулиця
Відпочинку вулиця	Відпочинку вулиця
Відпочинку провулок	Відпочинку провулок
Відродження в'їзд	Відродження вʼїзд
Відродження вулиця	Відродження вулиця
Відродження площа	Відродження площа
Відродження провулок	Відродження провулок
Відродження проспект	Відродження проспект
Віжень вулиця	Віжень вулиця
Військбуд вулиця	Військбуд вулиця
Військове містечко	Військове містечко
Військове Містечко вулиця	Військове Містечко вулиця
Військових Хірургів вулиця	Військових Хірургів вулиця
Військової Доблесті вулиця	Військової Доблесті вулиця
Вікторія вулиця	Вікторія вулиця
Віліса Лаціса вулиця	Віліса Лаціса вулиця
Віліса Лаціса провулок	Віліса Лаціса провулок
Вільних Козаків вулиця	Вільних Козаків вулиця
Вільних матросів вулиця	Вільних матросів вулиця
Вільної України	Вільної України
Вільшана вулиця	Вільшана вулиця
Віля Надворнюка вулиця	Віля Надворнюка вулиця
Вілʼямса вулиця	Вілʼямса вулиця
Віннера вулиця	Віннера вулиця
Вінницьке лісництво вулиця	Вінницьке лісництво вулиця
Вінницьке шосе	Вінницьке шосе
Віраг вулиця	Віраг вулиця
Вісконта вулиця	Вісконта вулиця
Вісника вулиця	Вісника вулиця
Віта вулиця	Віта вулиця
Вітрика вулиця	Вітрика вулиця
Вітрила вулиця	Вітрила вулиця
Вітру вулиця	Вітру вулиця
Віцана вулиця	Віцана вулиця
Вічових стрільців	Вічових стрільців
Вішталя вулиця	Вішталя вулиця
вкл. Махно	вкл. Махно
владимира великого	владимира великого
Внутрішній провулок	Внутрішній провулок
Вовчий провулок	Вовчий провулок
Вовчинець фрірайд	Вовчинець фрірайд
Вовчок вулиця	Вовчок вулиця
Вогнетривка вулиця	Вогнетривка вулиця
Водас вулиця	Водас вулиця
Водиця вулиця	Водиця вулиця
Водіїв вулиця	Водіїв вулиця
Водіїв провулок	Водіїв провулок
Водоканалбуд вулиця	Водоканалбуд вулиця
Водопровідника вулиця	Водопровідника вулиця
Водтелеп вулиця	Водтелеп вулиця
Воз'єднання вулиця	Возʼєднання вулиця
Воз’ єднання вулиця	Возʼ єднання вулиця
Воз’єднання вулиця	Возʼєднання вулиця
Возз'єднання вулиця	Воззʼєднання вулиця
Возз'єднання провулок	Воззʼєднання провулок
Возз’єднання бульвар	Воззʼєднання бульвар
Возз’єднання вулиця	Воззʼєднання вулиця
Возз’єднання провулок	Воззʼєднання провулок
Возз’єднання проспект	Воззʼєднання проспект
Воззʼєднання вулиця	Воззʼєднання вулиця
Воззʼєднання площа	Воззʼєднання площа
Возничий провулок	Возничий провулок
Возʼєднання провулок	Возʼєднання провулок
Воинов Интернационалистов	Воинов Интернационалистов
Воінів УПА вулиця	Воінів УПА вулиця
Воїнів Визволителів вулиця	Воїнів Визволителів вулиця
Воїнів вулиця	Воїнів вулиця
Воїнів УНР вулиця	Воїнів УНР вулиця
Воїнів УПА вулиця	Воїнів УПА вулиця
Воїнів УПА провулок	Воїнів УПА провулок
Воїнів УПАулиця	Воїнів УПАулиця
Воїнів-визволителів вулиця	Воїнів-визволителів вулиця
Воїнів-Сибіряків вулиця	Воїнів-Сибіряків вулиця
Воїнiв вулиця	Воїнів вулиця
Войтул вулиця	Войтул вулиця
Войциха вулиця	Войциха вулиця
Волинських Чехів вулиця	Волинських Чехів вулиця
Волиця вулиця	Волиця вулиця
Воловець вулиця	Воловець вулиця
Воловиця вулиця	Воловиця вулиця
Волонтерів вулиця	Волонтерів вулиця
Волонтерів провулок	Волонтерів провулок
Волосика вулиця	Волосика вулиця
Волочаєва вулиця	Волочаєва вулиця
Волошиних вулиця	Волошиних вулиця
Волошків провулок	Волошків провулок
Волощина вулиця	Волощина вулиця
Волховбуду вулиця	Волховбуду вулиця
Воля вулиця	Воля вулиця
Воронці вулиця	Воронці вулиця
Ворошина вулиця	Ворошина вулиця
Восток-I вулиця	Восток-I вулиця
Восток-II вулиця	Восток-II вулиця
Восходу вулиця	Восходу вулиця
Вошкина вулиця	Вошкина вулиця
Вояків Дивізії Галичина вулиця	Вояків Дивізії Галичина вулиця
Вояків УПА вулиця	Вояків УПА вулиця
Временная объездная дорога	Временная объездная дорога
Врізана вулиця	Врізана вулиця
Вротновських вулиця	Вротновських вулиця
Втіха вулиця	Втіха вулиця
Втората вулиця	Втората вулиця
Вузькоколійка вулиця	Вузькоколійка вулиця
вул. Жовтнева	вул. Жовтнева
вул. Зелена	вул. Зелена
вул. Зодчих	вул. Зодчих
Вул. Інглезіі	Вул. Інглезі
вул. Орджонікідзе	вул. Орджонікідзе
Вул. Церковна	Вул. Церковна
вулиця Базарна	вулиця Базарна
вулиця Битий Шлях	вулиця Битий Шлях
вулиця Бідненків	вулиця Бідненків
вулиця Бічна	вулиця Бічна
вулиця Благовісна	вулиця Благовісна
вулиця Будівельників	вулиця Будівельників
вулиця Варинського	вулиця Варинського
вулиця Весни	вулиця Весни
вулиця Ветеранів	вулиця Ветеранів
вулиця Визволителів	вулиця Визволителів
вулиця Виноградна	вулиця Виноградна
вулиця Вишнева	вулиця Вишнева
вулиця Гастелло	вулиця Гастелло
вулиця Героїв Крут	вулиця Героїв Крут
вулиця Героїв Майдану	вулиця Героїв Майдану
вулиця Героїв Маріуполя	вулиця Героїв Маріуполя
вулиця Героїв Пожежників	вулиця Героїв Пожежників
вулиця Героїв Рятувальників	вулиця Героїв Рятувальників
вулиця Героїв України	вулиця Героїв України
вулиця Головна	вулиця Головна
вулиця Горняків	вулиця Горняків
вулиця Дворянская	вулиця Дворянская
вулиця Добра	вулиця Добра
вулиця Дружби	вулиця Дружби
вулиця Дружби ІІ	2-га вулиця Дружби
вулиця Дружби народів	вулиця Дружби Народів
вулиця Єдності	вулиця Єдності
вулиця Жовтнева	вулиця Жовтнева
вулиця Замостянка	вулиця Замостянка
вулиця Запотічна	вулиця Запотічна
вулиця Затишна	вулиця Затишна
вулиця Зелена	вулиця Зелена
вулиця І. Килющика	вулиця І. Килющика
вулиця Колгоспна	вулиця Колгоспна
вулиця Комінтерна	вулиця Комінтерна
вулиця Копань	вулиця Копань
вулиця Космічна	вулиця Космічна
вулиця Космодемянської	вулиця Космодемянської
вулиця Космонавтів	вулиця Космонавтів
вулиця Левчишина	вулиця Левчишина
вулиця Лісна	вулиця Лісна
вулиця Межева	вулиця Межева
вулиця Металургів	вулиця Металургів
вулиця Миру	вулиця Миру
вулиця Мусорського	вулиця Мусорського
вулиця Незалежності	вулиця Незалежності
вулиця Обболонь	вулиця Обболонь
вулиця Огуленко	вулиця Огуленко
вулиця Перелісна	вулиця Перелісна
вулиця Перемоги	вулиця Перемоги
вулиця Першотравнева	вулиця Першотравнева
вулиця Підлісна	вулиця Підлісна
вулиця Правосуддя	вулиця Правосуддя
вулиця Праці	вулиця Праці
вулиця Примирення	вулиця Примирення
вулиця Приозерна	вулиця Приозерна
вулиця Прошинського	вулиця Прошинського
вулиця Роз вулиця	вулиця Роз вулиця
вулиця Руставі	вулиця Руставі
вулиця Свободи	вулиця Свободи
вулиця Середня	вулиця Середня
вулиця Січових Стрільців	вулиця Січових Стрільців
вулиця Слобода	вулиця Слобода
Вулиця Соборності	Вулиця Соборності
вулиця Сороківщина	вулиця Сороківщина
вулиця Струмінського	вулиця Струмінського
Вулиця Тиха	Вулиця Тиха
вулиця Травнева	вулиця Травнева
вулиця Українських Повстанців	вулиця Українських Повстанців
вулиця Ульянових	вулиця Ульянових
вулиця Фрунзе	вулиця Фрунзе
вулиця Хрещатик	вулиця Хрещатик
вулиця ЦТР	вулиця ЦТР
вулиця Чекістів	вулиця Чекістів
вулиця Червона	вулиця Червона
вулиця Чулея	вулиця Чулея
Вулиця Шептицьких	Вулиця Шептицьких
вулиця Щастя	вулиця Щастя
вулиця Юності	вулиця Юності
вулиця Яблочна	вулиця Яблочна
вулиця Яблунева	вулиця Яблунева
Вуліса вулиця	Вуліса вулиця
Вулшава вулиця	Вулшава вулиця
Вургуна вулиця	Вургуна вулиця
Вутіша вулиця	Вутіша вулиця
Вучкана вулиця	Вучкана вулиця
Вчених вулиця	Вчених вулиця
Вчителів вулиця	Вчителів вулиця
Вiдродження вулиця	Відродження вулиця
Гаврана вулиця	Гаврана вулиця
Гавришів Кут вулиця	Гавришів Кут вулиця
Гавришко вулиця	Гавришко вулиця
Гагарина вулиця	Гагарина вулиця
Гагарина квартал	Гагарина квартал
Гагарина проспект	Гагарина проспект
Гагенмейстера вулиця	Гагенмейстера вулиця
Газети «Іскра» вулиця	Газети «Іскра» вулиця
Газети «Комсомолець Донбасу» вулиця	Газети «Комсомолець Донбасу» вулиця
Газети «Правда» вулиця	Газети «Правда» вулиця
Газети «Правда» провулок	Газети «Правда» провулок
Газети «Правда» проспект	Газети «Правда» проспект
Газети Зоря вулиця	Газети Зоря вулиця
Газети Правда вулиця	Газети Правда вулиця
Газло вулиця	Газло вулиця
Газовиков вулиця	Газовиков вулиця
Газовка вулиця	Газовка вулиця
Газопровід вулиця	Газопровід вулиця
Газотраса Північно-Західна	Газотраса Північно-Західна
Гаї вулиця	Гаї вулиця
Гай вулиця	Гай вулиця
Гайок вулиця	Гайок вулиця
Галаєва вулиця	Галаєва вулиця
Галанчикової провулок	Галанчикової провулок
Галафеєва вулиця	Галафеєва вулиця
Галафєєва вулиця	Галафєєва вулиця
Галерея до Дальніх печер	Галерея до Дальніх печер
Галечко вулиця	Галечко вулиця
Галицьких Вояків вулиця	Галицьких Вояків вулиця
Галковскої вулиця	Галковскої вулиця
Гамаюна вулиця	Гамаюна вулиця
Гамбург вулиця	Гамбург вулиця
Гамора вулиця	Гамора вулиця
Ганді вулиця	Ганді вулиця
Ганопільске шосе	Ганопільске шосе
Гарама вулиця	Гарама вулиця
Гарамишина вулиця	Гарамишина вулиця
Гараса вулиця	Гараса вулиця
Гарб вулиця	Гарб вулиця
Гарбарів тупик	Гарбарів тупик
Гаргаєва вулиця	Гаргаєва вулиця
Гардемаринов бульвар	Гардемаринов бульвар
Гардимана вулиця	Гардимана вулиця
Гардоні вулиця	Гардоні вулиця
Гаришина вулиця	Гаришина вулиця
Гарібальді вулиця	Гарібальді вулиця
Гаркушина вулиця	Гаркушина вулиця
Гармонії вулиця	Гармонії вулиця
Гарнієра вулиця	Гарнієра вулиця
Гасина вулиця	Гасина вулиця
Гастелло вулиця	Гастелло вулиця
Гастелло провулок	Гастелло провулок
Гастелло тупик	Гастелло тупик
Гастело вулиця	Гастело вулиця
Гатила вулиця	Гатила вулиця
Гафурі вулиця	Гафурі вулиця
Гвая вулиця	Гвая вулиця
Гвоздичная вулиця	Гвоздичная вулиця
Гевденя вулиця	Гевденя вулиця
Гевліча вулиця	Гевліча вулиця
Гедьолйо вулиця	Гедьолйо вулиця
Гейдена вулиця	Гейдена вулиця
Гейзи Оноді вулиця	Гейзи Оноді вулиця
Гейне вулиця	Гейне вулиця
Гелевана вулиця	Гелевана вулиця
Гелевера вулиця	Гелевера вулиця
Гелевея вулиця	Гелевея вулиця
Генерала Арабея вулиця	Генерала Арабея вулиця
Генерала Васильева	Генерала Васильева
Генерала Видригана вулиця	Генерала Видригана вулиця
генерала Дерев’ янка вулиця	генерала Деревʼ янка вулиця
Генерала Дерев’янка вулиця	Генерала Деревʼянка вулиця
Генерала Дерев’янка провулок	Генерала Деревʼянка провулок
Генерала Єруха вулиця	Генерала Єруха вулиця
Генерала Куркчі вулиця	Генерала Куркчі вулиця
Генерала Лашина вулиця	Генерала Лашина вулиця
Генерала Леселідзе вулиця	Генерала Леселідзе вулиця
Генерала Обруча вулиця	Генерала Обруча вулиця
Генерала Плієва вулиця	Генерала Плієва вулиця
Генерала Плієва площа	Генерала Плієва площа
Генерала Путейка вулиця	Генерала Путейка вулиця
Генерала Пушкина	Генерала Пушкина
Генерала Трейка вулиця	Генерала Трейка вулиця
Генерала Цветаєва вулиця	Генерала Цветаєва вулиця
Генералів Сухинських провулок	Генералів Сухинських провулок
Геологів вулиця	Геологів вулиця
Геологів провулок	Геологів провулок
Геологів проїзд	Геологів проїзд
Геологів проспект	Геологів проспект
Георге Біяне вулиця	Георге Біяне вулиця
Геранієва вулиця	Геранієва вулиця
Гербурга вулиця	Гербурга вулиця
Геребенюка вулиця	Геребенюка вулиця
Героев аллея	Героев аллея
Героев Врадиевщини	Героев Врадиевщини
Героев Десантников проспект	Героев Десантников проспект
Героев Днепра	Героев Днепра
Героев Крут	Героев Крут
Героев Сталинграда	Героев Сталинграда
Героев Сталинграда квартал	Героев Сталинграда квартал
Героев Сталинграда проспект	Героев Сталинграда проспект
Героев Труда	Героев Труда
Героів Праці вулиця	Героів Праці вулиця
Героїв Авіаторів вулиця	Героїв Авіаторів вулиця
Героїв Азову вулиця	Героїв Азову вулиця
Героїв Азову провулок	Героїв Азову провулок
Героїв алея	Героїв алея
Героїв Армії УНР вулиця	Героїв Армії УНР вулиця
Героїв Ато вулиця	Героїв Ато вулиця
Героїв АТО вулиця	Героїв АТО вулиця
Героїв АТО проспект	Героїв АТО проспект
Героїв Афганістану вулиця	Героїв Афганістану вулиця
Героїв Базару	Героїв Базару
Героїв Базару вулиця	Героїв Базару вулиця
Героїв Берестечка вулиця	Героїв Берестечка вулиця
Героїв Бреста вулиця	Героїв Бреста вулиця
Героїв Бреста площа	Героїв Бреста площа
Героїв Бреста провулок	Героїв Бреста провулок
Героїв Бронепоїзда вулиця	Героїв Бронепоїзда вулиця
Героїв бульвар	Героїв бульвар
Героїв Бучі вулиця	Героїв Бучі вулиця
Героїв ВВВ майдан	Героїв ВВВ майдан
Героїв Ворзеля вулиця	Героїв Ворзеля вулиця
Героїв Ворзеля провулок	Героїв Ворзеля провулок
Героїв вулиця	Героїв вулиця
Героїв Гостомеля вулиця	Героїв Гостомеля вулиця
Героїв Гурб вулиця	Героїв Гурб вулиця
Героїв Дніпра алея	Героїв Дніпра алея
Героїв Дніпра вулиця	Героїв Дніпра вулиця
Героїв Дніпра провулок	Героїв Дніпра провулок
Героїв Дніпра проспект	Героїв Дніпра проспект
Героїв Євромайдану вулиця	Героїв Євромайдану вулиця
Героїв Євромайдану площа	Героїв Євромайдану площа
Героїв ЗСУ вулиця	Героїв ЗСУ вулиця
Героїв Ірпіня вулиця	Героїв Ірпіня вулиця
Героїв Києва вулиця	Героїв Києва вулиця
Героїв Космосу бульвар	Героїв Космосу бульвар
Героїв Космосу вулиця	Героїв Космосу вулиця
Героїв Краснодона вулиця	Героїв Краснодона вулиця
Героїв Краснодону вулиця	Героїв Краснодону вулиця
Героїв Кривбасу площа	Героїв Кривбасу площа
Героїв Крут алея	Героїв Крут алея
Героїв Крут бульвар	Героїв Крут бульвар
Героїв Крут вулиці	Героїв Крут вулиці
Героїв Крут вулиця	Героїв Крут вулиця
ГероЇв Крут вулиця	ГероЇв Крут вулиця
Героїв Крут площа	Героїв Крут площа
Героїв Крут провулок	Героїв Крут провулок
Героїв Крут тупик	Героїв Крут тупик
Героїв Ленінграду вулиця	Героїв Ленінграду вулиця
Героїв Майдану вулиця	Героїв Майдану вулиця
Героїв Майдану площа	Героїв Майдану площа
Героїв Майдану провулок	Героїв Майдану провулок
Героїв Маріуполя вулиця	Героїв Маріуполя вулиця
Героїв Маріуполя площа	Героїв Маріуполя площа
Героїв Маріуполя провулок	Героїв Маріуполя провулок
Героїв Мерефʼян вʼїзд	Героїв Мерефʼян вʼїзд
Героїв Миколаєва вулиця	Героїв Миколаєва вулиця
Героїв Мирополя вулиця	Героїв Мирополя вулиця
Героїв Міуса вулиця	Героїв Міуса вулиця
Героїв Нацгвардії вулиця	Героїв Нацгвардії вулиця
Героїв небесної сотні вулиця	Героїв небесної сотні вулиця
Героїв оборони	Героїв оборони
Героїв ОУН вулиця	Героїв ОУН вулиця
Героїв ОУН-УПА вулиця	Героїв ОУН-УПА вулиця
Героїв Перекопу вулиця	Героїв Перекопу вулиця
Героїв Підпілля вулиця	Героїв Підпілля вулиця
Героїв Пілотів в’їзд	Героїв Пілотів вʼїзд
Героїв Пілотів вулиця	Героїв Пілотів вулиця
Героїв площа	Героїв площа
Героїв Пожежних вулиця	Героїв Пожежних вулиця
Героїв поліції вулиця	Героїв поліції вулиця
Героїв Поліції вулиця	Героїв Поліції вулиця
Героїв полку «Азов» вулиця	Героїв полку «Азов» вулиця
Героїв Полку Азов вулиця	Героїв Полку Азов вулиця
Героїв праці вулиця	Героїв праці вулиця
Героїв Праці вулиця	Героїв Праці вулиця
Героїв провулок	Героїв провулок
Героїв проспект	Героїв проспект
Героїв Революції вулиця	Героїв Революції вулиця
Героїв Севастополя вулиця	Героїв Севастополя вулиця
Героїв Союзу вулиця	Героїв Союзу вулиця
Героїв Сталінграда вулиця	Героїв Сталінграда вулиця
Героїв Сталінграда площа	Героїв Сталінграда площа
Героїв Сталінграда проспект	Героїв Сталінграда проспект
Героїв Сталінграду бульвар	Героїв Сталінграду бульвар
Героїв Сталінграду вулиця	Героїв Сталінграду вулиця
Героїв Сталінграду квартал	Героїв Сталінграду квартал
Героїв Сталінграду площа	Героїв Сталінграду площа
Героїв Трипілля вулиця	Героїв Трипілля вулиця
Героїв труда вулиця	Героїв труда вулиця
Героїв УПА вулиця	Героїв УПА вулиця
Героїв УПА провулок	Героїв УПА провулок
Героїв Херсона вулиця	Героїв Херсона вулиця
Героїв Чернобиля вулиця	Героїв Чернобиля вулиця
Героїв Чорнобиля	Героїв Чорнобиля
Героїв Чорнобиля вулиця	Героїв Чорнобиля вулиця
Героїв Чорнобиля площа	Героїв Чорнобиля площа
Героїв Чорнобиля провулок	Героїв Чорнобиля провулок
Героїв Чорнобиля проспект	Героїв Чорнобиля проспект
Героїв-пожежних вулиця	Героїв-пожежних вулиця
Героїзму вулиця	Героїзму вулиця
Герой Крут	Герой Крут
Героя Бараболько вулиця	Героя Бараболько вулиця
ГЕС вулиця	ГЕС вулиця
ГЕС провулок	ГЕС провулок
Геся вулиця	Геся вулиця
Гете вулиця	Гете вулиця
Гечеі вулиця	Гечеі вулиця
Гєологічєскій провулок	Гєологічєскій провулок
Гибало вулиця	Гибало вулиця
Гидронавтов бульвар	Гидронавтов бульвар
Гиївка вулиця	Гиївка вулиця
Гирчичів провулок	Гирчичів провулок
Гідровузол Дениші	Гідровузол Дениші
Гіжицьких вулиця	Гіжицьких вулиця
Гізелли Дравої вулиця	Гізелли Дравої вулиця
Гіллястий провулок	Гіллястий провулок
Гінцака вулиця	Гінцака вулиця
Гірка вулиця	Гірка вулиця
Гіркиня вулиця	Гіркиня вулиця
Гірник провулок	Гірник провулок
Гірниче Селище вулиця	Гірниче Селище вулиця
Гірничий провулок	Гірничий провулок
Гірчичне Зерно провулок	Гірчичне Зерно провулок
Гіршмана вулиця	Гіршмана вулиця
Гладка вулиця	Гладка вулиця
Глеба Успенского	Глеба Успенского
Глезоса вулиця	Глезоса вулиця
Глибка вулиця	Глибка вулиця
Глибока вулиця	Глибока вулиця
Глибока Долина вулиця	Глибока Долина вулиця
Глибочиця вулиця	Глибочиця вулиця
Глинище вулиця	Глинище вулиця
Глинище провулок	Глинище провулок
Глинне вулиця	Глинне вулиця
Глинянка вулиця	Глинянка вулиця
Глібка вулиця	Глібка вулиця
Глібовських вулиця	Глібовських вулиця
Глієвих вулиця	Глієвих вулиця
Глухий провулок	Глухий провулок
Глушець вулиця	Глушець вулиця
Глушків провулок	Глушків провулок
Гнаровской провулок	Гнаровской провулок
Гнилицької вулиця	Гнилицької вулиця
Гнута береза	Гнута береза
Гнучка вулиця	Гнучка вулиця
Голлоші вулиця	Голлоші вулиця
Голлоші провулок	Голлоші провулок
Голобородько вулиця	Голобородько вулиця
Головболгарбуд вулиця	Головболгарбуд вулиця
Гололя вулиця	Гололя вулиця
Голондія вулиця	Голондія вулиця
Голоско Фтизіатир вулиця	Голоско Фтизіатир вулиця
Голубий Кут вулиця	Голубий Кут вулиця
Голубина вулиця	Голубина вулиця
Голубинка — Передовое — Широкое	Голубинка — Передовое — Широкое
Голубой залив	Голубой залив
Гольдбергів провулок	Гольдбергів провулок
Гольдфадена провулок	Гольдфадена провулок
Гольфклуб - Перемоги	Гольфклуб - Перемоги
Голядкина вулиця	Голядкина вулиця
Голятин вулиця	Голятин вулиця
Гомолка вулиця	Гомолка вулиця
Гомонової вулиця	Гомонової вулиця
Гоначара вулиця	Гоначара вулиця
Гонча вулиця	Гонча вулиця
Гончариха вулиця	Гончариха вулиця
Гончарі вулиця	Гончарі вулиця
Гончарів вулиця	Гончарів вулиця
Гопнер вулиця	Гопнер вулиця
Горб вулиця	Горб вулиця
Горб провулок	Горб провулок
Горби Пролісок вулиця	Горби Пролісок вулиця
Горбиста вулиця	Горбиста вулиця
Горбка вулиця	Горбка вулиця
Горбок вулиця	Горбок вулиця
Горбочок вулиця	Горбочок вулиця
Горбушка вулиця	Горбушка вулиця
Гордика вулиця	Гордика вулиця
Гординських вулиця	Гординських вулиця
Гордіюк вулиця	Гордіюк вулиця
Гордолина вулиця	Гордолина вулиця
Горішків вулиця	Горішків вулиця
Горішній Кінець вулиця	Горішній Кінець вулиця
Горішній кут вулиця	Горішній кут вулиця
Горішня Брама вулиця	Горішня Брама вулиця
Горішня вулиця	Горішня вулиця
Горішнянка вулиця	Горішнянка вулиця
Горка вулиця	Горка вулиця
Горлових провулок	Горлових провулок
Гормот вулиця	Гормот вулиця
Горностаєва вулиця	Горностаєва вулиця
Горняк вулиця	Горняк вулиця
Горняка вулиця	Горняка вулиця
Гороб'я вулиця	Горобʼя вулиця
Городища вулиця	Городища вулиця
Городище вулиця	Городище вулиця
Городищина вулиця	Городищина вулиця
Городній провулок	Городній провулок
Городній проїзд	Городній проїзд
Городній тупик	Городній тупик
Городня вулиця	Городня вулиця
Городок вулиця	Городок вулиця
Городской парк	Городской парк
Горошків тупик	Горошків тупик
Горука вулиця	Горука вулиця
Горчака вулиця	Горчака вулиця
Горчака провулок	Горчака провулок
Горянка вулиця	Горянка вулиця
Господарчий масив вулиця	Господарчий масив вулиця
Гостєва вулиця	Гостєва вулиця
Гостинець вулиця	Гостинець вулиця
Грабина вулиця	Грабина вулиця
Грабівець вулиця	Грабівець вулиця
Грабник вулиця	Грабник вулиця
Грабовець вулиця	Грабовець вулиця
Граве вулиця	Граве вулиця
Грайонца вулиця	Грайонца вулиця
Гранд Волинь	Гранд Волинь
Границя вулиця	Границя вулиця
Гранкар'єр вулиця	Гранкарʼєр вулиця
Графа фон Гарнієра вулиця	Графа фон Гарнієра вулиця
Графські сходи	Графські сходи
Граффа вулиця	Граффа вулиця
Гребеля вулиця	Гребеля вулиця
Гребля вулиця	Гребля вулиця
Греків провулок	Греків провулок
Грендєш вулиця	Грендєш вулиця
Гречко вулиця	Гречко вулиця
Гречнєва вулиця	Гречнєва вулиця
Грига вулиця	Грига вулиця
Григор’ єва вулиця	Григорʼ єва вулиця
Григор’єва вулиця	Григорʼєва вулиця
Григоровичів-Барських вулиця	Григоровичів-Барських вулиця
Гризана провулок	Гризана провулок
Гризодубових вулиця	Гризодубових вулиця
Гризодубової вулиця	Гризодубової вулиця
Гризодубової провулок	Гризодубової провулок
Гризун вулиця	Гризун вулиця
Грималюк вулиця	Грималюк вулиця
Гримучка вулиця	Гримучка вулиця
Гриневичів вулиця	Гриневичів вулиця
Гринчевої вулиця	Гринчевої вулиця
Грицевця бульвар	Грицевця бульвар
Грицевця вулиця	Грицевця вулиця
Гришана вулиця	Гришана вулиця
Грієвза вулиця	Грієвза вулиця
Грінвальда вулиця	Грінвальда вулиця
Грішина вулиця	Грішина вулиця
Громових вулиця	Громових вулиця
Грузина провулок	Грузина провулок
Грузія вулиця	Грузія вулиця
Груїшор вулиця	Груїшор вулиця
Грунських вулиця	Грунських вулиця
Грунських провулок	Грунських провулок
Грунь вулиця	Грунь вулиця
Грушевсько вулиця	Грушевсько вулиця
Грушко вулиця	Грушко вулиця
Грядкувата вулиця	Грядкувата вулиця
Гугеля вулиця	Гугеля вулиця
Гулаї вулиця	Гулаї вулиця
Гулевич вулиця	Гулевич вулиця
Гуняді вулиця	Гуняді вулиця
Гур'їва площа	Гурʼїва площа
Гур’єва вулиця	Гурʼєва вулиця
Гурамішвілі вулиця	Гурамішвілі вулиця
Гурамішвілі провулок	Гурамішвілі провулок
Гурвіча вулиця	Гурвіча вулиця
Гуреєва вулиця	Гуреєва вулиця
Гусинка вулиця	Гусинка вулиця
Густа рослинність	Густа рослинність
Гуті вулиця	Гуті вулиця
Гуцул Ленд Буковель	Гуцул Ленд Буковель
Гюго вулиця	Гюго вулиця
Ґвадані вулиця	Ґвадані вулиця
Ґеорґе Асакі вулиця	Ґеорґе Асакі вулиця
Ґете вулиця	Ґете вулиця
Ґрохольських вулиця	Ґрохольських вулиця
Ґрохольських провулок	Ґрохольських провулок
Ґрохольських тупик	Ґрохольських тупик
Давниця вулиця	Давниця вулиця
Давниця урочище	Давниця урочище
Давній вал вулиця	Давній вал вулиця
Давня вулиця	Давня вулиця
Дадіані вулиця	Дадіані вулиця
Далека вулиця	Далека вулиця
Дальницьке шосе	Дальницьке шосе
Дальній провулок	Дальній провулок
Дальня вулиця	Дальня вулиця
Данте провулок	Данте провулок
Даньшина вулиця	Даньшина вулиця
Дарко вулиця	Дарко вулиця
Дарницьке шосе	Дарницьке шосе
Дарничанка вулиця	Дарничанка вулиця
Дарчі Керт провулок	Дарчі Керт провулок
Дачка вулиця	Дачка вулиця
Дачная вулиця	Дачная вулиця
Дванадцятихатка вулиця	Дванадцятихатка вулиця
Двір вулиця	Двір вулиця
Двір площа	Двір площа
Дворище вулиця	Дворище вулиця
Девдюка вулиця	Девдюка вулиця
Деволана вулиця	Деволана вулиця
Дегтяря провулок	Дегтяря провулок
Дедишко вулиця	Дедишко вулиця
Деже Дьєрі вулиця	Деже Дьєрі вулиця
Дезидерія Задора вулиця	Дезидерія Задора вулиця
Дейгана вулиця	Дейгана вулиця
Дейнеко вулиця	Дейнеко вулиця
Декабристві вулиця	Декабристві вулиця
Делу-Дітре-Вей вулиця	Делу-Дітре-Вей вулиця
Дем’янів Лаз вулиця	Демʼянів Лаз вулиця
Деманта вулиця	Деманта вулиця
Деметра вулиця	Деметра вулиця
Демчуков вулиця	Демчуков вулиця
Депутатів вулиця	Депутатів вулиця
Дерев'янко вулиця	Деревʼянко вулиця
Дерев’янка вулиця	Деревʼянка вулиця
Деревянко вулиця	Деревянко вулиця
Дерекосег вулиця	Дерекосег вулиця
Дересів вулиця	Дересів вулиця
Дерчені вулиця	Дерчені вулиця
Детюка вулиця	Детюка вулиця
Дехтяря вулиця	Дехтяря вулиця
Дехтяря провулок	Дехтяря провулок
Децика І. вулиця	Децика І. вулиця
Дечебал вулиця	Дечебал вулиця
Дешево вулиця	Дешево вулиця
Джабаєва вулиця	Джабаєва вулиця
Джакомо Пуччіні вулиця	Джакомо Пуччіні вулиця
Джалія вулиця	Джалія вулиця
Джамбула вулиця	Джамбула вулиця
Джамбула Джабаєва вулиця	Джамбула Джабаєва вулиця
Джамбула Джабаєва провулок	Джамбула Джабаєва провулок
Джамбула провулок	Джамбула провулок
Джанаєва вулиця	Джанаєва вулиця
Джапарідзе вулиця	Джапарідзе вулиця
Джеджелія вулиця	Джеджелія вулиця
Джерело вулиця	Джерело вулиця
Джерело провулок	Джерело провулок
Джингарадзе вулиця	Джингарадзе вулиця
Джинчарадзе провулок	Джинчарадзе провулок
Джублик вулиця	Джублик вулиця
Джузеппе Верді вулиця	Джузеппе Верді вулиця
Джузеппе Гарібальді вулиця	Джузеппе Гарібальді вулиця
Джулаївка вулиця	Джулаївка вулиця
Дзвінка вулиця	Дзвінка вулиця
ДЗД - Колодязь	ДЗД - Колодязь
Дибковка вулиця	Дибковка вулиця
Диктатури Пролетаріату вулиця	Диктатури Пролетаріату вулиця
Димніча вулиця	Димніча вулиця
Динамо вулиця	Динамо вулиця
Директорії вулиця	Директорії вулиця
Дитинства вулиця	Дитинства вулиця
Дитячий провулок	Дитячий провулок
Дитячий світ	Дитячий світ
Діаманди Ґалас вулиця	Діаманди Ґалас вулиця
Дібровка вулиця	Дібровка вулиця
Дівоча вулиця	Дівоча вулиця
Дівочий провулок	Дівочий провулок
Дівче вулиця	Дівче вулиця
Діда Трофима вулиця	Діда Трофима вулиця
Дідріхсона вулиця	Дідріхсона вулиця
Дідро вулиця	Дідро вулиця
Дільничий провулок	Дільничий провулок
Дінця вулиця	Дінця вулиця
Дітей війни алея	Дітей війни алея
Діхтяря провулок	Діхтяря провулок
для людей с инвалидностью	для людей с инвалидностью
Для навигации	Для навигации
Дмитрия Яворницкого	Дмитрия Яворницкого
Днепровские пороги	Днепровские пороги
Дніпрельстан вулиця	Дніпрельстан вулиця
Дніпробуду вулиця	Дніпробуду вулиця
Дніпробуду провулок	Дніпробуду провулок
Дніпровскька вулиця	Дніпровскька вулиця
Дніпрогесу вулиця	Дніпрогесу вулиця
Дня Шахтаря вулиця	Дня Шахтаря вулиця
Добичіних вулиця	Добичіних вулиця
Доблесті провулок	Доблесті провулок
Добра Вода вулиця	Добра Вода вулиця
Добра вулиця	Добра вулиця
Добра провулок	Добра провулок
Добрий провулок	Добрий провулок
Добрий хутір вулиця	Добрий хутір вулиця
Добрий Шлях вулиця	Добрий Шлях вулиця
Добрих Сусідів вулиця	Добрих Сусідів вулиця
Добробут вулиця	Добробут вулиця
Добровідка вулиця	Добровідка вулиця
Добровой провулок	Добровой провулок
Добровольчих батальйонів вулиця	Добровольчих Батальйонів вулиця
Добровольчих Батальйонів вулиця	Добровольчих Батальйонів вулиця
Добровольчих Батальйонів провулок	Добровольчих Батальйонів провулок
Добровольчих батальйонiв вулиця	Добровольчих Батальйонів вулиця
Добромир вулиця	Добромир вулиця
Добросусідства вулиця	Добросусідства вулиця
Добросусідства провулок	Добросусідства провулок
Довга балка вулиця	вулиця Довга Балка
Довга вулиця	Довга вулиця
Довге Озеро вулиця	Довге Озеро вулиця
Довгий Грунь вулиця	Довгий Грунь вулиця
Довгий Куток вулиця	Довгий Куток вулиця
Довгий провулок	Довгий провулок
Довжа вулиця	Довжа вулиця
Довжик вулиця	Довжик вулиця
Довжинець (штрика) вулиця	Довжинець (штрика) вулиця
Довжинець вулиця	Довжинець вулиця
Довжок вулиця	Довжок вулиця
Довжок провулок	Довжок провулок
Догаєва вулиця	Догаєва вулиця
Долгий вулиця	Долгий вулиця
Долгий проїзд	Долгий проїзд
Долгоша вулиця	Долгоша вулиця
Долина вулиця	Долина вулиця
Долина Княжа вулиця	Долина Княжа вулиця
Долинка вулиця	Долинка вулиця
Долинка провулок	Долинка провулок
Долишня вулиця	Долишня вулиця
Долі вулиця	Долі вулиця
Долішня вулиця	Долішня вулиця
Долішнянка вулиця	Долішнянка вулиця
Долорес Ібаррурі вулиця	Долорес Ібаррурі вулиця
Долорес Ібаррурі провулок	Долорес Ібаррурі провулок
Дольне вулиця	Дольне вулиця
Домб вулиця	Домб вулиця
Доненерго вулиця	Доненерго вулиця
Донецьке шосе	Донецьке шосе
Дора - Санкович через Каменярню	Дора - Санкович через Каменярню
Дордюка провулок	Дордюка провулок
Доріжка до джерела	Доріжка до джерела
Доріжка до пляжу	Доріжка до пляжу
Доріжка до Притулку	Доріжка до Притулку
Доробок вулиця	Доробок вулиця
дорога Широка	дорога Широка
Дородніцина вулиця	Дородніцина вулиця
Дорошок вулиця	Дорошок вулиця
Досвітня вулиця	Досвітня вулиця
Дослідне Поле вулиця	Дослідне Поле вулиця
Достатку вулиця	Достатку вулиця
Достатку провулок	Достатку провулок
Досягнень вулиця	Досягнень вулиця
Дощадець вулиця	Дощадець вулиця
Драбановець вулиця	Драбановець вулиця
древняя дорога	древняя дорога
Дригала провулок	Дригала провулок
Дроб’язка вулиця	Дробʼязка вулиця
Дробця вулиця	Дробця вулиця
Дробця провулок	Дробця провулок
Дрофаня вулиця	Дрофаня вулиця
Другетів вулиця	Другетів вулиця
Другі дачі	Другі дачі
Дружба вулиця	Дружба вулиця
Дружба квартал	Дружба квартал
Дружба міст	Дружба міст
Дружби вуиця	Дружби вуиця
Дружби дорога	Дружби дорога
Дружби квартал	Дружби квартал
Дружби кулиця	Дружби кулиця
Дружби народів алея	Дружби народів алея
Дружби народів бульвар	Дружби народів бульвар
Дружби Народів бульвар	Дружби Народів бульвар
Дружби народів вулиця	Дружби народів вулиця
Дружби Народів вулиця	Дружби Народів вулиця
Дружби народів квартал	Дружби народів квартал
Дружби народів площа	Дружби народів площа
Дружби Народів площа	Дружби Народів площа
Дружби Народів провулок	Дружби Народів провулок
Дружби Народів проспект	Дружби Народів проспект
Дружби Народів СРСР площа	Дружби Народів СРСР площа
Дружби народiв квартал	Дружби народів квартал
Дружби проїзд	Дружби проїзд
Друзів вулиця	Друзів вулиця
Друзів провулок	Друзів провулок
Друкарів вулиця	Друкарів вулиця
Друця вулиця	Друця вулиця
Дубенщина вулиця	Дубенщина вулиця
Дубина вулиця	Дубина вулиця
Дубинка вулиця	Дубинка вулиця
Дубовиця вулиця	Дубовиця вулиця
Дубок вулиця	Дубок вулиця
Дубоноса вулиця	Дубоноса вулиця
Дубровка вулиця	Дубровка вулиця
Дуже крутий спуск	Дуже крутий спуск
Дульчика вулиця	Дульчика вулиця
Думбрава вулиця	Думбрава вулиця
Дурбака вулиця	Дурбака вулиця
Дьогтярина вулиця	Дьогтярина вулиця
Дьордя Довжа вулиця	Дьордя Довжа вулиця
Дьошина вулиця	Дьошина вулиця
Дьошина провулок	Дьошина провулок
Дьячишина вулиця	Дьячишина вулиця
Дюли Ійєша бульвар	Дюли Ійєша бульвар
Дюли Кепеша вулиця	Дюли Кепеша вулиця
Дюма вулиця	Дюма вулиця
Дякущина вулиця	Дякущина вулиця
Дялу Боулуй вулиця	Дялу Боулуй вулиця
Егер вулиця	Егер вулиця
Едельвейсів вулиця	Едельвейсів вулиця
Едмунта Егана площа	Едмунта Егана площа
Едомера Тассоні вулиця	Едомера Тассоні вулиця
Ейгер вулиця	Ейгер вулиця
Ейдемана вулиця	Ейдемана вулиця
Екскавації провулок	Екскавації провулок
Електрометалургів вулиця	Електрометалургів вулиця
елисейские поля	елисейские поля
Еліберерій вулиця	Еліберерій вулиця
Еліезера Штейнбарга вулиця	Еліезера Штейнбарга вулиця
Елінг вулиця	Елінг вулиця
Ельворті вулиця	Ельворті вулиця
Емінеску вулиця	Емінеску вулиця
Емінеску провулок	Емінеску провулок
Енґельса вулиця	Енґельса вулиця
Ендре Аді вулиця	Ендре Аді вулиця
Ендре Оді вулиця	Ендре Оді вулиця
Епіка вулиця	Епіка вулиця
Ердев вулиця	Ердев вулиця
Ерделі вулиця	Ерделі вулиця
Ердехіватал вулиця	Ердехіватал вулиця
Ересвень вулиця	Ересвень вулиця
Етвеша вулиця	Етвеша вулиця
євпака вулиця	євпака вулиця
Євстаф’єва вулиця	Євстафʼєва вулиця
Євстафьєва вулиця	Євстафьєва вулиця
Єдина вулиця	Єдина вулиця
Єдинача вулиця	Єдинача вулиця
Єднання вулиця	Єднання вулиця
Єлизарової вулиця	Єлизарової вулиця
Єпанчина вулиця	Єпанчина вулиця
Єретика вулиця	Єретика вулиця
Єрмішина вулиця	Єрмішина вулиця
Єрусалимка вулиця	Єрусалимка вулиця
Ж/Д переход	Ж/Д переход
Жага швидкості	Жага швидкості
Жайворона вулиця	Жайворона вулиця
Жамбила Жабаєва вулиця	Жамбила Жабаєва вулиця
Жамбила Тулаєва вулиця	Жамбила Тулаєва вулиця
Жвава вулиця	Жвава вулиця
Жвана вулиця	Жвана вулиця
Жванецьке шосе	Жванецьке шосе
Жебелєва вулиця	Жебелєва вулиця
Жежків вулиця	Жежків вулиця
Железнодорожников проспект	Железнодорожников проспект
Желтая дорога	Желтая дорога
Желязняка вулиця	Желязняка вулиця
Жердєва вулиця	Жердєва вулиця
Жердія вулиця	Жердія вулиця
Жертв революції вулиця	Жертв революції вулиця
Жибчина вулиця	Жибчина вулиця
Жигаївка вулиця	Жигаївка вулиця
Жигоровка вулиця	Жигоровка вулиця
Жигуліних вулиця	Жигуліних вулиця
Жилко вулиця	Жилко вулиця
Жиловка вулиця	Жиловка вулиця
Житлове містечко вулиця	Житлове містечко вулиця
Житлове Містечко вулиця	Житлове Містечко вулиця
Житлоселище вулиця	Житлоселище вулиця
Житній провулок	Житній провулок
Житній проїзд	Житній проїзд
Житній проспект	Житній проспект
Житній Ринок вулиця	Житній Ринок вулиця
Житній Ринок площа	Житній Ринок площа
Житня вулиця	Житня вулиця
Жігмонда Перені вулиця	Жігмонда Перені вулиця
Жігмонда Шіпоша вулиця	Жігмонда Шіпоша вулиця
ЖМ Берізки	ЖМ Берізки
Жовкевських вулиця	Жовкевських вулиця
Жовта вулиця	Жовта вулиця
Жовтенят вулиця	Жовтенят вулиця
Жовтий провулок	Жовтий провулок
Жовтневої вулиці провулок	Жовтневої вулиці провулок
Жовтневої Революції бульвар	Жовтневої Революції бульвар
Жовтневої Революції в’їзд	Жовтневої Революції вʼїзд
Жовтневої революції вулиця	Жовтневої революції вулиця
Жовтневої Революції вулиця	Жовтневої Революції вулиця
Жовтневої революції квартал	Жовтневої революції квартал
Жовтневої Революції площа	Жовтневої Революції площа
Жовтневої Революції провулок	Жовтневої Революції провулок
Жовтневої революції проспект	Жовтневої революції проспект
Жовтня вулиця	Жовтня вулиця
Жовтня площа	Жовтня площа
Жовтня провулок	Жовтня провулок
Жовтонога вулиця	Жовтонога вулиця
Жовтоножко вулиця	Жовтоножко вулиця
Жоліо Кюрі вулиця	Жоліо Кюрі вулиця
Жолобок провулок	Жолобок провулок
Жомера вулиця	Жомера вулиця
Жон Мироносиць вулиця	Жон Мироносиць вулиця
Жофії Баторі вулиця	Жофії Баторі вулиця
Жуйка вулиця	Жуйка вулиця
Жукин - Ровжі	Жукин - Ровжі
Жуковських вулиця	Жуковських вулиця
Жупан вулиця	Жупан вулиця
Журі вулиця	Журі вулиця
Журливої провулок	Журливої провулок
Жухрая провулок	Жухрая провулок
З’єднана вулиця	Зʼєднана вулиця
За Грабцем вулиця	За Грабцем вулиця
За двором вулиця	За двором вулиця
За Долиною вулиця	За Долиною вулиця
за магазином Магнит	за магазином Магнит
За мир вулиця	За мир вулиця
За мист	За мист
За мостом вулиця	За мостом вулиця
За Парканом урочище	За Парканом урочище
За раскопками	За раскопками
За Рудкою вулиця	За Рудкою вулиця
За Рудкою провулок	За Рудкою провулок
Забава вулиця	Забава вулиця
Забалка вулиця	Забалка вулиця
Заберезина вулиця	Заберезина вулиця
Забілявка вулиця	Забілявка вулиця
Забіркіне вулиця	Забіркіне вулиця
Забойщиков проспект	Забойщиков проспект
Заболото вулиця	Заболото вулиця
Заболоття вулиця	Заболоття вулиця
Забрама вулиця	Забрама вулиця
Забрама провулок	Забрама провулок
Забрід вулиця	Забрід вулиця
Забріддя вулиця	Забріддя вулиця
заброшеная дорога	заброшеная дорога
Забурдаєва проспект	Забурдаєва проспект
Завадка вулиця	Завадка вулиця
завалена стара дорога	завалена стара дорога
заваленая дорога	заваленая дорога
завалено (требует прочистки)	завалено (требует прочистки)
Завалля вулиця	Завалля вулиця
Заварихина вулиця	Заварихина вулиця
Завгородній провулок	Завгородній провулок
Завгородніх вулиця	Завгородніх вулиця
Завгородня вулиця	Завгородня вулиця
Завертяєва вулиця	Завертяєва вулиця
Заверх вулиця	Заверх вулиця
Заверхня вулиця	Заверхня вулиця
Завод телеграфної апаратури	Завод телеграфної апаратури
Завода вулиця	Завода вулиця
Заводище вулиця	Заводище вулиця
Заводу Комсомолець вулиця	Заводу Комсомолець вулиця
Завойка вулиця	Завойка вулиця
Завойко вулиця	Завойко вулиця
Заворуєва вулиця	Заворуєва вулиця
Загатці вулиця	Загатці вулиця
Загать вулиця	Загать вулиця
Загиблих Героїв вулиця	Загиблих Героїв вулиця
Загір'я вулиця	Загірʼя вулиця
Загір’я вулиця	Загірʼя вулиця
Загірка вулиця	Загірка вулиця
Заглиння вулиця	Заглиння вулиця
Заговда вулиця	Заговда вулиця
Загора вулиця	Загора вулиця
Загора провулок	Загора провулок
Загород вулиця	Загород вулиця
Загорода вулиця	Загорода вулиця
Загороддя вулиця	Загороддя вулиця
Загородній в’їзд	Загородній вʼїзд
Загородній провулок	Загородній провулок
Загородня вулиця	Загородня вулиця
Загоруйко вулиця	Загоруйко вулиця
Загорянка вулиця	Загорянка вулиця
Загребелля вулиця	Загребелля вулиця
Загребля вулиця	Загребля вулиця
Задвір вулиця	Задвір вулиця
Задвір’я вулиця	Задвірʼя вулиця
Задвориння вулиця	Задвориння вулиця
Задернюка вулиця	Задернюка вулиця
Заділ вулиця	Заділ вулиця
Заділок вулиця	Заділок вулиця
Задільниця вулиця	Задільниця вулиця
Задніпровських провулок	Задніпровських провулок
Задовга вулиця	Задовга вулиця
Задор вулиця	Задор вулиця
Заезд во двор	Заезд во двор
Зазамче вулиця	Зазамче вулиця
Заїжджий провулок	Заїжджий провулок
Заїзджий провулок	Заїзджий провулок
Заїзжий провулок	Заїзжий провулок
закинута дорога	закинута дорога
ЗАКИНУТА ДОРОГА	ЗАКИНУТА ДОРОГА
закинута стежка	закинута стежка
Закинута стежка	Закинута стежка
Закинутий переїзд	Закинутий переїзд
Закичера вулиця	Закичера вулиця
Заклинських вулиця	Заклинських вулиця
Закоротина вулиця	Закоротина вулиця
Закорчма вулиця	Закорчма вулиця
Закоршма вулиця	Закоршма вулиця
Закоханих вулиця	Закоханих вулиця
Закритий провулок	Закритий провулок
Закрупець вулиця	Закрупець вулиця
Залаегерсег вулиця	Залаегерсег вулиця
Залесья вулиця	Залесья вулиця
Залиман вулиця	Залиман вулиця
Залисий вулиця	Залисий вулиця
Залізниця вулиця	Залізниця вулиця
Залізничина вулиця	Залізничина вулиця
Залізничка вулиця	Залізничка вулиця
Залізничне шосе	Залізничне шосе
Залізничної вулиці провулок	Залізничної вулиці провулок
Залізної Дивізії вулиця	Залізної Дивізії вулиця
Залісся вулиця	Залісся вулиця
Заломана Річка вулиця	Заломана Річка вулиця
Залуг вулиця	Залуг вулиця
Залужжя вулиця	Залужжя вулиця
Залуцьківщина вулиця	Залуцьківщина вулиця
Замір'я вулиця	Замірʼя вулиця
Замір’я вулиця	Замірʼя вулиця
Заміст вулиця	Заміст вулиця
Замістя вулиця	Замістя вулиця
Замістя провулок	Замістя провулок
Замкнена вулиця	Замкнена вулиця
Замкнута вулиця	Замкнута вулиця
Замковище вулиця	Замковище вулиця
Замковище провулок	Замковище провулок
Замлиння вулиця	Замлиння вулиця
Замлинських вулиця	Замлинських вулиця
Замогилка вулиця	Замогилка вулиця
Замок вулиця	Замок вулиця
Замость вулиця	Замость вулиця
Замостя вулиця	Замостя вулиця
Замотаєва вулиця	Замотаєва вулиця
Занедбана дорога	Занедбана дорога
Занковецької вулиця	Занковецької вулиця
Заокіп вулиця	Заокіп вулиця
Заповідник вулиця	Заповідник вулиця
Заподрино вулиця	Заподрино вулиця
Запоріжця вулиця	Запоріжця вулиця
Запорізьке шосе	Запорізьке шосе
Запорізьких козаків вулиця	Запорізьких козаків вулиця
Запорізької Січі вулиця	Запорізької Січі вулиця
Запорозької Січі вулиця	Запорозької Січі вулиця
Запотік вулиця	Запотік вулиця
Запотіччя вулиця	Запотіччя вулиця
Запрудне тупик	Запрудне тупик
Запрутина вулиця	Запрутина вулиця
Заребро вулиця	Заребро вулиця
Заречная вулиця	Заречная вулиця
Зарєчная вулиця	Зарєчная вулиця
Зарицьких вулиця	Зарицьких вулиця
Заріг вулиця	Заріг вулиця
Заріка вулиця	Заріка вулиця
Зарінок вулиця	Зарінок вулиця
Зарічанській провулок	Зарічанській провулок
Зарічка вулиця	Зарічка вулиця
Зарічок вулиця	Зарічок вулиця
Заріччя вулиця	Заріччя вулиця
Заріччя провулок	Заріччя провулок
Зарниця вулиця	Зарниця вулиця
Зарогатка вулиця	Зарогатка вулиця
Зародової вулиця	Зародової вулиця
Заросла дорога / стежка	Заросла дорога / стежка
Заросла молодняком	Заросла молодняком
Заросляк - Водоспад	Заросляк - Водоспад
Заросляк - Несамовите	Заросляк - Несамовите
Заросший шлях	Заросший шлях
Заруда вулиця	Заруда вулиця
Заруддя вулиця	Заруддя вулиця
Зарудка вулиця	Зарудка вулиця
Зарудка провулок	Зарудка провулок
Засаддя вулиця	Засаддя вулиця
Засадя вулиця	Засадя вулиця
Засивка вулиця	Засивка вулиця
Засілля вулиця	Засілля вулиця
Застав вулиця	Застав вулиця
Застав'я вулиця	Заставʼя вулиця
Застав’є вулиця	Заставʼє вулиця
Застав’я вулиця	Заставʼя вулиця
Застава вулиця	Застава вулиця
Застава провулок	Застава провулок
Заставок вулиця	Заставок вулиця
Застіноцької провулок	Застіноцької провулок
Заступ’я вулиця	Заступʼя вулиця
Засулич вулиця	Засулич вулиця
Засядько вулиця	Засядько вулиця
Затиша вулиця	Затиша вулиця
Затишшя вулиця	Затишшя вулиця
Зауглище вулиця	Зауглище вулиця
Захар'єва вулиця	Захарʼєва вулиця
Західне селище	Західне селище
Західне шосе	Західне шосе
Захоролля вулиця	Захоролля вулиця
Зацерква вулиця	Зацерква вулиця
Зацерків'я вулиця	Зацерківʼя вулиця
Зацерків’я вулиця	Зацерківʼя вулиця
Зачиняєва вулиця	Зачиняєва вулиця
Зашкапії вулиця	Зашкапії вулиця
Защирок вулиця	Защирок вулиця
Заяма вулиця	Заяма вулиця
Заяр’я вулиця	Заярʼя вулиця
Заячий Гай вулиця	Заячий Гай вулиця
Заячий жолоб	Заячий жолоб
Заячий провулок	Заячий провулок
Збараж вулиця	Збараж вулиця
Збаразьке кільце вулиця	Збаразьке кільце вулиця
Збоїща вулиця	Збоїща вулиця
Зв’язку в’їзд	Зв’язку вʼїзд
Зв’язку вулиця	Звʼязку вулиця
Зв’язку провулок	Звʼязку провулок
Зваричі вулиця	Зваричі вулиця
Зваричі провулок	Зваричі провулок
Звейнека вулиця	Звейнека вулиця
Звеньєвий провулок	Звеньєвий провулок
Звивиста вулиця	Звивиста вулиця
Звивистий провулок	Звивистий провулок
Звилиста вулиця	Звилиста вулиця
Звільнена вулиця	Звільнена вулиця
Звільнення вулиця	Звільнення вулиця
Звір вулиця	Звір вулиця
Звіринець вулиця	Звіринець вулиця
Зворець вулиця	Зворець вулиця
Згоди майдан	Згоди майдан
Здвижка вулиця	Здвижка вулиця
Здоров'я вулиця	Здоровʼя вулиця
Здоров’я вулиця	Здоровʼя вулиця
Здоров’я провулок	Здоровʼя провулок
Здоров’я траса	Здоровʼя траса
Здоровʼя провулок	Здоровʼя провулок
Зелдфа вулиця	Зелдфа вулиця
Зелена (Колгоспна) вулиця	Зелена (Колгоспна) вулиця
Зелена алея	Зелена алея
Зелена Брама вулиця	Зелена Брама вулиця
Зелена вулиця	Зелена вулиця
Зелена Гірка вулиця	Зелена Гірка вулиця
Зелена Долина вулиця	Зелена Долина вулиця
Зелена площа	Зелена площа
Зелена полоща	Зелена полоща
Зелена провулок	Зелена провулок
Зелена Роща вулиця	Зелена Роща вулиця
Зеленбуд вулиця	Зеленбуд вулиця
Зелене господарство	Зелене господарство
Зелених Янголів вулиця	Зелених Янголів вулиця
Землеробів вулиця	Землеробів вулиця
Зиґзаґ вулиця	Зиґзаґ вулиця
Зільберника провулок	Зільберника провулок
Зільберта вулиця	Зільберта вулиця
Зіндельса вулиця	Зіндельса вулиця
Зінчаші вулиця	Зінчаші вулиця
Зіньковецької вулиця	Зіньковецької вулиця
Зірка вулиця	Зірка вулиця
Злато Місто	Злато Місто
Злена вулиця	Злена вулиця
Злой песок	Злой песок
Змагання вулиця	Змагання вулиця
Змагання провулок	Змагання провулок
Знаменських провулок	Знаменських провулок
Зовнішня вулиця	Зовнішня вулиця
Зодчих вулиця	Зодчих вулиця
Зодчих провулок	Зодчих провулок
Зои Космодемьянской	Зои Космодемьянской
Золної вулиця	Золної вулиця
Золота алея	Золота алея
Золота Баня вулиця	Золота Баня вулиця
Золота вулиця	Золота вулиця
Золотарка вулиця	Золотарка вулиця
Золоте кільце	Золоте кільце
Золотий Берег	Золотий Берег
Золотий берег бульвар	Золотий берег бульвар
Золотий берег вулиця	Золотий берег вулиця
Золотий Лан вулиця	Золотий Лан вулиця
Золотий Потік вулиця	Золотий Потік вулиця
Золотий провулок	Золотий провулок
Золотий Яр вулиця	Золотий Яр вулиця
Золотиста вулиця	Золотиста вулиця
Золотистий провулок	Золотистий провулок
Золоті Ключі вулиця	Золоті Ключі вулиця
Золотів Яр вулиця	Золотів Яр вулиця
Золотой берег	Золотой берег
Золотоосінній провулок	Золотоосінній провулок
Золотоосіння вулиця	Золотоосіння вулиця
Зорге вулиця	Зорге вулиця
Зорге провулок	Зорге провулок
Зорге тупик	Зорге тупик
Зоресвітня вулиця	Зоресвітня вулиця
Зору вулиця	Зору вулиця
Зорька мікрорайон	Зорька мікрорайон
Зоря вулиця	Зоря вулиця
Зоря Комунізму вулиця	Зоря Комунізму вулиця
Зоря провулок	Зоря провулок
Зофоре вулиця	Зофоре вулиця
Зруб вулиця	Зруб вулиця
Зубрицьких вулиця	Зубрицьких вулиця
Зузука вулиця	Зузука вулиця
Зулена вулиця	Зулена вулиця
Ивана Билозира	Ивана Билозира
Ивана Франко	Ивана Франко
Ивана Франко бульвар	Ивана Франко бульвар
Ивана Яцуненко	Ивана Яцуненко
Илʼїча вулиця	Илʼїча вулиця
им. Генерала Корявко	им. Генерала Корявко
им. Марии Буркун	им. Марии Буркун
Империя Скорости	Империя Скорости
Исмаил бей Гаспралъи	Исмаил бей Гаспралъи
Исмаил Бей Гаспралъи	Исмаил Бей Гаспралъи
Ицхака Рабина	Ицхака Рабина
І провулок Надрічної	І провулок Надрічної
І. Алба вулиця	І. Алба вулиця
І. Вільде вулиця	І. Вільде вулиця
І. Данеко вулиця	І. Данеко вулиця
І. Калуша вулиця	І. Калуша вулиця
І. Шило вулиця	І. Шило вулиця
І.Прашка вулиця	І.Прашка вулиця
І.Франко провулок	І.Франко провулок
Івокут вулиця	Івокут вулиця
Ігенєлт вулиця	Ігенєлт вулиця
Ігнат'єва вулиця	Ігнатʼєва вулиця
Ігнатових вулиця	Ігнатових вулиця
Ігорєва вулиця	Ігорєва вулиця
Ізвєстій вулиця	Ізвєстій вулиця
Ізвєстія провулок	Ізвєстія провулок
Ізвилиста вулиця	Ізвилиста вулиця
Ізвиліста вулиця	Ізвиліста вулиця
Ізвіліста вулиця	Ізвіліста вулиця
Ізугенєва вулиця	Ізугенєва вулиця
ІІ Дружби провулок	2-й провулок Дружби
ІІ-й Гоголь провулок	2-й провулок Гоголя
ім. героя Білоножко вулиця	ім. героя Білоножко вулиця
ім. Казмирука площа	ім. Казмирука площа
ім.Фрунзе вулиця	ім.Фрунзе вулиця
Імре Текелі вулиця	Імре Текелі вулиця
Інглезі вулиця	Інглезі вулиця
Інгул Карт	Інгул Карт
Індустріалізації вулиця	Індустріалізації вулиця
Індустріальне шосе	Індустріальне шосе
Індустріальної вулиці провулок	Індустріальної вулиці провулок
Індустріальної вулиці тупик	Індустріальної вулиці тупик
Індустрії вулиця	Індустрії вулиця
Інженера Веденеєва вулиця	Інженера Веденеєва вулиця
Інженерів вулиця	Інженерів вулиця
Інженерів проспект	Інженерів проспект
Інститутській проріз вулиця	Інститутській проріз вулиця
Інтернату провулок	Інтернату провулок
Іона Кілару вулиця	Іона Кілару вулиця
Ісаханяня вулиця	Ісаханяня вулиця
Ісковщина вулиця	Ісковщина вулиця
Існюка вулиця	Існюка вулиця
ІТР вулиця	ІТР вулиця
Іфюшаг вулиця	Іфюшаг вулиця
Йде далі у вигляді звіриних стежок	Йде далі у вигляді звіриних стежок
Йовжефа Онтола вулиця	Йовжефа Онтола вулиця
Йовжефа Шорі вулиця	Йовжефа Шорі вулиця
Йогансона провулок	Йогансона провулок
Йокаї вулиця	Йокаї вулиця
Йонко вулиця	Йонко вулиця
к автомобильной дороге	к автомобильной дороге
к Автомобілісту	к Автомобілісту
К Бирюзовому озеру	К Бирюзовому озеру
К роднику	К роднику
Кабівці вулиця	Кабівці вулиця
Кавалерідзе вулиця	Кавалерідзе вулиця
Кавалерії вулиця	Кавалерії вулиця
Кагамлика вулиця	Кагамлика вулиця
кагатне поле	кагатне поле
Кагатне поле	Кагатне поле
Кадинця вулиця	Кадинця вулиця
Кадуб вулиця	Кадуб вулиця
Кадуна вулиця	Кадуна вулиця
Казанової вулиця	Казанової вулиця
Казбек вулиця	Казбек вулиця
Казінці вулиця	Казінці вулиця
Казішвілі вулиця	Казішвілі вулиця
Казок алея	Казок алея
Казьмірі вулиця	Казьмірі вулиця
Казьонщина вулиця	Казьонщина вулиця
Кайданка вулиця	Кайданка вулиця
Каландирця вулиця	Каландирця вулиця
Калатур вулиця	Калатур вулиця
Календюка вулиця	Календюка вулиця
Калєва вулиця	Калєва вулиця
Калинка урочище	Калинка урочище
Калниші вулиця	Калниші вулиця
Калошина вулиця	Калошина вулиця
Кальварії вулиця	Кальварії вулиця
Кальницькой вулиця	Кальницькой вулиця
Калiнiча вулиця	Калініча вулиця
Кам'яниста вулиця	Камʼяниста вулиця
Кам'янка вулиця	Камʼянка вулиця
Кам’янець вулиця	Камʼянець вулиця
Кам’яниста вулиця	Камʼяниста вулиця
Кам’янка вулиця	Камʼянка вулиця
Кам’янка провулок	Камʼянка провулок
Кам’яногірка вулиця	Камʼяногірка вулиця
Кам’янчанина вулиця	Камʼянчанина вулиця
Каманина тупик	Каманина тупик
Камая вулиця	Камая вулиця
Каменець вулиця	Каменець вулиця
Каменьщіків вулиця	Каменьщіків вулиця
Каменьщікiв вулиця	Каменьщіків вулиця
Каменяра вулиця	Каменяра вулиця
Каменярів вулиця	Каменярів вулиця
Каменярів провулок	Каменярів провулок
Камишевата вулиця	Камишевата вулиця
Камка вулиця	Камка вулиця
Камневата вулиця	Камневата вулиця
Камо вулиця	Камо вулиця
Камяниха вулиця	Камяниха вулиця
Камянка вулиця	Камянка вулиця
Канора вулиця	Канора вулиця
Капанеллі вулиця	Капанеллі вулиця
капец как заброшена	капец как заброшена
Карбунешть вулиця	Карбунешть вулиця
Карканиці вулиця	Карканиці вулиця
Каркашадзе провулок	Каркашадзе провулок
Кармаєва вулиця	Кармаєва вулиця
Кароя Тарці вулиця	Кароя Тарці вулиця
Картвелішвілі вулиця	Картвелішвілі вулиця
Каруна вулиця	Каруна вулиця
Кархута вулиця	Кархута вулиця
Каспра вулиця	Каспра вулиця
Каталін вулиця	Каталін вулиця
Каховка вулиця	Каховка вулиця
Кашарня вулиця	Кашарня вулиця
Каштей вулиця	Каштей вулиця
Кащєєва вулиця	Кащєєва вулиця
Кащія вулиця	Кащія вулиця
Квітів вулиця	Квітів вулиця
Квітко вулиця	Квітко вулиця
Квітуча вулиця	Квітуча вулиця
Квітучий провулок	Квітучий провулок
Квятека вулиця	Квятека вулиця
Кевелів вулиця	Кевелів вулиця
Кекпатак вулиця	Кекпатак вулиця
Келчеї вулиця	Келчеї вулиця
Кемеровскій провулок	Кемеровскій провулок
Кеніга вулиця	Кеніга вулиця
Керпініш вулиця	Керпініш вулиця
Керт вулиця	Керт вулиця
Кертолйо вулиця	Кертолйо вулиця
Кийка вулиця	Кийка вулиця
Кийків вулиця	Кийків вулиця
Кийкiв вулиця	Кийків вулиця
Киктя вулиця	Киктя вулиця
КИМ вулиця	КИМ вулиця
Кипуча вулиця	Кипуча вулиця
Кипучий провулок	Кипучий провулок
Кирило-Мефодіївські сходи	Кирило-Мефодіївські сходи
Киртка вулиця	Киртка вулиця
Кисляк вулиця	Кисляк вулиця
Кистяківських вулиця	Кистяківських вулиця
Китобоїв вулиця	Китобоїв вулиця
Кихна вулиця	Кихна вулиця
Кичерка вулиця	Кичерка вулиця
Кіблер вулиця	Кіблер вулиця
Кіборгів вулиця	Кіборгів вулиця
Кібрика вулиця	Кібрика вулиця
Ківшана вулиця	Ківшана вулиця
Кігіма вулиця	Кігіма вулиця
Кіквідзе вулиця	Кіквідзе вулиця
Кіквідзе провулок	Кіквідзе провулок
Кікень вулиця	Кікень вулиця
Кікоша вулиця	Кікоша вулиця
Кільце Аеропорту	Кільце Аеропорту
Кім вулиця	Кім вулиця
КІМа вулиця	КІМа вулиця
КІМа провулок	КІМа провулок
КІМу провулок	КІМу провулок
Кіндратьєва вулиця	Кіндратьєва вулиця
Кінець вулиця	Кінець вулиця
Кініжі вулиця	Кініжі вулиця
Кіорпе вулиця	Кіорпе вулиця
Кіото вулиця	Кіото вулиця
Кіпті вулиця	Кіпті вулиця
Кіраль вулиця	Кіраль вулиця
Кірічека вулиця	Кірічека вулиця
Кіш вулиця	Кіш вулиця
Кішвашут вулиця	Кішвашут вулиця
Кішгедь вулиця	Кішгедь вулиця
Кішкез вулиця	Кішкез вулиця
Кіштемете вулиця	Кіштемете вулиця
Кішфолуді вулиця	Кішфолуді вулиця
Клавдієво - Буча	Клавдієво - Буча
Клара Цеткин	Клара Цеткин
Классона вулиця	Классона вулиця
Клебанщина вулиця	Клебанщина вулиця
Клешканя вулиця	Клешканя вулиця
Клибанія вулиця	Клибанія вулиця
Кливака вулиця	Кливака вулиця
Климпуші вулиця	Климпуші вулиця
Клинець вулиця	Клинець вулиця
Клисів провулок	Клисів провулок
Клочко вулиця	Клочко вулиця
Клушина вулиця	Клушина вулиця
Клюткавиця вулиця	Клюткавиця вулиця
Клюхька вулиця	Клюхька вулиця
Ключинських вулиця	Ключинських вулиця
Кмитів Яр вулиця	Кмитів Яр вулиця
Княгинин вулиця	Княгинин вулиця
Княжа вулиця	Княжа вулиця
Княжа площа	Княжа площа
Княжий Брід вулиця	Княжий Брід вулиця
Княжий затон	Княжий затон
Княжий Затон вулиця	Княжий Затон вулиця
Княжий міст	Княжий міст
Княжий провулок	Княжий провулок
Княжина вулиця	Княжина вулиця
Князів Ґедиміновичів вулиця	Князів Ґедиміновичів вулиця
Князів Коріатовичів вулиця	Князів Коріатовичів вулиця
Князів Коріатовичів провулок	Князів Коріатовичів провулок
Князів Коріатовичів узвіз	Князів Коріатовичів узвіз
Князів острозьких вулиця	Князів острозьких вулиця
Князів Острозьких вулиця	Князів Острозьких вулиця
Князів Острозьких провулок	Князів Острозьких провулок
Князів Ружинських вулиця	Князів Ружинських вулиця
Князів Сангушків вулиця	Князів Сангушків вулиця
Князів Сангушків провулок	Князів Сангушків провулок
Князів Сангушко вулиця	Князів Сангушко вулиця
Князів Сангушко провулок	Князів Сангушко провулок
князя Потемкина Таврического	князя Потемкина Таврического
Кобеєва вулиця	Кобеєва вулиця
Кобера вулиця	Кобера вулиця
Кобера провулок	Кобера провулок
Коберідзе вулиця	Коберідзе вулиця
Кобзарів вулиця	Кобзарів вулиця
Кобозєва вулиця	Кобозєва вулиця
Кобринських вулиця	Кобринських вулиця
Кобринця вулиця	Кобринця вулиця
Кобринюка вулиця	Кобринюка вулиця
Кобриш вулиця	Кобриш вулиця
Ковбуза вулиця	Ковбуза вулиця
Ковельмана вулиця	Ковельмана вулиця
Ковната вулиця	Ковната вулиця
Коворот вулиця	Коворот вулиця
Ковтюха вулиця	Ковтюха вулиця
Кодриш вулиця	Кодриш вулиця
Кожбук вулиця	Кожбук вулиця
Кожем’яків вулиця	Кожемʼяків вулиця
Кожухаря вулиця	Кожухаря вулиця
Кожушко вулиця	Кожушко вулиця
Козача вулиця	Козача вулиця
Козачий вулиця	Козачий вулиця
Козачий провулок	Козачий провулок
Козачий тупик	Козачий тупик
Козачий Шлях вулиця	Козачий Шлях вулиця
Козинець вулиця	Козинець вулиця
Козинці вулиця	Козинці вулиця
Козиря вулиця	Козиря вулиця
Козіївка вулиця	Козіївка вулиця
Козіно вулиця	Козіно вулиця
Козові вулиця	Козові вулиця
Козоріса вулиця	Козоріса вулиця
Койнаша вулиця	Койнаша вулиця
Кокирлату вулиця	Кокирлату вулиця
Кокінакі вулиця	Кокінакі вулиця
Коккінакі вулиця	Коккінакі вулиця
Коккінакі провулок	Коккінакі провулок
Кокоєва вулиця	Кокоєва вулиця
Коксохіміків вулиця	Коксохіміків вулиця
Колективізації вулиця	Колективізації вулиця
Колесня вулиця	Колесня вулиця
Коллонтай вулиця	Коллонтай вулиця
Коллонтай провулок	Коллонтай провулок
Коло Моста вулиця	Коло Моста вулиця
Колодязьна вулиця	Колодязьна вулиця
Коломієць провулок	Коломієць провулок
Колонія вулиця	Колонія вулиця
Колонтай вул.	Колонтай вул.
Колонтай провулок	Колонтай провулок
Колосиста вулиця	Колосиста вулиця
Колосистий в'їзд	Колосистий вʼїзд
Колосистий провулок	Колосистий провулок
Колоскових вулиця	Колоскових вулиця
Колпаковой вулиця	Колпаковой вулиця
Колуково вулиця	Колуково вулиця
Кольцевой мототрек	Кольцевой мототрек
Кольчака вулиця	Кольчака вулиця
Колюбаєва вулиця	Колюбаєва вулиця
Командарма Корка вулиця	Командарма Корка вулиця
Комарвоа вулиця	Комарвоа вулиця
Комбайнерів вулиця	Комбайнерів вулиця
Комиссара Ищенко	Комиссара Ищенко
Комінника вулиця	Комінника вулиця
Комінтерну  вулиця	Комінтерну  вулиця
Комінтерну вулиця	Комінтерну вулиця
Комінтерну провулок	Комінтерну провулок
Комка вулиця	Комка вулиця
Комка провулок	Комка провулок
Комонавтів вулиця	Комонавтів вулиця
Композиторів вулиця	Композиторів вулиця
Комсомолу проспект	Комсомолу проспект
Комунара вулиця	Комунара вулиця
Комунарів вулиця	Комунарів вулиця
Комунарів площа	Комунарів площа
Комунарів провулок	Комунарів провулок
Комуністичної праці вулиця	Комуністичної праці вулиця
Конгресів Яр вулиця	Конгресів Яр вулиця
Кондака вулиця	Кондака вулиця
Кондарєва вулиця	Кондарєва вулиця
Кондратка вулиця	Кондратка вулиця
Кондратця вулиця	Кондратця вулиця
Кондрашина вулиця	Кондрашина вулиця
Коник вулиця	Коник вулиця
Коні провулок	Коні провулок
Конопельця вулиця	Конопельця вулиця
Конопницької вулиця	Конопницької вулиця
Коноптицької вулиця	Коноптицької вулиця
Конституції в’їзд	Конституції вʼїзд
Конституції вулиця	Конституції вулиця
Конституції майдан	Конституції майдан
Конституції площа	Конституції площа
Конституції провулок	Конституції провулок
Конституції проспект	Конституції проспект
Конструкторілор вулиця	Конструкторілор вулиця
Конько вулиця	Конько вулиця
Коняєва вулиця	Коняєва вулиця
Коняшиних вулиця	Коняшиних вулиця
кооператив Межречье	кооператив Межречье
Кооператив Прибрежное	Кооператив Прибрежное
Кооперації провулок	Кооперації провулок
Копана вулиця	Копана вулиця
Копанка вулиця	Копанка вулиця
Копань вулиця	Копань вулиця
Копачів вулиця	Копачів вулиця
Копчин вулиця	Копчин вулиця
Корабелів вулиця	Корабелів вулиця
Корабелів площа	Корабелів площа
Корабелів провулок	Корабелів провулок
Корабелів проспект	Корабелів проспект
Корабельника вулиця	Корабельника вулиця
Корабліної вулиця	Корабліної вулиця
Корабліної проїзд	Корабліної проїзд
Корбутяка вулиця	Корбутяка вулиця
Корда вулиця	Корда вулиця
Корея вулиця	Корея вулиця
Корзо вулиця	Корзо вулиця
Коріатовичів провулок	Коріатовичів провулок
Корлюка вулиця	Корлюка вулиця
Корман вулиця	Корман вулиця
Корнії вулиця	Корнії вулиця
Корніліча вулиця	Корніліча вулиця
Коровья дорога	Коровья дорога
Королівщина вулиця	Королівщина вулиця
Корота вулиця	Корота вулиця
Коротка вулиця	Коротка вулиця
Коротка стежка на Полонину Явірник	Коротка стежка на Полонину Явірник
Корпанюків вулиця	Корпанюків вулиця
Корсунка вулиця	Корсунка вулиця
Корфа вулиця	Корфа вулиця
Корчі вулиця	Корчі вулиця
Корчі провулок	Корчі провулок
Корчіївка вулиця	Корчіївка вулиця
Корчунок вулиця	Корчунок вулиця
Косвена вулиця	Косвена вулиця
Косий міст	Косий міст
Косий провулок	Косий провулок
Косий хутір вулиця	Косий хутір вулиця
Космача вулиця	Космача вулиця
Космонавта Пацаєва вулиця	Космонавта Пацаєва вулиця
Космонавтів бульвар	Космонавтів бульвар
Космонавтів вулиця	Космонавтів вулиця
Космонавтів провулок	Космонавтів провулок
Космонавтів проспект	Космонавтів проспект
Космонавтiв вулиця	Космонавтів вулиця
Косовських вулиця	Косовських вулиця
Косогона вулиця	Косогона вулиця
Костенюк вулиця	Костенюк вулиця
Костьолок вулиця	Костьолок вулиця
Костюків Ліс вулиця	Костюків Ліс вулиця
Костюшко вулиця	Костюшко вулиця
Косяк вулиця	Косяк вулиця
Коте Шилокадзе вулиця	Коте Шилокадзе вулиця
Котирло вулиця	Котирло вулиця
Котовка вулиця	Котовка вулиця
Коцка вулиця	Коцка вулиця
Коцка провулок	Коцка провулок
Коцорина вулиця	Коцорина вулиця
Коцюба вулиця	Коцюба вулиця
Кочегарів вулиця	Кочегарів вулиця
Коштель вулиця	Коштель вулиця
Крагульця вулиця	Крагульця вулиця
Краєва вулиця	Краєва вулиця
Краєзнавча вулиця	Краєзнавча вулиця
Країще вулиця	Країще вулиця
Крайній провулок	Крайній провулок
Крайній проїзд	Крайній проїзд
Крайня вулиця	Крайня вулиця
Крайняя вулиця	Крайняя вулиця
Краківщина вулиця	Краківщина вулиця
Крамничий провулок	Крамничий провулок
Красина вулиця	Красина вулиця
Красино вулиця	Красино вулиця
Красицьких вулиця	Красицьких вулиця
Красінських вулиця	Красінських вулиця
Красная вулиця	Красная вулиця
Красная звезда	Красная звезда
Красне Плесо вулиця	Красне Плесо вулиця
Красних зір вулиця	Красних зір вулиця
Красних Партизан вулиця	Красних Партизан вулиця
Красновських провулок	Красновських провулок
Красногірка вулиця	Красногірка вулиця
Красногірка провулок	Красногірка провулок
Красностав вулиця	Красностав вулиця
Красношапка вулиця	Красношапка вулиця
Красноштана вулиця	Красноштана вулиця
Краснянка вулиця	Краснянка вулиця
Красопулька вулиця	Красопулька вулиця
Крачуна вулиця	Крачуна вулиця
Крегулець вулиця	Крегулець вулиця
Крейсера «Аврора» вулиця	Крейсера «Аврора» вулиця
Крейсера Аврора вулиця	Крейсера Аврора вулиця
Крейтера вулиця	Крейтера вулиця
Кременчуцьке шосе	Кременчуцьке шосе
Креміня вулиця	Креміня вулиця
Кремлівських Курсантів вулиця	Кремлівських Курсантів вулиця
Кремнієвий провулок	Кремнієвий провулок
Кренкеля вулиця	Кренкеля вулиця
Кренкеля провулок	Кренкеля провулок
Криве вулиця	Криве вулиця
Кривець вулиця	Кривець вулиця
Кривлюка вулиця	Кривлюка вулиця
Кривня Горішня вулиця	Кривня Горішня вулиця
Кривня Долішня вулиця	Кривня Долішня вулиця
Криворіжсталі вулиця	Криворіжсталі вулиця
Криворізьке шосе	Криворізьке шосе
Криворучко вулиця	Криворучко вулиця
Кривохижина вулиця	Кривохижина вулиця
Кривошеї вулиця	Кривошеї вулиця
Кривуля вулиця	Кривуля вулиця
Кривуля хутір	Кривуля хутір
Кривча вулиця	Кривча вулиця
Криклия вулиця	Криклия вулиця
Крим-Кавказ вулиця	Крим-Кавказ вулиця
Кримця вулиця	Кримця вулиця
Криничанка вулиця	Криничанка вулиця
Криничувата вулиця	Криничувата вулиця
Криничуватий провулок	Криничуватий провулок
Крікента вулиця	Крікента вулиця
Кротона вулиця	Кротона вулиця
Кроцолин вулиця	Кроцолин вулиця
Круг вулиця	Круг вулиця
Круг Городище вулиця	Круг Городище вулиця
Кругла вулиця	Кругла вулиця
Кругла площа	Кругла площа
Кругле вулиця	Кругле вулиця
Круглий вулиця	Круглий вулиця
Круглий провулок	Круглий провулок
Круглик вулиця	Круглик вулиця
Круглицької вулиця	Круглицької вулиця
Кругляк вулиця	Кругляк вулиця
Кружляк вулиця	Кружляк вулиця
Крупскої вулиця	Крупскої вулиця
Крупськой провулок	Крупськой провулок
Крута вулиця	Крута вулиця
Крутий підйом	Крутий підйом
Крутий провулок	Крутий провулок
Крутий спуск	Крутий спуск
крутий схил	крутий схил
Крутий узвіз	Крутий узвіз
Крутий яр	Крутий яр
Крутий Яр вулиця	Крутий Яр вулиця
Крутнів Яр вулиця	Крутнів Яр вулиця
Крутнів Яр провулок	Крутнів Яр провулок
крутой спуск	крутой спуск
Крутой спуск	Крутой спуск
Крутой спуск к берегу	Крутой спуск к берегу
Круча вулиця	Круча вулиця
Крушельницьких вулиця	Крушельницьких вулиця
Крушина вулиця	Крушина вулиця
Крушник вулиця	Крушник вулиця
Крянге вулиця	Крянге вулиця
Крiвая вулиця	Крівая вулиця
Кубану острів	Кубану острів
Кубинця вулиця	Кубинця вулиця
Кубинця провулок	Кубинця провулок
Кубишко вулиця	Кубишко вулиця
Кубійовичів вулиця	Кубійовичів вулиця
Кубіка вулиця	Кубіка вулиця
Кударя  вулиця	Кударя  вулиця
Кударя вулиця	Кударя вулиця
Кударя провулок	Кударя провулок
Кудрява вулиця	Кудрява вулиця
Кудрявий провулок	Кудрявий провулок
Кузнеча вулиця	Кузнеча вулиця
Кузьменщина вулиця	Кузьменщина вулиця
Куінджі вулиця	Куінджі вулиця
Куїнджі вулиця	Куїнджі вулиця
Куїнджі провулок	Куїнджі провулок
Кукля вулиця	Кукля вулиця
Кулеша вулиця	Кулеша вулиця
Куликове поле	Куликове поле
Культосвітня вулиця	Культосвітня вулиця
Куляб’єва вулиця	Кулябʼєва вулиця
Куманець вулиця	Куманець вулиця
Куп'янській провулок	Купʼянській провулок
Купальниця вулиця	Купальниця вулиця
Купиня вулиця	Купиня вулиця
Купов’янової вулиця	Куповʼянової вулиця
Куптія вулиця	Куптія вулиця
Курака вулиця	Курака вулиця
Курака провулок	Курака провулок
Куракина вулиця	Куракина вулиця
Курако вулиця	Курако вулиця
Курило вулиця	Курило вулиця
Куріса вулиця	Куріса вулиця
Курлука вулиця	Курлука вулиця
Курноса вулиця	Курноса вулиця
Курорт Куяльник	Курорт Куяльник
Курортное шоссе	Курортное шосе
Курсантів вулиця	Курсантів вулиця
Курсантські сходи	Курсантські сходи
Курявка вулиця	Курявка вулиця
Кустов'є вулиця	Кустовʼє вулиця
Кустря вулиця	Кустря вулиця
кут Бурси	кут Бурси
Кут вулиця	Кут вулиця
Кутець вулиця	Кутець вулиця
Кутня вулиця	Кутня вулиця
Куток вулиця	Куток вулиця
Кухарєва вулиця	Кухарєва вулиця
Кучарка вулиця	Кучарка вулиця
Кучаря провулок	Кучаря провулок
Кучерява вулиця	Кучерява вулиця
Кучерявий провулок	Кучерявий провулок
Кушакевичів вулиця	Кушакевичів вулиця
Кушвіда вулиця	Кушвіда вулиця
Куяльник вулиця	Куяльник вулиця
Куяльник провулок	Куяльник провулок
Кшршчка вулиця	Кшршчка вулиця
Кюрі вулиця	Кюрі вулиця
Лабуза вулиця	Лабуза вулиця
Лагайка вулиця	Лагайка вулиця
Лагерне Поле вулиця	Лагерне Поле вулиця
Ладо Кецховелі вулиця	Ладо Кецховелі вулиця
Ладо Кецховелі провулок	Ладо Кецховелі провулок
Лазника вулиця	Лазника вулиця
Лазня вулиця	Лазня вулиця
Лазо вулиця	Лазо вулиця
Лазо провулок	Лазо провулок
Лазок вулиця	Лазок вулиця
Лалаянца вулиця	Лалаянца вулиця
Лалаянца провулок	Лалаянца провулок
Ламана вулиця	Ламана вулиця
Лан вулиця	Лан вулиця
Лангемака вулиця	Лангемака вулиця
Ландау вулиця	Ландау вулиця
Ландау провулок	Ландау провулок
Ланжерон пляж	Ланжерон пляж
Ланок вулиця	Ланок вулиця
Ланок провулок	Ланок провулок
Лапаївка вулиця	Лапаївка вулиця
Лаптєвих вулиця	Лаптєвих вулиця
Лапшин вулиця	Лапшин вулиця
Ласкава вулиця	Ласкава вулиця
Ласла Шафарі вулиця	Ласла Шафарі вулиця
Ласло Оцела вулиця	Ласло Оцела вулиця
Ластовча вулиця	Ластовча вулиця
Латаша вулиця	Латаша вулиця
Латориця вулиця	Латориця вулиця
Лауреатів вулиця	Лауреатів вулиця
Лафазана вулиця	Лафазана вулиця
Леб’яжий в’їзд	Леб’яжий вʼїзд
Лебідя вулиця	Лебідя вулиця
Левенца провулок	Левенца провулок
Левкоєва вулиця	Левкоєва вулиця
Левшиних вулиця	Левшиних вулиця
Леглич вулиця	Леглич вулиця
Леініа вулиця	Леініа вулиця
Лейзмана вулиця	Лейзмана вулиця
Лейтенанта Бараха вулиця	Лейтенанта Бараха вулиця
Лейтенанта Верхових вулиця	Лейтенанта Верхових вулиця
Лейтенанта Кібенок вулиця	Лейтенанта Кібенок вулиця
Лейтенанта Пугасія вулиця	Лейтенанта Пугасія вулиця
Лейтенанта Шмидта	Лейтенанта Шмидта
Лейтенантів вулиця	Лейтенантів вулиця
Лелеча вулиця	Лелеча вулиця
Ленина (Слобожанская)	Ленина (Слобожанская)
Ленина вулиця	Ленина вулиця
Ленина проспект	Ленина проспект
Леніга вулиця	Леніга вулиця
Леніні вулиця	Леніні вулиця
Ленківщина вулиця	Ленківщина вулиця
Ленських Подій вулиця	Ленських Подій вулиця
Ленських Подій провулок	Ленських Подій провулок
Лео Кераміка	Лео Кераміка
Лео Мола вулиця	Лео Мола вулиця
Леоні вулиця	Леоні вулиця
Леонтовіча вулиця	Леонтовіча вулиця
Лепішка вулиця	Лепішка вулиця
Леппіка вулиця	Леппіка вулиця
Лепсе вулиця	Лепсе вулиця
Лепсе площа	Лепсе площа
Леселідзе вулиця	Леселідзе вулиця
Леси Украинки	Леси Украинки
Лесная вулиця	Лесная вулиця
Лесной бульвар	Лесной бульвар
Лесной спуск	Лесной спуск
Лестница в море	Лестница в море
Лестница к гарнизонному пляжу	Лестница к гарнизонному пляжу
Лестница любви	Лестница любви
Лестница на пляж	Лестница на пляж
Лестница Раевского	Лестница Раевского
Лехела вулиця	Лехела вулиця
Лецовка вулиця	Лецовка вулиця
Лечин вулиця	Лечин вулиця
Лємєхової вулиця	Лємєхової вулиця
Либіді провулок	Либіді провулок
Лимарків провулок	Лимарків провулок
Линтварьових провулок	Линтварьових провулок
Лип’я вулиця	Липʼя вулиця
Липовиця-І вулиця	Липовиця-І вулиця
Лисий хутір	Лисий хутір
Лисинка провулок	Лисинка провулок
Листвена вулиця	Листвена вулиця
Литвиненко-Вольгемут вулиця	Литвиненко-Вольгемут вулиця
Литвяк вулиця	Литвяк вулиця
Литовка вулиця	Литовка вулиця
Лицоєва вулиця	Лицоєва вулиця
Лишеня вулиця	Лишеня вулиця
Ліверпуль площа	Ліверпуль площа
Лівий Гай вулиця	Лівий Гай вулиця
Лідіце вулиця	Лідіце вулиця
Лікаря Бланка провулок	Лікаря Бланка провулок
Лікаря Дедю вулиця	Лікаря Дедю вулиця
Ліквідаторів ЧАЕС вулиця	Ліквідаторів ЧАЕС вулиця
Лілаакац вулиця	Лілаакац вулиця
Лінія А вулиця	Лінія А вулиця
Лінія Б вулиця	Лінія Б вулиця
Лінія В вулиця	Лінія В вулиця
Лінія Г вулиця	Лінія Г вулиця
Лінія для маршрутизації. Видимої стежки нема	Лінія для маршрутизації. Видимої стежки нема
Лінія Залізниці вулиця	Лінія Залізниці вулиця
Ліпницької вулиця	Ліпницької вулиця
Лісгосп вулиця	Лісгосп вулиця
Ліселідзе провулок	Ліселідзе провулок
Лісництва вулиця	Лісництва вулиця
Лісов вулиця	Лісов вулиця
Лісові вулиця	Лісові вулиця
Лісовій провулок	Лісовій провулок
Лісоводів вулиця	Лісоводів вулиця
Лісок вул.	Лісок вул.
Лісок вулиця	Лісок вулиця
Лісопарк трейл	Лісопарк трейл
Лісорозсадник вулиця	Лісорозсадник вулиця
Лісорубів вулиця	Лісорубів вулиця
Лісорубів провулок	Лісорубів провулок
Літке вулиця	Літке вулиця
Літкє вулиця	Літкє вулиця
Літній майданчик	Літній майданчик
Літній провулок	Літній провулок
Літня вулиця	Літня вулиця
Лішинських вулиця	Лішинських вулиця
ЛНАУ городок	ЛНАУ городок
Логаша вулиця	Логаша вулиця
Логаша провулок	Логаша провулок
Логозаря вулиця	Логозаря вулиця
Логойдових вулиця	Логойдових вулиця
Лозовик вулиця	Лозовик вулиця
Лозуватка вулиця	Лозуватка вулиця
Ломана вулиця	Ломана вулиця
Ломачина вулиця	Ломачина вулиця
Ломбард Скарбниця	Ломбард Скарбниця
Ломонососа вулиця	Ломонососа вулиця
Лонка вулиця	Лонка вулиця
Лоняї вулиця	Лоняї вулиця
Лосевої вулиця	Лосевої вулиця
Лотошина вулиця	Лотошина вулиця
Лотута вулиця	Лотута вулиця
Луг вулиця	Луг вулиця
Луганка вулиця	Луганка вулиця
Лужок вулиця	Лужок вулиця
Лучиста вулиця	Лучиста вулиця
льва ландау	льва ландау
Льотчика Крутеня провулок	Льотчика Крутеня провулок
Любава вулиця	Любава вулиця
Люксембург вулиця	Люксембург вулиця
Лютневої Революції вулиця	Лютневої Революції вулиця
Лютневої Революції провулок	Лютневої Революції провулок
Лялі Убийвовк вулиця	Лялі Убийвовк вулиця
Лялі Убийвовк провулок	Лялі Убийвовк провулок
Лялі-Убийвовк вулиця	Лялі-Убийвовк вулиця
Лянгуса вулиця	Лянгуса вулиця
м-н. Тополь	м-н. Тополь
М’ясокомбіната проїзд	Мʼясокомбіната проїзд
Магазин Домашній	Магазин Домашній
Магазин побутової техніки	Магазин побутової техніки
Магнолій вулиця	Магнолій вулиця
Магура вулиця	Магура вулиця
Мазана вулиця	Мазана вулиця
Мазая вулиця	Мазая вулиця
Майдан Бергшлосс	Майдан Бергшлосс
Майдан вулиця	Майдан вулиця
Майдан Героїв вулиця	Майдан Героїв вулиця
Майдан Злагоди	Майдан Злагоди
майдан Княжий двір вулиця	майдан Княжий двір вулиця
Майдан Рад	Майдан Рад
Майдан УСС вулиця	Майдан УСС вулиця
Майдана вулиця	Майдана вулиця
Майзенберга вулиця	Майзенберга вулиця
Майстерюка вулиця	Майстерюка вулиця
Майстрів вугілля вулиця	Майстрів вугілля вулиця
Майстрів вулиця	Майстрів вулиця
Майстрів провулок	Майстрів провулок
Макаренщина вулиця	Макаренщина вулиця
Маккош вулиця	Маккош вулиця
МакНІІ містечко	МакНІІ містечко
Маковщина вулиця	Маковщина вулиця
Макогоніва вулиця	Макогоніва вулиця
Макортет вулиця	Макортет вулиця
Мала Безкупчина вулиця	Мала Безкупчина вулиця
Мала вулиця	Мала вулиця
Мала Нараївка вулиця	Мала Нараївка вулиця
Мала Спринька вулиця	Мала Спринька вулиця
Малаєвої вулиця	Малаєвої вулиця
Мале кільце	Мале кільце
Мале коло	Мале коло
Мале Передмістя вулиця	Мале Передмістя вулиця
Малий Боуц вулиця	Малий Боуц вулиця
Малий вивіз	Малий вивіз
Малий Кінець вулиця	Малий Кінець вулиця
Малий кут вулиця	Малий кут вулиця
Малий Кут вулиця	Малий Кут вулиця
Малий Куток вулиця	Малий Куток вулиця
Малий міст	Малий міст
Малий провулок	Малий провулок
Малий Ринок вулиця	Малий Ринок вулиця
Малий Уж провулок	Малий Уж провулок
Малий узвіз	Малий узвіз
Малишко вулиця	Малишко вулиця
Малі Кривчиці вулиця	Малі Кривчиці вулиця
Малі Лісовикі вулиця	Малі Лісовикі вулиця
Малієвських вулиця	Малієвських вулиця
Малом вулиця	Малом вулиця
Мальв вулиця	Мальв вулиця
Мальовничий провулок	Мальовничий провулок
мальовничий ярок	мальовничий ярок
Мамадалієва провулок	Мамадалієва провулок
Мамаївщина вулиця	Мамаївщина вулиця
Мамайсура вулиця	Мамайсура вулиця
Маметової вулиця	Маметової вулиця
Мамкіної вулиця	Мамкіної вулиця
Манжиєва вулиця	Манжиєва вулиця
Манюшка вулиця	Манюшка вулиця
Манюшко в’їзд	Манюшко вʼїзд
Мар’янка вулиця	Марʼянка вулиця
Марамуреш вулиця	Марамуреш вулиця
Марапульця вулиця	Марапульця вулиця
Маргосюків вулиця	Маргосюків вулиця
Маресьєва вулиця	Маресьєва вулиця
Маринеско узвіз	Маринеско узвіз
Марінеско вулиця	Марінеско вулиця
Марічка провулок	Марічка провулок
Марко Вовчок бульвар	Марко Вовчок бульвар
Марко Вовчок вулиця	Марко Вовчок вулиця
Марко Вовчок провулок	Марко Вовчок провулок
Маркусів вулиця	Маркусів вулиця
Мартірок вулиця	Мартірок вулиця
Марунька вулиця	Марунька вулиця
Марфіцина вулиця	Марфіцина вулиця
Марципіль вулиця	Марципіль вулиця
Маршала Гречко вулиця	Маршала Гречко вулиця
Маршала Рибалко вулиця	Маршала Рибалко вулиця
Маршала Рокоссовского	Маршала Рокоссовского
Маршала Судця вулиця	Маршала Судця вулиця
Маршала Тимошенко	Маршала Тимошенко
Маршала Толубка вулиця	Маршала Толубка вулиця
Маршрут здоров'я	Маршрут здоровʼя
Маршрут на Кикошів Камінь	Маршрут на Кикошів Камінь
Масив Криниченька	Масив Криниченька
Масив Новоселів вулиця	Масив Новоселів вулиця
Масив Середній вулиця	Масив Середній вулиця
Масив Старе місто	Масив Старе місто
Мастюка вулиця	Мастюка вулиця
Масюткіних вулиця	Масюткіних вулиця
Матері Божої площа	Матері Божої площа
Матійціва вулиця	Матійціва вулиця
Матлаєва вулиця	Матлаєва вулиця
Матросів провулок	Матросів провулок
Матросов вулиця	Матросов вулиця
Матяшівочка вулиця	Матяшівочка вулиця
Мауриція Ґоттлєба вулиця	Мауриція Ґоттлєба вулиця
Маханько вулиця	Маханько вулиця
Махарадзе вулиця	Махарадзе вулиця
Махарадзе провулок	Махарадзе провулок
Махинько вулиця	Махинько вулиця
Махінової вулиця	Махінової вулиця
Махно вулиця	Махно вулиця
Мацуєва вулиця	Мацуєва вулиця
Мацука вулиця	Мацука вулиця
Маширя вулиця	Маширя вулиця
Маюш вулиця	Маюш вулиця
Маяк вулиця	Маяк вулиця
Маяк Революції вулиця	Маяк Революції вулиця
Маяка вулиця	Маяка вулиця
Мегура вулиця	Мегура вулиця
Медведиця вулиця	Медведиця вулиця
Медвежа вулиця	Медвежа вулиця
Меденція вулиця	Меденція вулиця
Медичній провулок	Медичній провулок
Медніка вулиця	Медніка вулиця
Медніка провулок	Медніка провулок
Межева-сад вулиця	Межева-сад вулиця
Межлаука вулиця	Межлаука вулиця
Мезев вулиця	Мезев вулиця
Мезевгомок вулиця	Мезевгомок вулиця
Меліоратів вулиця	Меліоратів вулиця
Меліораторів вулиця	Меліораторів вулиця
Меліораторів площа	Меліораторів площа
Мелітопольських Дивізій вулиця	Мелітопольських Дивізій вулиця
Меля вулиця	Меля вулиця
Меморіал слави	Меморіал слави
Менахем-Мендл Шнеєрсона вулиця	Менахем-Мендл Шнеєрсона вулиця
Менделеєва провулок	Менделеєва провулок
Мендєлєєва вулиця	Мендєлєєва вулиця
Мендуса вулиця	Мендуса вулиця
Менчів вулиця	Менчів вулиця
Менькіної вулиця	Менькіної вулиця
Мересьєва вулиця	Мересьєва вулиця
Мерзляка вулиця	Мерзляка вулиця
Меріме вулиця	Меріме вулиця
Металіста вулиця	Металіста вулиця
Металіста провулок	Металіста провулок
Металлургов квартал	Металлургов квартал
Металлургов мик	Металлургов мик
Металлургов микрорайон	Металлургов микрорайон
Металлургов проспект	Металлургов проспект
Металоконструкцій вулиця	Металоконструкцій вулиця
Металург квартал	Металург квартал
Металургів бульвар	Металургів бульвар
Металургів вулиця	Металургів вулиця
Металургів мікрорайон	Металургів мікрорайон
Металургів площа	Металургів площа
Металургів провулок	Металургів провулок
Металургів проспект	Металургів проспект
Метеорологічне вулиця	Метеорологічне вулиця
Метро міст	Метро міст
Мехліса вулиця	Мехліса вулиця
МЖК «Мрія»	МЖК «Мрія»
Мигловця вулиця	Мигловця вулиця
Мигуна вулиця	Мигуна вулиця
Мизо вулиця	Мизо вулиця
Микгород вулиця	Микгород вулиця
Микиші вулиця	Микиші вулиця
Миколаєва вулиця	Миколаєва вулиця
Миколаєва провулок	Миколаєва провулок
Миколаї Божук вулиця	Миколаї Божук вулиця
Миколаї Божук провулок	Миколаї Божук провулок
Миколаїва вулиця	Миколаїва вулиця
Миколаївка вулиця	Миколаївка вулиця
Миколія вулиця	Миколія вулиця
микрорайон Акрополь	микрорайон Акрополь
микрорайон Генерала Корявко	микрорайон Генерала Корявко
микрорайон Гидростроителей	микрорайон Гидростроителей
микрорайон Казачья Бухта	микрорайон Казачья Бухта
микрорайон Корявко	микрорайон Корявко
микрорайон Лесной	микрорайон Лесной
Микрорайон металлургов	Микрорайон металлургов
Мила вулиця	Мила вулиця
Милий провулок	Милий провулок
Милорадовичів вулиця	Милорадовичів вулиця
Милосердя провулок	Милосердя провулок
Миндру вулиця	Миндру вулиця
Мира вулиця	Мира вулиця
Мира проспект	Мира проспект
Мира улиця	Мира улиця
Миргородських вулиця	Миргородських вулиця
Миргородських дивізій вулиця	Миргородських дивізій вулиця
Мирній провулок	Мирній провулок
Миру алея	Миру алея
Миру бульвар	Миру бульвар
Миру в'їзд	Миру вʼїзд
Миру в’їзд	Миру вʼїзд
Миру вилиця	Миру вилиця
Миру вулиці	Миру вулиці
Миру вулицю	Миру вулицю
Миру вулиця	Миру вулиця
Миру Вулиця	Миру Вулиця
Миру вулмця	Миру вулмця
Миру квартал	Миру квартал
Миру площа	Миру площа
Миру провулок	Миру провулок
Миру проїзд	Миру проїзд
Миру проспект	Миру проспект
Мистецтв алея	Мистецтв алея
Мистецтв бульвар	Мистецтв бульвар
Мистецтв вулиця	Мистецтв вулиця
Мистецтв майдан	Мистецтв майдан
Мистецтва провулок	Мистецтва провулок
Мистецькі Ворота майдан	Мистецькі Ворота майдан
Митниця вулиця	Митниця вулиця
Митрака вулиця	Митрака вулиця
Митрака провулок	Митрака провулок
Михаила Петренко	Михаила Петренко
Михайлевичів вулиця	Михайлевичів вулиця
Михаця вулиця	Михаця вулиця
Мичуринские Дачи	Мичуринские Дачи
Мігалі вулиця	Мігалі вулиця
Мігуна вулиця	Мігуна вулиця
Міжріччя вулиця	Міжріччя вулиця
Мізюна вулиця	Мізюна вулиця
Мікеша вулиця	Мікеша вулиця
Міклея вулиця	Міклея вулиця
Мікрорайон БОС	Мікрорайон БОС
Мікрорайон вулиця	Мікрорайон вулиця
мікрорайон Гідробудівників	мікрорайон Гідробудівників
мікрорайон Мікроцентр	мікрорайон Мікроцентр
Мікроцентр вулиця	Мікроцентр вулиця
Міксата вулиця	Міксата вулиця
Мільнера вулиця	Мільнера вулиця
Міляшково вулиця	Міляшково вулиця
Міра вулиця	Міра вулиця
Міст «Бронниця - Унгри»	Міст «Бронниця - Унгри»
Міст дружби	Міст дружби
Міст закоханих	Міст закоханих
Міст колишньої взькоколійки	Міст колишньої взькоколійки
Міст над водопадом	Міст над водопадом
Міст над Інститутською	Міст над Інститутською
міст повз річку Кошеву	міст повз річку Кошеву
міст Солотвино–Сигіт	міст Солотвино–Сигіт
Міст у дуже поганому стані	Міст у дуже поганому стані
Міст через Сулинську затоку	Міст через Сулинську затоку
Міст через Черемош	Міст через Черемош
Міста Шалетт вулиця	Міста Шалетт вулиця
Містечко вулиця	Містечко вулиця
Містечко охорони	Містечко охорони
Містечок вулиця	Містечок вулиця
Місток для персоналу	Місток для персоналу
Місток через р.Рата	Місток через р.Рата
Місток через річку	Місток через річку
Місце відпочинку	Місце відпочинку
Місцевих Рад вулиця	Місцевих Рад вулиця
Місцепрому вулиця	Місцепрому вулиця
Міськдачі вулиця	Міськдачі вулиця
Міус провулок	Міус провулок
Міхлі вулиця	Міхлі вулиця
Міцкевица вулиця	Міцкевица вулиця
Міцна вулиця	Міцна вулиця
Мічурана вулиця	Мічурана вулиця
Мічурина вулиця	Мічурина вулиця
мкр Ювілейний	мкр Ювілейний
мкрн МакНИИ	мкрн МакНИИ
мкрн. Гірник	мкрн. Гірник
мкрн. им. Генерала Васильева	мкрн. им. Генерала Васильева
мкрн. Лазурний	мкрн. Лазурний
мкрн. Південний	мкрн. Південний
Млин урочище	Млин урочище
Могильчака вулиця	Могильчака вулиця
Могильчака провулок	Могильчака провулок
може заливатись струмком	може заливатись струмком
Моїсеєва вулиця	Моїсеєва вулиця
Мокра вулиця	Мокра вулиця
мокра стежка	мокра стежка
Мокрий провулок	Мокрий провулок
Мокріївка вулиця	Мокріївка вулиця
Мокрушина вулиця	Мокрушина вулиця
Молода Гвардія вулиця	Молода Гвардія вулиця
Молодих Партизан вулиця	Молодих Партизан вулиця
Молодих Патріотів вулиця	Молодих Патріотів вулиця
Молодих Шахтарів вулиця	Молодих Шахтарів вулиця
Молоді алея	Молоді алея
Молоді вулиця	Молоді вулиця
Молоді площа	Молоді площа
Молоді проспект	Молоді проспект
Молодіжка вулиця	Молодіжка вулиця
Молодіжної вулиці провулок	Молодіжної вулиці провулок
Молодої гвардії вулиця	Молодої гвардії вулиця
Молодої Гвардії вулиця	Молодої Гвардії вулиця
Молодої гвардії провулок	Молодої гвардії провулок
Молодої Гвардії проспект	Молодої Гвардії проспект
Молочная балка	Молочная балка
Монастир вулиця	Монастир вулиця
Монастирок вулиця	Монастирок вулиця
Монтана вулиця	Монтана вулиця
Мончака вулиця	Мончака вулиця
Монюшко вулиця	Монюшко вулиця
Мопра вулиця	Мопра вулиця
МОПРа вулиця	МОПРа вулиця
Мора Йокаі вулиця	Мора Йокаі вулиця
Морвокзалу площа	Морвокзалу площа
Мордар'єва вулиця	Мордарʼєва вулиця
Морской бульвар	Морской бульвар
Москва-Донбас вулиця	Москва-Донбас вулиця
Москеті провулок	Москеті провулок
Московських студентів вулиця	Московських студентів вулиця
мост пішохідний	мост пішохідний
мост разрушен	мост разрушен
Мост через Миус	Мост через Миус
Мостки к зубцу	Мостки к зубцу
Мотокрос Екстрім Бортничі	Мотокрос Екстрім Бортничі
Мототрек «Люблинець»	Мототрек «Люблинець»
Мохнюка вулиця	Мохнюка вулиця
Мочир вулиця	Мочир вулиця
Мошляка вулиця	Мошляка вулиця
Мрії вулиця	Мрії вулиця
Мрій бульвар	Мрій бульвар
Мрія вулиця	Мрія вулиця
МТС вулиця	МТС вулиця
Мудрьона вулиця	Мудрьона вулиця
Мукіївка вулиця	Мукіївка вулиця
Мулявка вулиця	Мулявка вулиця
Мурінсона вулиця	Мурінсона вулиця
Мухамадєєва вулиця	Мухамадєєва вулиця
Мухамедієва вулиця	Мухамедієва вулиця
МЮДа вулиця	МЮДа вулиця
МЮДа провулок	МЮДа провулок
Мячина вулиця	Мячина вулиця
на бабу	на бабу
на Богдан	на Богдан
На Борсучину	На Борсучину
на брід через Іршу	на брід через Іршу
На вид каскаду водоспадів	На вид каскаду водоспадів
На горба	На горба
На дачi	На дачі
На ж/д станцию	На ж/д станцию
На Зіньків	На Зіньків
На Кам'янське	На Камʼянське
На кладбище	На кладбище
На Копані вулиця	На Копані вулиця
На Красносельское	На Красносельское
на Криштопівку	на Криштопівку
На Малу Шебелу	На Малу Шебелу
На межирічскій міст	На межирічскій міст
На Мельницю	На Мельницю
На Нивах вулиця	На Нивах вулиця
На пер. Копек-Богаз	На пер. Копек-Богаз
На Росохату	На Росохату
На Росохацькі полонини	На Росохацькі полонини
На Сторожі вулиця	На Сторожі вулиця
На Таборищі вулиця	На Таборищі вулиця
На тунель	На тунель
На ферму	На ферму
На хребет	На хребет
На Чвертях вулиця	На Чвертях вулиця
Набережне шосе	Набережне шосе
Набивка вулиця	Набивка вулиця
Навколишня вулиця	Навколишня вулиця
Навої вулиця	Навої вулиця
Навої провулок	Навої провулок
Навсі площа	Навсі площа
Нагаївщина вулиця	Нагаївщина вулиця
Нагірних вулиця	Нагірних вулиця
Нагірянка вулиця	Нагірянка вулиця
Наголюка вулиця	Наголюка вулиця
Нагоринка верхня вулиця	Нагоринка верхня вулиця
Нагоринка вулиця	Нагоринка вулиця
Нагорінка вулиця	Нагорінка вулиця
Нагорянка вулиця	Нагорянка вулиця
Нагрощина вулиця	Нагрощина вулиця
Над Бугом вулиця	Над Бугом вулиця
Над Гуком вулиця	Над Гуком вулиця
Над Джерелом вулиця	Над Джерелом вулиця
Над Липою вулиця	Над Липою вулиця
Над Лугом вулиця	Над Лугом вулиця
Над потоком вулиця	Над потоком вулиця
Над Потоком вулиця	Над Потоком вулиця
Над Рудкою вулиця	Над Рудкою вулиця
Над ставом вулиця	Над ставом вулиця
Над Ставом вулиця	Над Ставом вулиця
Над Яром вулиця	Над Яром вулиця
Надбужжя вулиця	Надбужжя вулиця
надо прочищать	надо прочищать
Надош вулиця	Надош вулиця
Надстав вулиця	Надстав вулиця
Надставної провулок	Надставної провулок
Надсяння вулиця	Надсяння вулиця
Надь Ердев вулиця	Надь Ердев вулиця
Надьона вулиця	Надьона вулиця
Надьсер вулиця	Надьсер вулиця
Надьтемете вулиця	Надьтемете вулиця
Надьшамутаг вулиця	Надьшамутаг вулиця
Найкраща вулиця	Найкраща вулиця
Наливайко вулиця	Наливайко вулиця
Нандора Плотені вулиця	Нандора Плотені вулиця
Нараївка вулиця	Нараївка вулиця
Нарбутів вулиця	Нарбутів вулиця
Народів вулиця	Народів вулиця
Народів провулок	Народів провулок
Народних Депутатів вулиця	Народних Депутатів вулиця
Народної Гвардії провулок	Народної Гвардії провулок
Народовладдя вулиця	Народовладдя вулиця
Нарцисів вулиця	Нарцисів вулиця
Нарціс вулиця	Нарціс вулиця
Наташи Малаєвої вулиця	Наташи Малаєвої вулиця
Нафтомістечко вулиця	Нафтомістечко вулиця
Национальной Гвардии	Национальной Гвардии
Нації Нескорених вулиця	Нації Нескорених вулиця
Національної Гвардії вулиця	Національної Гвардії вулиця
Національної Гвардії майдан	Національної Гвардії майдан
Начало маршрута	Начало маршрута
Наш Край	Наш Край
Наш Шлях вулиця	Наш Шлях вулиця
Нашел новую тропку	Нашел новую тропку
НЕ рекомендуется! Дорога сквозь поле!	НЕ рекомендуется! Дорога сквозь поле!
Невелика вулиця	Невелика вулиця
Невеличка вулиця	Невеличка вулиця
Невідомих Солдат вулиця	Невідомих Солдат вулиця
Неділина вулиця	Неділина вулиця
Недовга вулиця	Недовга вулиця
Недужка вулиця	Недужка вулиця
Нежумирі вулиця	Нежумирі вулиця
Незабудок вулиця	Незабудок вулиця
Незабутній провулок	Незабутній провулок
Незнайка вулиця	Незнайка вулиця
Немо вулиця	Немо вулиця
Немовлят вулиця	Немовлят вулиця
Нені провулок	Нені провулок
Неофіта Кибалюка вулиця	Неофіта Кибалюка вулиця
Неплія провулок	Неплія провулок
Неплюєва вулиця	Неплюєва вулиця
Неплюєва провулок	Неплюєва провулок
Нерсісянскій бульвар	Нерсісянскій бульвар
Несвицької вулиця	Несвицької вулиця
Нескорених вулиця	Нескорених вулиця
Нетеча вулиця	Нетеча вулиця
неточно нанесена	неточно нанесена
Нефелейч вулиця	Нефелейч вулиця
Неціла вулиця	Неціла вулиця
Нєжданової вулиця	Нєжданової вулиця
Нижне кільце	Нижне кільце
Нижняя речная	Нижняя речная
Низамі вулиця	Низамі вулиця
Никифоряка вулиця	Никифоряка вулиця
Николаївка вулиця	Николаївка вулиця
Нимфейная дорога	Нимфейная дорога
Нізамі вулиця	Нізамі вулиця
Нікіфора вулиця	Нікіфора вулиця
Нінелі Бокій вулиця	Нінелі Бокій вулиця
Нірідьсег вулиця	Нірідьсег вулиця
Нічика провулок	Нічика провулок
Нічлава вулиця	Нічлава вулиця
Нічлава провулок	Нічлава провулок
Нове життя вулиця	Нове життя вулиця
Нове Життя вулиця	Нове Життя вулиця
Нове Життя провулок	Нове Життя провулок
Нове північне шосе	Нове північне шосе
Нове селище	Нове селище
Нове Селище вулиця	Нове Селище вулиця
Нове Село	Нове Село
Нове Село вулиця	Нове Село вулиця
Нове урочище	Нове урочище
Нове шосе	Нове шосе
Нове Шосе вулиця	Нове Шосе вулиця
Нові будинки	Нові будинки
Новобуд вулиця	Новобуд вулиця
Новобудов вулиця	Новобудов вулиця
Новозагородня вулиця	Новозагородня вулиця
Новозелена вулиця	Новозелена вулиця
Нової Конституції вулиця	Нової Конституції вулиця
Нової провулок	Нової провулок
Новоклубная вулиця	Новоклубная вулиця
Новолелів вулиця	Новолелів вулиця
Новолинника вулиця	Новолинника вулиця
Новомоспіно вулиця	Новомоспіно вулиця
Новооржицьке — Черевки	Новооржицьке — Черевки
Новопразьке шосе	Новопразьке шосе
Новопрокладена вулиця	Новопрокладена вулиця
Новопроложена вулиця	Новопроложена вулиця
Новорибцівській провулок	Новорибцівській провулок
Новоселиця вулиця	Новоселиця вулиця
Новоселищна вулиця	Новоселищна вулиця
Новоселів вулиця	Новоселів вулиця
Новоселів провулок	Новоселів провулок
Новоселів проїзд	Новоселів проїзд
Новоселка вулиця	Новоселка вулиця
Новоселов вулиця	Новоселов вулиця
Новосілка вулиця	Новосілка вулиця
Новосілля вулиця	Новосілля вулиця
Новоставці вулиця	Новоставці вулиця
Новостроївка вулиця	Новостроївка вулиця
Новостройка вулиця	Новостройка вулиця
Новосьолов вулиця	Новосьолов вулиця
Новоушицьке шосе	Новоушицьке шосе
Новрузалієва вулиця	Новрузалієва вулиця
Нодькез вулиця	Нодькез вулиця
Нодьполой вулиця	Нодьполой вулиця
Номікосових вулиця	Номікосових вулиця
Нони Погуляйло вулиця	Нони Погуляйло вулиця
Нососелів вулиця	Нососелів вулиця
Носса вулиця	Носса вулиця
НСБ Заросляк - оз.Несамовите	НСБ Заросляк - оз.Несамовите
Нiни Соснiної вулиця	Ніни Сосніної вулиця
Оазис миру	Оазис миру
Об’єднана вулиця	Обʼєднана вулиця
Об’їжджа вулиця	Обʼїжджа вулиця
Оберігу провулок	Оберігу провулок
Оберлі вулиця	Оберлі вулиця
Обіуха вулиця	Обіуха вулиця
Облазці вулиця	Облазці вулиця
Ободовка вулиця	Ободовка вулиця
Обозище вулиця	Обозище вулиця
Оболонь вулиця	Оболонь вулиця
Оболоня вулиця	Оболоня вулиця
Оборона вулиця	Оборона вулиця
Оборони Києва вулиця	Оборони Києва вулиця
Оборони Ленінграду вулиця	Оборони Ленінграду вулиця
Обрежа вулиця	Обрежа вулиця
Обривиста вулиця	Обривиста вулиця
Оброшино Ліс	Оброшино Ліс
Обручаєва провулок	Обручаєва провулок
Обручєва вулиця	Обручєва вулиця
Овочеводів вулиця	Овочеводів вулиця
Овочівництва вулиця	Овочівництва вулиця
Огієвських вулиця	Огієвських вулиця
Огієвських провулок	Огієвських провулок
Огородній в'їзд	Огородній вʼїзд
Огородній провулок	Огородній провулок
Огородня вулиця	Огородня вулиця
Огреба провулок	Огреба провулок
Огрод вулиця	Огрод вулиця
Одарія вулиця	Одарія вулиця
Одностороння вулиця	Одностороння вулиця
ОДПУ вулиця	ОДПУ вулиця
Озаркевичів вулиця	Озаркевичів вулиця
Оздоровча вулиця	Оздоровча вулиця
Оздоровче містечко	Оздоровче містечко
Оздоровчий провулок	Оздоровчий провулок
Озеленювачів вулиця	Озеленювачів вулиця
Озера Хасан вулиця	Озера Хасан вулиця
Озера Хасан провулок	Озера Хасан провулок
Озерце вулиця	Озерце вулиця
Озерянка вулиця	Озерянка вулиця
Окапці вулиця	Окапці вулиця
Окрема вулиця	Окрема вулиця
Окремий Хутір вулиця	Окремий Хутір вулиця
Октября вулиця	Октября вулиця
Октябрят вулиця	Октябрят вулиця
Окунєва вулиця	Окунєва вулиця
олд Тролль-трейл	олд Тролль-трейл
Олегове поле вулиця	Олегове поле вулиця
Олейнюка вулиця	Олейнюка вулиця
Олександрів вулиця	Олександрів вулиця
Олексієва вулиця	Олексієва вулиця
Олексіївка - П'ятихатки	Олексіївка - Пʼятихатки
Олексіївка - Павлове Поле	Олексіївка - Павлове Поле
Олексіївка - Павлово Поле	Олексіївка - Павлово Поле
ольги кобилянсьої	ольги кобилянсьої
Ольговичів провулок	Ольговичів провулок
Омнога вулиця	Омнога вулиця
Онілової провулок	Онілової провулок
Онопрійка вулиця	Онопрійка вулиця
Онуфрієва вулиця	Онуфрієва вулиця
Онча вулиця	Онча вулиця
Операторів вулиця	Операторів вулиця
Опшар вулиця	Опшар вулиця
Орача вулиця	Орача вулиця
Орача провулок	Орача провулок
Орбіта вулиця	Орбіта вулиця
Ордженікідзе провулок	Ордженікідзе провулок
Орджоникідзе вулиця	Орджоникідзе вулиця
Орджонікідзе вулиця	Орджонікідзе вулиця
Орджонікідзе площа	Орджонікідзе площа
Орджонікідзе провулок	Орджонікідзе провулок
Орджонікідзе проїзд	Орджонікідзе проїзд
Орджонікідзе проспект	Орджонікідзе проспект
Оришечка вулиця	Оришечка вулиця
Оришечко вулиця	Оришечко вулиця
Орищака вулиця	Орищака вулиця
Орлина вулиця	Орлина вулиця
Орлине гніздо вулиця	Орлине гніздо вулиця
Орлів тупик	Орлів тупик
Орлівскька вулиця	Орлівскька вулиця
Орловка — Бахчисарай	Орловка — Бахчисарай
Орлятко вулиця	Орлятко вулиця
Орсоглаз вулиця	Орсоглаз вулиця
Орчик провулок	Орчик провулок
Осада Червона вулиця	Осада Червона вулиця
Освітня вулиця	Освітня вулиця
Освободітєлєй вулиця	Освободітєлєй вулиця
ОСГК Здоров’я	ОСГК Здоровʼя
Оседача вулиця	Оседача вулиця
Оседля вулиця	Оседля вулиця
Оселя вулиця	Оселя вулиця
Осередок вулиця	Осередок вулиця
Осипових вулиця	Осипових вулиця
Осінній провулок	Осінній провулок
Осінній проїзд	Осінній проїзд
Осіння вулиця	Осіння вулиця
Осіньнній провулок	Осіньнній провулок
Осіня вулиця	Осіня вулиця
Основная вулиця	Основная вулиця
Осо вулиця	Осо вулиця
ОСО вулиця	ОСО вулиця
Осоавіахіма вулиця	Осоавіахіма вулиця
Осоавіахіма провулок	Осоавіахіма провулок
Осоавіахіма проїзд	Осоавіахіма проїзд
Осоавіахіму вулиця	Осоавіахіму вулиця
Осовиця вулиця	Осовиця вулиця
ОСОК «Молочник»	ОСОК «Молочник»
ост. Січ - Наукове містечко	ост. Січ - Наукове містечко
Острів вулиця	Острів вулиця
Остріїв — Добрятин	Остріїв — Добрятин
Островчик вулиця	Островчик вулиця
Остроградських вулиця	Остроградських вулиця
Острозьково вулиця	Острозьково вулиця
Осьмухина вулиця	Осьмухина вулиця
Осьмушин Яр вулиця	Осьмушин Яр вулиця
Отамана Григор’єва вулиця	Отамана Григорʼєва вулиця
Отамана Сітка вулиця	Отамана Сітка вулиця
Отамана Шока вулиця	Отамана Шока вулиця
Откіс вулиця	Откіс вулиця
Отрадная вулиця	Отрадная вулиця
Отрок вулиця	Отрок вулиця
Оттінгера вулиця	Оттінгера вулиця
Отто Гротеваля вулиця	Отто Гротеваля вулиця
Отця Бабина вулиця	Отця Бабина вулиця
ОУН-УПА майдан	ОУН-УПА майдан
Охотьничья вулиця	Охотьничья вулиця
Очеретянка вулиця	Очеретянка вулиця
П'ятигорця вулиця	Пʼятигорця вулиця
П'ятикопа вулиця	Пʼятикопа вулиця
П'ятниці вулиця	Пʼятниці вулиця
П’єра Береговуа вулиця	Пʼєра Береговуа вулиця
П’ятидесятиріччя Жовтня вулиця	Пʼятидесятиріччя Жовтня вулиця
П’ятидесятниць вулиця	Пʼятидесятниць вулиця
П’ятикопа вулиці провулок	Пʼятикопа вулиці провулок
П’ятикопа вулиця	Пʼятикопа вулиця
П’ятирічок вулиця	Пʼятирічок вулиця
П’ятисотенниць вулиця	Пʼятисотенниць вулиця
П’ятисотенниць провулок	Пʼятисотенниць провулок
П’ятихатка вулиця	Пʼятихатка вулиця
П’ятої сотні вулиця	Пʼятої сотні вулиця
Павлів Потік урочище	Павлів Потік урочище
Павлюкевичів вулиця	Павлюкевичів вулиця
Паганіні вулиця	Паганіні вулиця
Пажіт вулиця	Пажіт вулиця
Пала Терека вулиця	Пала Терека вулиця
Паланка вулиця	Паланка вулиця
Паланок площа	Паланок площа
Палац культури	Палац культури
Паліїв Яр вулиця	Паліїв Яр вулиця
Паліїів вулиця	Паліїів вулиця
Пальміро Тольятті вулиця	Пальміро Тольятті вулиця
Пам'яті вулиця	Памʼяті вулиця
Пам’ яті вулиця	Памʼ яті вулиця
Пам’яті алея	Памʼяті алея
Пам’яті вулиця	Памʼяті вулиця
Пам’яті Героїв вулиця	Памʼяті Героїв вулиця
Пам’яті площа	Памʼяті площа
Пам’ять Героїв вулиця	Памʼять Героїв вулиця
Панкєєва вулиця	Панкєєва вулиця
Пантазьєва вулиця	Пантазьєва вулиця
Панцерника Потьомкін вулиця	Панцерника Потьомкін вулиця
Панянка вулиця	Панянка вулиця
Паоло Фонтані вулиця	Паоло Фонтані вулиця
Папандреу Андреуса вулиця	Папандреу Андреуса вулиця
Папірня вулиця	Папірня вулиця
Паращівця І. вулиця	Паращівця І. вулиця
Паризької Комуни тупик	Паризької Комуни тупик
Паризької комуні вулиця	Паризької комуні вулиця
Парк Культури	Парк Культури
Парк розваг	Парк розваг
Парк Хіміків	Парк Хіміків
Парня вулиця	Парня вулиця
Паровоза вулиця	Паровоза вулиця
Партизан вулиця	Партизан вулиця
Партико провулок	Партико провулок
Партолих вулиця	Партолих вулиця
Парус ж/м	Парус ж/м
Парусовка вулиця	Парусовка вулиця
Парфановичів вулиця	Парфановичів вулиця
Парфентьєва вулиця	Парфентьєва вулиця
Парфилів провулок	Парфилів провулок
Пасаж провулок	Пасаж провулок
Пасіка вулиця	Пасіка вулиця
Пасіонарії вулиця	Пасіонарії вулиця
Пасіонарії узвіз	Пасіонарії узвіз
Пассіонарії вулиця	Пассіонарії вулиця
Пастівник вулиця	Пастівник вулиця
Пастуша вулиця	Пастуша вулиця
Патакі вулиця	Патакі вулиця
Патрієва вулиця	Патрієва вулиця
Патріотів в’їзд	Патріотів вʼїзд
Патріотів вулиця	Патріотів вулиця
Патріотів проїзд	Патріотів проїзд
Патріотів України алея	Патріотів України алея
Пахарів Хутір вулиця	Пахарів Хутір вулиця
Пахолі вулиця	Пахолі вулиця
Пацаєва вулиця	Пацаєва вулиця
Пацаєва провулок	Пацаєва провулок
Пашенної вулиця	Пашенної вулиця
Пашенної провулок	Пашенної провулок
Паши Ангеліної вулиця	Паши Ангеліної вулиця
Паши Ангеліной вулиця	Паши Ангеліной вулиця
Пашинських вулиця	Пашинських вулиця
Пащенкових вулиця	Пащенкових вулиця
Пащиця вулиця	Пащиця вулиця
Пеєвої вулиця	Пеєвої вулиця
Пенежка вулиця	Пенежка вулиця
Пенсіонерів вулиця	Пенсіонерів вулиця
пер. Соцгородок	пер. Соцгородок
Перевіз вулиця	Перевіз вулиця
Перегорода вулиця	Перегорода вулиця
Передмістя вулиця	Передмістя вулиця
Переїзної провулок	Переїзної провулок
Перекоп вулиця	Перекоп вулиця
Перелета вулиця	Перелета вулиця
Перелісок вулиця	Перелісок вулиця
Перемога вулиця	Перемога вулиця
Перемоги алея	Перемоги алея
Перемоги майдан	Перемоги майдан
Перемоги мікрорайон	Перемоги мікрорайон
Перені вулиця	Перені вулиця
Переорали дорогу	Переорали дорогу
Перепаханная дорога	Перепаханная дорога
Перепечка вулиця	Перепечка вулиця
Перервана вулиця	Перервана вулиця
Пересвіта вулиця	Пересвіта вулиця
Переселення вулиця	Переселення вулиця
Перескок вулиця	Перескок вулиця
Перехід вулиця	Перехід вулиця
Перехід до танку	Перехід до танку
перехід через колію	перехід через колію
Перехід через струмок Прелочний	Перехід через струмок Прелочний
Переход в столовую	Переход в столовую
Переход по бревнам	Переход по бревнам
Перехрестя вулиця	Перехрестя вулиця
Перехрестя Героїв	Перехрестя Героїв
Переца Маркіша	Переца Маркіша
Перля вулиця	Перля вулиця
Перфильєва вулиця	Перфильєва вулиця
Перше Травня вулиця	Перше Травня вулиця
Перших коммунарів вулиця	Перших коммунарів вулиця
Перших Космонавтів вулиця	Перших Космонавтів вулиця
Першовідкривачів вулиця	Першовідкривачів вулиця
Першотравневй провулок	Першотравневй провулок
Першотравневої вулиці провулок	Першотравневої вулиці провулок
Першотравненва вулиця	Першотравненва вулиця
Першотравненвий провулок	Першотравненвий провулок
Песляка вулиця	Песляка вулиця
Петефі вулиця	Петефі вулиця
Петефі провулок	Петефі провулок
Печаті вулиця	Печаті вулиця
Печенєг вулиця	Печенєг вулиця
Печера вулиця	Печера вулиця
Печиборща вулиця	Печиборща вулиця
пешеходная дорожка	пешеходная дорожка
Пешехонових вулиця	Пешехонових вулиця
Пештере вулиця	Пештере вулиця
пешходная дорожка	пешходная дорожка
Пионеров бульвар	Пионеров бульвар
Пирятин - Гребінка	Пирятин - Гребінка
Питомник вулиця	Питомник вулиця
Пишканя вулиця	Пишканя вулиця
Пишканя провулок	Пишканя провулок
Південенергобуду вулиця	Південенергобуду вулиця
Південне шосе	Південне шосе
Півколо вулиця	Півколо вулиця
Північне кладовище	Північне кладовище
Північне шосе	Північне шосе
Півонієва площа	Півонієва площа
Пігорєва вулиця	Пігорєва вулиця
Під Голоском вулиця	Під Голоском вулиця
Під горою	Під горою
Під Горою вулиця	Під Горою вулиця
Під Дубом	Під Дубом
Під Дубом вулиця	Під Дубом вулиця
Під Лісом хутір	Під Лісом хутір
Під Марковим Верхом вулиця	Під Марковим Верхом вулиця
Під Митою вулиця	Під Митою вулиця
Під Осовою вулиця	Під Осовою вулиця
Під Тисою вулиця	Під Тисою вулиця
Під Шимінкою вулиця	Під Шимінкою вулиця
Підберег вулиця	Підберег вулиця
Підбір вулиця	Підбір вулиця
Підборці вулиця	Підборці вулиця
Підваговець вулиця	Підваговець вулиця
Підвалля вулиця	Підвалля вулиця
Підварок провулок	Підварок провулок
Підвисока вулиця	Підвисока вулиця
Підгай вулиця	Підгай вулиця
Підгір'я вулиця	Підгірʼя вулиця
Підгір’я вулиця	Підгірʼя вулиця
Підгірка вулиця	Підгірка вулиця
Підгірських вулиця	Підгірських вулиця
Підгола вулиця	Підгола вулиця
Підгора вулиця	Підгора вулиця
Підгородній провулок	Підгородній провулок
Підгородня вулиця	Підгородня вулиця
Підгребінь вулиця	Підгребінь вулиця
Підділ вулиця	Підділ вулиця
Піддуб вулиця	Піддуб вулиця
Піддубина вулиця	Піддубина вулиця
Підзамок вулиця	Підзамок вулиця
Підзамче вулиця	Підзамче вулиця
Підйом на Данциж	Підйом на Данциж
підйом на Петрос	підйом на Петрос
Підйом на Пожижевську	Підйом на Пожижевську
Підйом на Туркул	Підйом на Туркул
Підкичера вулиця	Підкичера вулиця
Підкопая вулиця	Підкопая вулиця
Підлипа вулиця	Підлипа вулиця
Підлипка вулиця	Підлипка вулиця
Підліс вулиця	Підліс вулиця
Підлісок вулиця	Підлісок вулиця
Підлісом вулиця	Підлісом вулиця
Підлісся вулиця	Підлісся вулиця
Підмагура вулиця	Підмагура вулиця
Підмарика вулиця	Підмарика вулиця
Підметена вулиця	Підметена вулиця
Підмістя вулиця	Підмістя вулиця
Підмосковка вулиця	Підмосковка вулиця
Підполковника Красніка	Підполковника Красніка
Підпоповець вулиця	Підпоповець вулиця
Підреть вулиця	Підреть вулиця
Підріг вулиця	Підріг вулиця
Підріжжя вулиця	Підріжжя вулиця
Підстанція вулиця	Підстанція вулиця
Підстінка вулиця	Підстінка вулиця
Підстінок вулиця	Підстінок вулиця
Підстригача вулиця	Підстригача вулиця
Підтикана вулиця	Підтикана вулиця
Підцерква вулиця	Підцерква вулиця
Підцурків вулиця	Підцурків вулиця
Підчос вулиця	Підчос вулиця
Підшефна вулиця	Підшефна вулиця
Піззамче вулиця	Піззамче вулиця
Пікассо вулиця	Пікассо вулиця
Пілієва вулиця	Пілієва вулиця
Пілот вулиця	Пілот вулиця
Пілотів вулиця	Пілотів вулиця
Пілотів провулок	Пілотів провулок
Пілотів проїзд	Пілотів проїзд
Піль хутір	Піль хутір
Пінтя вулиця	Пінтя вулиця
Піонера в’їзд	Піонера вʼїзд
Піонерів бульвар	Піонерів бульвар
Піонерів вулиця	Піонерів вулиця
Піонерів проспект	Піонерів проспект
Піонерських Таборів провулок	Піонерських Таборів провулок
Пісні вулиця	Пісні вулиця
Пісок вулиця	Пісок вулиця
Пісчана вулиця	Пісчана вулиця
Піт лейн	Піт лейн
Піша вулиця	Піша вулиця
Пішеля вулиця	Пішеля вулиця
Піший провулок	Піший провулок
Піщана вулиця	Піщана вулиця
Піщана дорога	Піщана дорога
піщана стежка	піщана стежка
Піщанка вулиця	Піщанка вулиця
ПК ДНТ Лесовод тер.	ПК ДНТ Лесовод тер.
ПК ДОИЗ Технолог	ПК ДОИЗ Технолог
пл. Конституции	пл. Конституции
пл. Октября	пл. Октября
Плав’юка вулиця	Плавʼюка вулиця
Плависта вулиця	Плависта вулиця
Плаксіївка вулиця	Плаксіївка вулиця
Пламеницьких вулиця	Пламеницьких вулиця
План вулиця	План вулиця
Пласту вулиця	Пласту вулиця
Пластунів вулиця	Пластунів вулиця
Пластунів провулок	Пластунів провулок
Плахоті вулиця	Плахоті вулиця
Плебанія вулиця	Плебанія вулиця
Плевана вулиця	Плевана вулиця
Плесо вулиця	Плесо вулиця
Плетінка вулиця	Плетінка вулиця
Плетянка вулиця	Плетянка вулиця
Плещєєва вулиця	Плещєєва вулиця
Плєсо вулиця	Плєсо вулиця
Плєщєєва вулиця	Плєщєєва вулиця
Плитниця вулиця	Плитниця вулиця
Плієва вулиця	Плієва вулиця
Плотинія вулиця	Плотинія вулиця
Плотиче вулиця	Плотиче вулиця
Площа Героїв	Площа Героїв
Площа Героїв Майдану	Площа Героїв Майдану
Площа для виступів	Площа для виступів
Площа здорової логіки	Площа здорової логіки
Площа знань НТУУ «КПІ»	Площа знань НТУУ «КПІ»
Площа Кононенко	Площа Кононенко
Площа Миру вулиця	Площа Миру вулиця
Площа Незалежності	Площа Незалежності
Площа Партизан	Площа Партизан
Площа Перемоги	Площа Перемоги
Площа Ринок вулиця	Площа Ринок вулиця
Площа Соборності	Площа Соборності
площа Суднобудівельників	площа Суднобудівельників
площа Ювілейна	площа Ювілейна
Плугатаря вулиця	Плугатаря вулиця
Пляж Відрада	Пляж Відрада
Пляж Дельфін	Пляж Дельфін
Пляж Омега	Пляж Омега
Пляж Отрада	Пляж Отрада
ПМК вулиця	ПМК вулиця
По дамбе	По дамбе
по ребру на Дземброню	по ребру на Дземброню
по трубі через болото	по трубі через болото
по-за городами	по-за городами
Победа проспект	Победа проспект
Побратимів вулиця	Побратимів вулиця
Побук вулиця	Побук вулиця
Повстання Броненосця Потьомкін провулок	Повстання Броненосця Потьомкін провулок
Повстання вулиця	Повстання вулиця
Повстання площа	Повстання площа
Повстання провулок	Повстання провулок
Повстянка вулиця	Повстянка вулиця
Погадаєва вулиця	Погадаєва вулиця
Погар вулиця	Погар вулиця
Погибка вулиця	Погибка вулиця
Погоріла вулиця	Погоріла вулиця
Погулянка вулиця	Погулянка вулиця
Подвесной мост	Подвесной мост
Подворанці вулиця	Подворанці вулиця
Поділ вулиця	Поділ вулиця
Поділ провулок	Поділ провулок
Поділля вулиця	Поділля вулиця
Подлесная вулиця	Подлесная вулиця
Подъезд к кладбищу	Подъезд к кладбищу
Подъезд к урочищу Батилиман	Подъезд к урочищу Батилиман
Подъем на дамбу	Подъем на дамбу
Подъем на плато	Подъем на плато
подьедная дорога к дет. саду и гаражам скорой помощи	подьедная дорога к дет. саду и гаражам скорой помощи
Поезії вулиця	Поезії вулиця
Поезії майдан	Поезії майдан
Поезії провулок	Поезії провулок
поинута дорога	поинута дорога
Покиньборода вулиця	Покиньборода вулиця
Покотило вулиця	Покотило вулиця
Поле вулиця	Поле вулиця
Полевая вулиця	Полевая вулиця
Полевая дорога	Полевая дорога
Полеглих воїнів вулиця	Полеглих воїнів вулиця
Полеглих Героїв алея	Полеглих Героїв алея
Полеглих Героїв вулиця	Полеглих Героїв вулиця
Полеглих за Революцію вулиця	Полеглих за Революцію вулиця
Полеглих Комунарів вулиця	Полеглих Комунарів вулиця
Полеглих Комунарів проспект	Полеглих Комунарів проспект
Полежаєва вулиця	Полежаєва вулиця
Полетаєва в’їзд	Полетаєва вʼїзд
Полєжаєва вулиця	Полєжаєва вулиця
Полєтаєва вулиця	Полєтаєва вулиця
Полєтаєва провулок	Полєтаєва провулок
Полєток вулиця	Полєток вулиця
Полідовичів вулиця	Полідовичів вулиця
Полісся вулиця	Полісся вулиця
Політаєва вулиця	Політаєва вулиця
Політвідділ вулиця	Політвідділ вулиця
Політкаторжан вулиця	Політкаторжан вулиця
Полковника Бурляя провулок	Полковника Бурляя провулок
Полковника вулиця	Полковника вулиця
Полковника Гегечкорі вулиця	Полковника Гегечкорі вулиця
Полковника Тупіцина вулиця	Полковника Тупіцина вулиця
Полковничий хутір	Полковничий хутір
Полкової Сотні вулиця	Полкової Сотні вулиця
Полку Азов вулиця	Полку Азов вулиця
Полку Азов провулок	Полку Азов провулок
Пологая вулиця	Пологая вулиця
Пологий провулок	Пологий провулок
Пологіший підйом	Пологіший підйом
Поломиста вулиця	Поломиста вулиця
Полонина вулиця	Полонина вулиця
Полонина Довга	Полонина Довга
полонина Смотрич	полонина Смотрич
Полотнюків вулиця	Полотнюків вулиця
Полтава вулиця	Полтава вулиця
Полтарацьких вулиця	Полтарацьких вулиця
Польва вулиця	Польва вулиця
Польов вулиця	Польов вулиця
Польок мрн	Польок мрн
Польща вулиця	Польща вулиця
Помаранчевої революції вулиця	Помаранчевої революції вулиця
Помаранчевої Революції вулиця	Помаранчевої Революції вулиця
Попереччина вулиця	Попереччина вулиця
Попіля вулиця	Попіля вулиця
Попопа вулиця	Попопа вулиця
Попругі вулиця	Попругі вулиця
Попугаєва вулиця	Попугаєва вулиця
Поріднених Міст вулиця	Поріднених Міст вулиця
Порт вулиця	вулиця Порт
Порт-Елеватор вулиця	вулиця Порт-Елеватор
Порумбеску вулиця	Порумбеску вулиця
Посітка вулиця	Посітка вулиця
Послушняка вулиця	Послушняка вулиця
Посполита вулиця	Посполита вулиця
Постишєва вулиця	Постишєва вулиця
Постоя вулиця	Постоя вулиця
Постріж вулиця	Постріж вулиця
Посьолок завода вулиця	Посьолок завода вулиця
Поташня вулиця	Поташня вулиця
Потеряєва вулиця	Потеряєва вулиця
Потік вулиця	Потік вулиця
Потік Ірва вулиця	Потік Ірва вулиця
Потічок вулиця	Потічок вулиця
Потребує перевірки	Потребує перевірки
Потушняка вулиця	Потушняка вулиця
Похила вулиця	Похила вулиця
Похолмяцкьке кільце (заростає)	Похолмяцкьке кільце (заростає)
Почаївськеа вулиця	Почаївськеа вулиця
Почапці вулиця	Почапці вулиця
Почепин вулиця	Почепин вулиця
Поштарка вулиця	Поштарка вулиця
Поштарка провулок	Поштарка провулок
Пошукайла вулиця	Пошукайла вулиця
Ппроектируемая дорога для большегруза	Ппроектируемая дорога для большегруза
пр. Засядько	пр. Засядько
Праведниці Шулежко вулиця	Праведниці Шулежко вулиця
Правий Гай вулиця	Правий Гай вулиця
Правосуддя площа	Правосуддя площа
Прадуна вулиця	Прадуна вулиця
Прасолів вулиця	Прасолів вулиця
Праці бульвар	Праці бульвар
Праці вулиця	Праці вулиця
Праці площа	Праці площа
Праці провулок	Праці провулок
Праці проспект	Праці проспект
Працюючих вулиця	Працюючих вулиця
Пресайзена вулиця	Пресайзена вулиця
ПРЗ вулиця	ПРЗ вулиця
Прибера вулиця	Прибера вулиця
Прибій вулиця	Прибій вулиця
Прибой провулок	Прибой провулок
Пригорода вулиця	Пригорода вулиця
Пригородній провулок	Пригородній провулок
Пригородня вулиця	Пригородня вулиця
Прийма вулиця	Прийма вулиця
Приліпина вулиця	Приліпина вулиця
Примирення вулиця	Примирення вулиця
Приморські сходи	Приморські сходи
Принада вулиця	Принада вулиця
Принца Уэльского	Принца Уэльского
Присадибра вулиця	Присадибра вулиця
Присайзена вулиця	Присайзена вулиця
присілок Бірок	присілок Бірок
присілок Вільшина	присілок Вільшина
присілок Гостинець	присілок Гостинець
присілок Груби	присілок Груби
присілок Заболотня	присілок Заболотня
присілок Зарудні	присілок Зарудні
присілок Насалі	присілок Насалі
присілок Підберезина	присілок Підберезина
присілок Підрочин	присілок Підрочин
присілок Солтиси	присілок Солтиси
присілок Царина	присілок Царина
Пристань вулиця	Пристань вулиця
Пристань провулок	Пристань провулок
Пристін вулиця	Пристін вулиця
Приточиловка вулиця	Приточиловка вулиця
Прихозел вулиця	Прихозел вулиця
Причіл вулиця	Причіл вулиця
пров. Обхідний	пров. Обхідний
пров. Шевченко	пров. Шевченко
провулок А	провулок А
провулок Головний	провулок Головний
провулок Дружби народів	провулок Дружби народів
провулок Енергетиків	провулок Енергетиків
провулок Зелений	провулок Зелений
провулок Комсомольский	провулок Комсомольский
провулок Короткий	провулок Короткий
провулок Леси Украинки	провулок Леси Украинки
провулок Лісний	провулок Лісний
провулок Миру	провулок Миру
провулок Набережної вулиці	провулок Набережної вулиці
провулок Незалежності	провулок Незалежності
провулок Перемоги	провулок Перемоги
провулок Першотравневий	провулок Першотравневий
провулок Пипенка	провулок Пипенка
провулок Рад	провулок Рад
провулок Свободи	провулок Свободи
провулок Січових Стрільців	провулок Січових Стрільців
Прогрес вулиця	Прогрес вулиця
Прогресу вулиця	Прогресу вулиця
Продленная вулиця	Продленная вулиця
Продовольча вулиця	Продовольча вулиця
Проектируемая дорога	Проектируемая дорога
Проектируемая дорожка	Проектируемая дорожка
Прозора вулиця	Прозора вулиця
Проїжджа вулиця	Проїжджа вулиця
Проїжджий провулок	Проїжджий провулок
Проїзд по сухому або для позяшляховиків	Проїзд по сухому або для позяшляховиків
проїзд Стадіон Кладовище	проїзд Стадіон Кладовище
Проїзджий провулок	Проїзджий провулок
Проїзду для машин нема	Проїзду для машин нема
Проїзжа вулиця	Проїзжа вулиця
Проїзжий провулок	Проїзжий провулок
Прокоп'юка вулиця	Прокопʼюка вулиця
Прокоф’єва вулиця	Прокофʼєва вулиця
Прокоф’єва провулок	Прокофʼєва провулок
Пролетаріату Донбасу квартал	Пролетаріату Донбасу квартал
Пролетарській провулок	Пролетарській провулок
Пролісків вулиця	Пролісків вулиця
Пролісок вулиця	Пролісок вулиця
Промбуду вулиця	Промбуду вулиця
Променад бульвар	Променад бульвар
Промениста вулиця	Промениста вулиця
Променистий провулок	Променистий провулок
Промзона вулиця	Промзона вулиця
Промисло вулиця	Промисло вулиця
Промінь вулиця	Промінь вулиця
Промкооперації вулиця	Промкооперації вулиця
Пропускна вулиця	Пропускна вулиця
Просвіти алея	Просвіти алея
Просвіти майдан	Просвіти майдан
проспект Айвазовского	проспект Айвазовского
Проспект Алишера Навои	Проспект Алишера Навои
проспект Артиллеристов	проспект Артиллеристов
проспект Гагарина	проспект Гагарина
проспект Героев Десантников	проспект Героев Десантников
проспект Героїв Сталінграда	проспект Героїв Сталінграда
проспект Красносельского	проспект Красносельского
проспект Ленина	проспект Ленина
проспект Мира	проспект Мира
Проспект науки	Проспект науки
Проспект Науки	Проспект Науки
проспект Октябрьской Революции	проспект Октябрьской Революции
Проспект Октябрьской революции	Проспект Октябрьской революции
Проспект Октябрьской Революции	Проспект Октябрьской Революции
Проспект Перемоги	Проспект Перемоги
проспект Фрунзе	проспект Фрунзе
проспект Шахтарів	проспект Шахтарів
Проста вулиця	Проста вулиця
Простора вулиця	Простора вулиця
Просторий провулок	Просторий провулок
Протасів Яр вулиця	Протасів Яр вулиця
Професорів Богославських вулиця	Професорів Богославських вулиця
Профессора Свиргуненко	Профессора Свиргуненко
Профінтерну вулиця	Профінтерну вулиця
Профінтерну провулок	Профінтерну провулок
Профсоюзная вулиця	Профсоюзная вулиця
Профспілок вулиця	Профспілок вулиця
Профспілок площа	Профспілок площа
Прохід під будинками	Прохід під будинками
Прохладная вулиця	Прохладная вулиця
Проход к Ласточкиному гнезду	Проход к Ласточкиному гнезду
Проход на вокзал со шмоном	Проход на вокзал со шмоном
Проход под деревьями и кустами	Проход под деревьями и кустами
Прохожий провулок	Прохожий провулок
Прохоровщина вулиця	Прохоровщина вулиця
прочищена стежка	прочищена стежка
Прошака вулиця	Прошака вулиця
Прошина вулиця	Прошина вулиця
Прут вулиця	Прут вулиця
Прутня вулиця	Прутня вулиця
Пряма вулиця	Пряма вулиця
Пряма дорога П'ятихатки - Павлове Поле	Пряма дорога Пʼятихатки - Павлове Поле
Прямий провулок	Прямий провулок
Прямой тупик	Прямой тупик
Пстрака вулиця	Пстрака вулиця
Пташина вулиця	Пташина вулиця
Птіцина вулиця	Птіцина вулиця
Пудівітра провулок	Пудівітра провулок
Пустеля вулиця?	Пустеля вулиця?
Пустовгара вулиця	Пустовгара вулиця
Путейка алея	Путейка алея
Путейка вулиця	Путейка вулиця
Путєва вулиця	Путєва вулиця
Путровка - Фрирайд	Путровка - Фрирайд
Путь ворона	Путь ворона
Путь Соціалізму вулиця	Путь Соціалізму вулиця
Пуччіні вулиця	Пуччіні вулиця
Пушкина вулиця	Пушкина вулиця
Пшеницина вулиця	Пшеницина вулиця
Пшеничка вулиця	Пшеничка вулиця
Пшеничка провулок	Пшеничка провулок
Пьяная лестница	Пьяная лестница
Рабоча вулиця	Рабоча вулиця
Рабочий провулок	Рабочий провулок
Рад вулиця	Рад вулиця
Радванка вулиця	Радванка вулиця
Радів вулиця	Радів вулиця
Радіо в’їзд	Радіо вʼїзд
Радіо вулиця	Радіо вулиця
Радіо провулок	Радіо провулок
Радість вулиця	Радість вулиця
Радіус вулиця	Радіус вулиця
Раднаркому вулиця	Раднаркому вулиця
Радсело провулок	Радсело провулок
Радянських Космонавтів вулиця	Радянських Космонавтів вулиця
район Автовокзала	район Автовокзала
район Хале	район Хале
Раків Кут вулиця	Раків Кут вулиця
Раківщина вулиця	Раківщина вулиця
Ракоці вулиця	Ракоці вулиця
Рамішвіллі вулиця	Рамішвіллі вулиця
Рапія вулиця	Рапія вулиця
Рапної провулок	Рапної провулок
Рассвєт вулиця	Рассвєт вулиця
Растреллі вулиця	Растреллі вулиця
Рататюків провулок	Рататюків провулок
Рафайловець вулиця	Рафайловець вулиця
Рафієва провулок	Рафієва провулок
Рафтопулло вулиця	Рафтопулло вулиця
Раціоналізаторів вулиця	Раціоналізаторів вулиця
Ревазо Циклаурі вулиця	Ревазо Циклаурі вулиця
Ревазо Циклаурі провулок	Ревазо Циклаурі провулок
Ревейса вулиця	Ревейса вулиця
Ревен яр вулиця	Ревен яр вулиця
Революції вулиця	Революції вулиця
Революції площа	Революції площа
Революції провулок	Революції провулок
Революції проспект	Революції проспект
Революціонерів Воробйових вулиця	Революціонерів Воробйових вулиця
Революціонерів вулиця	Революціонерів вулиця
Ревпуті вулиця	Ревпуті вулиця
Редько вулиця	Редько вулиця
Рейваха вулиця	Рейваха вулиця
Рейка вулиця	Рейка вулиця
Рейнгарда сквер	Рейнгарда сквер
Реконструкції вулиця	Реконструкції вулиця
Релєєва вулиця	Релєєва вулиця
Рельєфна вулиця	Рельєфна вулиця
Ремісничий провулок	Ремісничий провулок
Рено вулиця	Рено вулиця
Реца вулиця	Реца вулиця
Речная (Дачаная)	Речная (Дачаная)
Речной тупик	Речной тупик
Решетєя вулиця	Решетєя вулиця
Решетів провулок	Решетів провулок
Решітка хутір	Решітка хутір
Рєзника вулиця	Рєзника вулиця
Рєпніних вулиця	Рєпніних вулиця
Рибалко вулиця	Рибалко вулиця
Рибалок вулиця	Рибалок вулиця
Рибача вулиця	Рибача вулиця
Рибачий провулок	Рибачий провулок
Рибинка вулиця	Рибинка вулиця
Рибинських вулиця	Рибинських вулиця
Риворотько вулиця	Риворотько вулиця
Риклюса вулиця	Риклюса вулиця
Рилеєва вулиця	Рилеєва вулиця
Рилеєва провулок	Рилеєва провулок
Римика вулиця	Римика вулиця
Ринок Барабашово	Ринок Барабашово
Ринок вулиця	Ринок вулиця
Ринок майдан	Ринок майдан
Ринок міст	Ринок міст
Ринок площа	Ринок площа
Рислянда вулиця	Рислянда вулиця
Рит вулиця	Рит вулиця
Рихлика вулиця	Рихлика вулиця
Ричка вулиця	Ричка вулиця
Рівних прав і можливостей вулиця	Рівних прав і можливостей вулиця
Різдва майдан	Різдва майдан
Різні площа	Різні площа
Різьбярів провулок	Різьбярів провулок
Ріка вулиця	Ріка вулиця
Рілеєва вулиця	Рілеєва вулиця
Ріхмана вулиця	Ріхмана вулиця
Річка вулиця	Річка вулиця
Робесп’єра вулиця	Робеспʼєра вулиця
Робесп’єра провулок	Робеспʼєра провулок
Робітниче селище вулиця	Робітниче селище вулиця
Робітничий провулок	Робітничий провулок
Робітничий Провулок	Робітничий Провулок
Робітничій провулок	Робітничій провулок
Робоча вулиця	Робоча вулиця
Робоча площа	Робоча площа
Робочий вулиця	Робочий вулиця
Робочий провулок	Робочий провулок
Ровжаш вулиця	Ровжаш вулиця
Ровінь вулиця	Ровінь вулиця
Рогізно вулиця	Рогізно вулиця
Роговиця вулиця	Роговиця вулиця
Родзянко вулиця	Родзянко вулиця
Родина вулиця	Родина вулиця
родина Калішевських провулок	родина Калішевських провулок
Родини Алчевських вулиця	Родини Алчевських вулиця
Родини Барвінських вулиця	Родини Барвінських вулиця
Родини Білинських вулиця	Родини Білинських вулиця
Родини Бобринських вулиця	Родини Бобринських вулиця
Родини Бунґе вулиця	Родини Бунґе вулиця
Родини Глаголєвих вулиця	Родини Глаголєвих вулиця
Родини Ґеретів вулиця	Родини Ґеретів вулиця
Родини Кістяківських вулиця	Родини Кістяківських вулиця
Родини Костюків вулиця	Родини Костюків вулиця
Родини Кривоносів вулиця	Родини Кривоносів вулиця
Родини Крістерів вулиця	Родини Крістерів вулиця
Родини Крушельницьких вулиця	Родини Крушельницьких вулиця
Родини Кульчинських вулиця	Родини Кульчинських вулиця
Родини Линтварьових вулиця	Родини Линтварьових вулиця
Родини Матушевських вулиця	Родини Матушевських вулиця
Родини Мисечків вулиця	Родини Мисечків вулиця
Родини Окуневських вулиця	Родини Окуневських вулиця
Родини Пищевичів провулок	Родини Пищевичів провулок
Родини Рвачових провулок	Родини Рвачових провулок
Родини Рощинських вулиця	Родини Рощинських вулиця
Родини Рудинських вулиця	Родини Рудинських вулиця
Родини Русових провулок	Родини Русових провулок
Родини Смирнових провулок	Родини Смирнових провулок
Родини Соколовських	Родини Соколовських
Родини Старухів вулиця	Родини Старухів вулиця
Родини Сущинських вулиця	Родини Сущинських вулиця
Родини Тобілевичів вулиця	Родини Тобілевичів вулиця
Родини Трегубових вулиця	Родини Трегубових вулиця
Родини Храпливих вулиця	Родини Храпливих вулиця
Родини Цегельських вулиця	Родини Цегельських вулиця
Родини Шумовських вулиця	Родини Шумовських вулиця
Родини Юрчаків вулиця	Родини Юрчаків вулиця
Родини Юхнелів вулиця	Родини Юхнелів вулиця
Родини Якубовських провулок	Родини Якубовських провулок
Родини Янових вулиця	Родини Янових вулиця
Родниковое — Передовое	Родниковое — Передовое
Родючий провулок	Родючий провулок
Рожаночка вулиця	Рожаночка вулиця
Рожок вулиця	Рожок вулиця
Рожошкерт вулиця	Рожошкерт вулиця
Роз вулиця	Роз вулиця
Розбита частина дороги	Розбита частина дороги
Розвилиста вулиця	Розвилиста вулиця
Розділена вулиця	Розділена вулиця
Розенталь вулиця	Розенталь вулиця
Розкіш вулиця	Розкіш вулиця
Розкової вулиця	Розкової вулиця
Розливка вулиця	Розливка вулиця
Розлога вулиця	Розлога вулиця
Розтока Тисовець вулиця	Розтока Тисовець вулиця
Розточчя вулиця	Розточчя вулиця
Розумовських вулиця	Розумовських вулиця
Розчіл вулиця	Розчіл вулиця
Роївка вулиця	Роївка вулиця
Роївка провулок	Роївка провулок
Ройко вулиця	Ройко вулиця
Рокита вулиця	Рокита вулиця
Романківа вулиця	Романківа вулиця
Ромашків вулиця	Ромашків вулиця
Ромашко вулиця	Ромашко вулиця
Ромашок вулиця	Ромашок вулиця
Ромейка вулиця	Ромейка вулиця
Ромейка провулок	Ромейка провулок
Роменця вулиця	Роменця вулиця
Роменця провулок	Роменця провулок
Ропша вулиця	Ропша вулиця
Рос вулиця	Рос вулиця
Росинка вулиця	Росинка вулиця
Росиста вулиця	Росиста вулиця
Росохан - Нивка	Росохан - Нивка
Россі вулиця	Россі вулиця
Россіні вулиця	Россіні вулиця
Россіні провулок	Россіні провулок
Россоха вулиця	Россоха вулиця
Ростов вулиця	Ростов вулиця
Ростока вулиця	Ростока вулиця
Роттаг вулиця	Роттаг вулиця
Рубаника вулиця	Рубаника вулиця
Рубінгера вулиця	Рубінгера вулиця
Рудавець вулиця	Рудавець вулиця
Рудакі вулиця	Рудакі вулиця
Рудзутака вулиця	Рудзутака вулиця
Рудик вулиця	Рудик вулиця
Рудишина вулиця	Рудишина вулиця
Рудка вулиця	Рудка вулиця
Руднєєва вулиця	Руднєєва вулиця
Рудннєва вулиця	Рудннєва вулиця
Рудня вулиця	Рудня вулиця
Рудокопів вулиця	Рудокопів вулиця
Рудочка вулиця	Рудочка вулиця
Рудь вулиця	Рудь вулиця
Ружина вулиця	Ружина вулиця
Рулових вулиця	Рулових вулиця
Румара вулиця	Румара вулиця
Руня вулиця	Руня вулиця
Рурисько вулиця	Рурисько вулиця
Русових вулиця	Русових вулиця
Руставелі вулиця	Руставелі вулиця
Руставелі провулок	Руставелі провулок
Руставі вулиця	Руставі вулиця
Рутка вулиця	Рутка вулиця
Руфа вулиця	Руфа вулиця
Руфа провулок	Руфа провулок
Ручай вулиця	Ручай вулиця
Ручай провулок	Ручай провулок
Рябий місток	Рябий місток
с/т Xортичанка	с/т Хортичанка
Сабадшаг вулиця	Сабадшаг вулиця
Сабанєєв міст вулиця	Сабанєєв міст вулиця
Сабрие Эреджеповой	Сабрие Эреджеповой
Сагайдачних вулиця	Сагайдачних вулиця
Садиба вулиця	Садиба вулиця
Садівництва вулиця	Садівництва вулиця
Садівничий проїзд	Садівничий проїзд
Садко вулиця	Садко вулиця
Садоводів-Хортиця вулиця	Садоводів-Хортиця вулиця
Садової тупик	Садової тупик
Садока Баронча вулиця	Садока Баронча вулиця
Садстанції вулиця	Садстанції вулиця
Сайко вулиця	Сайко вулиця
Сакена вулиця	Сакена вулиця
Сакко вулиця	Сакко вулиця
Сакко і Ванцетті вулиця	Сакко і Ванцетті вулиця
Сакко і Ванцетті провулок	Сакко і Ванцетті провулок
Сакур алея	Сакур алея
Самеда Вургуна вулиця	Самеда Вургуна вулиця
Саммера вулиця	Саммера вулиця
Самокіша вулиця	Самокіша вулиця
Самоткань вулиця	Самоткань вулиця
Саносвітній провулок	Саносвітній провулок
Сантьяго-де-Чилі площа	Сантьяго-де-Чилі площа
Санюка вулиця	Санюка вулиця
Сапельника провулок	Сапельника провулок
Саперів вулиця	Саперів вулиця
Саперне Поле вулиця	Саперне Поле вулиця
Сапіго вулиця	Сапіго вулиця
Сарапіних вулиця	Сарапіних вулиця
Сафрюка вулиця	Сафрюка вулиця
Сбежнєва вулиця	Сбежнєва вулиця
СБП - Сихів байк парк	СБП - Сихів байк парк
Свередюка вулиця	Свередюка вулиця
Світанку вулиця	Світанку вулиця
Світанку провулок	Світанку провулок
Світання вулиця	Світання вулиця
Світанок вулиця	Світанок вулиця
Світла вулиця	Світла вулиця
Світлий мікрорайон	Світлий мікрорайон
Світлий провулок	Світлий провулок
Світлий проїзд	Світлий проїзд
Світло Жовтня вулиця	Світло Жовтня вулиця
Світло Шахтаря вулиця	Світло Шахтаря вулиця
Світло Шахтаря провулок	Світло Шахтаря провулок
Свободи майдан	Свободи майдан
Свободи проїзд	Свободи проїзд
Свтіла вулиця	Свтіла вулиця
Связістов вулиця	Связістов вулиця
Святої Трійці вулиця	Святої Трійці вулиця
СГТ „Комунальник“	СГТ „Комунальник“
СГТ „Містопроект“	СГТ „Містопроект“
Северинка вулиця	Северинка вулиця
Севлевхедь вулиця	Севлевхедь вулиця
Сейделя вулиця	Сейделя вулиця
Сейтнеби Абдураманов	Сейтнеби Абдураманов
Селезінків вулиця	Селезінків вулиця
Селекціонерів вулиця	Селекціонерів вулиця
Селиця вулиця	Селиця вулиця
Селище Кізельгур	Селище Кізельгур
селище Миру	селище Миру
Селище Нове вулиця	Селище Нове вулиця
Селищна вулиця	Селищна вулиця
Село вулиця	Село вулиця
село Машино	село Машино
село. Шевченко	село. Шевченко
Сельських вулиця	Сельських вулиця
Сембратовичів вулиця	Сембратовичів вулиця
Семедія вулиця	Семедія вулиця
Семейка вулиця	Семейка вулиця
Семейка площа	Семейка площа
Семенішина провулок	Семенішина провулок
Семеноївка вулиця	Семеноївка вулиця
Семенюк вулиця	Семенюк вулиця
Семенюків Кут вулиця	Семенюків Кут вулиця
Семиградової вулиця	Семиградової вулиця
Семихатка вулиця	Семихатка вулиця
Сент Іштван Кіраль вулиця	Сент Іштван Кіраль вулиця
Сентмігалі вулиця	Сентмігалі вулиця
Сентфелд вулиця	Сентфелд вулиця
Сергея Лазо вулиця	Сергея Лазо вулиця
Сергіїва вулиця	Сергіїва вулиця
Серго вулиця	Серго вулиця
Серго Орджонікідзе вулиця	Серго Орджонікідзе вулиця
Серго провулок	Серго провулок
Сердечнюка вулиця	Сердечнюка вулиця
Середній в’їзд	Середній вʼїзд
Середній В’їзд провулок	Середній Вʼїзд провулок
Середній Гай вулиця	Середній Гай вулиця
Середній Десяток вулиця	Середній Десяток вулиця
Середній провулок	Середній провулок
Середній туп.	Середній туп.
Середня вулиця	Середня вулиця
Серет вулиця	Серет вулиця
Серп і Молот вулиця	Серп і Молот вулиця
Серп і Молот провулок	Серп і Молот провулок
Сеспеля вулиця	Сеспеля вулиця
Сечені вулиця	Сечені вулиця
Сєвєрная вулиця	Сєвєрная вулиця
Сєднєва вулиця	Сєднєва вулиця
Сиваша вулиця	Сиваша вулиця
Сивулька вулиця	Сивулька вулиця
Сидоришина вулиця	Сидоришина вулиця
Сидоряка вулиця	Сидоряка вулиця
Сикалка вулиця	Сикалка вулиця
Силакових вулиця	Силакових вулиця
Силкіних вулиця	Силкіних вулиця
Синій маршрут	Синій маршрут
Синій слід	Синій слід
Синовця вулиця	Синовця вулиця
Синько вулиця	Синько вулиця
Синьо-жовтий міст	Синьо-жовтий міст
Синюха провулок	Синюха провулок
Синя вулиця	Синя вулиця
Сиренєва вулиця	Сиренєва вулиця
Сировця вулиця	Сировця вулиця
СІА Мобайл	СІА Мобайл
Сіверка вулиця	Сіверка вулиця
Сіверса в’їзд	Сіверса вʼїзд
Сіверса вулиця	Сіверса вулиця
Сіґет вулиця	Сіґет вулиця
Сіді Таль вулиця	Сіді Таль вулиця
Сідловина - полонина	Сідловина - полонина
Сілаєва вулиця	Сілаєва вулиця
Сілваї вулиця	Сілваї вулиця
Сільваші вулиця	Сільваші вулиця
Сільвая вулиця	Сільвая вулиця
Сільгосп Технікум вулиця	Сільгосп Технікум вулиця
Сільце вулиця	Сільце вулиця
Сім'ї Розумовських вулиця	Сімʼї Розумовських вулиця
Сім'ї Сосніних вулиця	Сімʼї Сосніних вулиця
Сім’ї Дяківських вулиця	Сімʼї Дяківських вулиця
Сім’ї Ідзиковських вулиця	Сімʼї Ідзиковських вулиця
Сім’ї Кістяківських вулиця	Сімʼї Кістяківських вулиця
Сім’ї Колессів вулиця	Сімʼї Колессів вулиця
Сім’ї Красовських вулиця	Сімʼї Красовських вулиця
Сім’ї Прахових вулиця	Сімʼї Прахових вулиця
Сім’ї Розумовських вулиця	Сімʼї Розумовських вулиця
Сім’ї Сосніних вулиця	Сімʼї Сосніних вулиця
Сім’ї Хохлових вулиця	Сімʼї Хохлових вулиця
Сім’ї Шкарівських вулиця	Сімʼї Шкарівських вулиця
Сім’ї Шовкоплясів вулиця	Сімʼї Шовкоплясів вулиця
Сімʼї Бродських вулиця	Сімʼї Бродських вулиця
Сімʼї Житецьких вулиця	Сімʼї Житецьких вулиця
Сімʼї Тарасевичів провулок	Сімʼї Тарасевичів провулок
Сінічина вулиця	Сінічина вулиця
Сінько вулиця	Сінько вулиця
Сіра вулиця	Сіра вулиця
Сіренєва вулиця	Сіренєва вулиця
Сірко вулиця	Сірко вулиця
Сірожупанної Дивізії вулиця	Сірожупанної Дивізії вулиця
Сіропупа вулиця	Сіропупа вулиця
Сіті Лейк	Сіті Лейк
Січі вулиця	Січі вулиця
Січових Стрільців	Січових Стрільців
Скалевата вулиця	Скалевата вулиця
Скаліка вулиця	Скаліка вулиця
Сквер вулиця	Сквер вулиця
Сквер Здоров’я	Сквер Здоровʼя
Сквер Перемоги	Сквер Перемоги
Скеляста вулиця	Скеляста вулиця
Скелястий провулок	Скелястий провулок
Скітник вулиця	Скітник вулиця
Скобелка вулиця	Скобелка вулиця
Скоблі вулиця	Скоблі вулиця
Скоблі провулок	Скоблі провулок
Скоропадських вулиця	Скоропадських вулиця
Скотаря вулиця	Скотаря вулиця
Скринько вулиця	Скринько вулиця
Скубана вулиця	Скубана вулиця
Скульптора Вітрика провулок	Скульптора Вітрика провулок
Слабенюка вулиця	Слабенюка вулиця
Слідопитів вулиця	Слідопитів вулиця
Сліпа вулиця	Сліпа вулиця
Слобідка вулиця	Слобідка вулиця
Слобода вулиця	Слобода вулиця
Слободянука вулиця	Слободянука вулиця
Слупачика вулиця	Слупачика вулиця
Слуха вулиця	Слуха вулиця
Смаль Стоцкого	Смаль Стоцкого
Смерічка вулиця	Смерічка вулиця
Сміла вулиця	Сміла вулиця
Сміливих вулиця	Сміливих вулиця
Смоловика провулок	Смоловика провулок
Смолокур вулиця	Смолокур вулиця
Смолярня вулиця	Смолярня вулиця
Снайпер квартал	Снайпер квартал
Снайпера Адамия	Снайпера Адамия
Снайпера вулиця	Снайпера вулиця
Снайпера провулок	Снайпера провулок
Снігурі вулиця	Снігурі вулиця
Снігурових вулиця	Снігурових вулиця
СНТ Автомобилист	СНТ Автомобилист
СНТ Нептун	СНТ Нептун
СНТ Риф территория	СНТ Риф территория
СНТСН Парус	СНТСН Парус
Собачий провулок	Собачий провулок
Собесяка вулиця	Собесяка вулиця
Соболина вулиця	Соболина вулиця
Соборнв вулиця	Соборнв вулиця
Собрана вулиця	Собрана вулиця
Совєтов вулиця	Совєтов вулиця
Совхозная вулиця	Совхозная вулиця
Совхутір вулиця	Совхутір вулиця
Соколина вулиця	Соколина вулиця
Соколів провулок	Соколів провулок
Соколовських вулиця	Соколовських вулиця
Соколовських провулок	Соколовських провулок
Соколовських проїзд	Соколовських проїзд
Сокольники парк	Сокольники парк
Солеварів провулок	Солеварів провулок
Солобаєва вулиця	Солобаєва вулиця
Солов'їна вулиця	Соловʼїна вулиця
Солов‘їна вулиця	Солов‘їна вулиця
Солов’ їна вулиця	Соловʼ їна вулиця
Солов’їна вулиця	Соловʼїна вулиця
Солов`їна вулиця	Соловʼїна вулиця
Соловійка вулиця	Соловійка вулиця
Соловїна вулиця	Соловїна вулиця
Соловйових вулиця	Соловйових вулиця
Соловчиння вулиця	Соловчиння вулиця
Соловʼїна вулиця	Соловʼїна вулиця
Солоджука вулиця	Солоджука вулиця
Солодка вулиця	Солодка вулиця
Солом’янка вулиця	Соломʼянка вулиця
Солонці вулиця	Солонці вулиця
Солонці провулок	Солонці провулок
Солонцюватий провулок	Солонцюватий провулок
Сонця вулиця	Сонця вулиця
Сонячної провулок	Сонячної провулок
Сонячня вулиця	Сонячня вулиця
Сорокаріччя Жовтня вулиця	Сорокаріччя Жовтня вулиця
Сорокаріччя Жовтня провулок	Сорокаріччя Жовтня провулок
Сорокової Армії площа	Сорокової Армії площа
Сороханка вулиця	Сороханка вулиця
Сороча вулиця	Сороча вулиця
Сосніних вулиця	Сосніних вулиця
Сосонка вулиця	Сосонка вулиця
Сотні Спартана вулиця	Сотні Спартана вулиця
Софи Перовского	Софи Перовского
Софі центр	Софі центр
Сохора вулиця	Сохора вулиця
Соцгородок вулиця	Соцгородок вулиця
Соцмістечко вулиця	Соцмістечко вулиця
Соцпраці вулиця	Соцпраці вулиця
Соцпраці провулок	Соцпраці провулок
Союзу Українок вулиця	Союзу Українок вулиця
Спадиста вулиця	Спадиста вулиця
Спадистий провулок	Спадистий провулок
Спартак вулиця	Спартак вулиця
Спартана вулиця	Спартана вулиця
Спащина вулиця	Спащина вулиця
Спєшнєва вулиця	Спєшнєва вулиця
Спєшнєва провулок	Спєшнєва провулок
Співоча вулиця	Співоча вулиця
Співоче поле	Співоче поле
Співочий провулок	Співочий провулок
Співуча вулиця	Співуча вулиця
СПК Междуречье	СПК Междуречье
Спогадів вулиця	Спогадів вулиця
Сподівань вулиця	Сподівань вулиця
Спортгородок квартал	Спортгородок квартал
Спорткомплекс ЛНТУ	Спорткомплекс ЛНТУ
Спортмайдан вулиця	Спортмайдан вулиця
Спортсменів вулиця	Спортсменів вулиця
Спорту вулиця	Спорту вулиця
Спрейса вулиця	Спрейса вулиця
Спренжина вулиця	Спренжина вулиця
Спринька вулиця	Спринька вулиця
Спуск вулиця	Спуск вулиця
Спуск до водоспадів	Спуск до водоспадів
Спуск Ельдорадо	Спуск Ельдорадо
Спуск к пляжу	Спуск к пляжу
спуск через лес по ручью	спуск через лес по ручью
Спускна вулиця	Спускна вулиця
Сріблиста вулиця	Сріблиста вулиця
Сріблянка вулиця	Сріблянка вулиця
Срібляста вулиця	Срібляста вулиця
Сріблястий провулок	Сріблястий провулок
СТ “Автопроект“	СТ “Автопроект“
СТ “Автосервіс“	СТ “Автосервіс“
СТ “Вікторія“	СТ “Вікторія“
СТ “Віраж“	СТ “Віраж“
СТ “Віта“	СТ “Віта“
СТ “Здоровʼя-Мінерал“	СТ “Здоровʼя-Мінерал“
СТ “Золота осінь“	СТ “Золота осінь“
СТ “Камертон“	СТ “Камертон“
СТ “Кристал“	СТ “Кристал“
СТ “Лаванда“	СТ “Лаванда“
СТ “Містобудівник“	СТ “Містобудівник“
СТ “Монтажник“	СТ “Монтажник“
СТ “Світанок“	СТ “Світанок“
СТ “Спектр“	СТ “Спектр“
СТ „Авіатор“	СТ „Авіатор“
СТ „Автоматика“	СТ „Автоматика“
СТ „Берізка“	СТ „Берізка“
СТ „Біофізприлад“	СТ „Біофізприлад“
СТ „Вишенька“	СТ „Вишенька“
СТ „Вишиванка“	СТ „Вишиванка“
СТ „Джерело“	СТ „Джерело“
СТ „Дзвіночок“	СТ „Дзвіночок“
СТ „Електрик“	СТ „Електрик“
СТ „Енергетик“	СТ „Енергетик“
СТ „Затишок“	СТ „Затишок“
СТ „Калинка“	СТ „Калинка“
СТ „Колос“	СТ „Колос“
СТ „Конвеєр“	СТ „Конвеєр“
СТ „Лісок“	СТ „Лісок“
СТ „Надра“	СТ „Надра“
СТ „Нива“	СТ „Нива“
СТ „Побуттехніка“	СТ „Побуттехніка“
СТ „Проектувальник“	СТ „Проектувальник“
СТ „Сільмашовець“	СТ „Сільмашовець“
СТ „Холодок“	СТ „Холодок“
СТ „Чайка“	СТ „Чайка“
СТ „Явір“	СТ „Явір“
СТ «Парус»	СТ «Парус»
СТ Берег	СТ Берег
СТ Вільське	СТ Вільське
СТ Гавань	СТ Гавань
СТ Источник	СТ Источник
СТ Магістраль	СТ Магістраль
СТ Меркурий	СТ Меркурий
СТ Нечаево	СТ Нечаево
СТ Прибрежное	СТ Прибрежное
СТ Садоводческий	СТ Садоводческий
ст. Мечта	ст. Мечта
Став вулиця	Став вулиця
Став’янка вулиця	Ставʼянка вулиця
Ставище вулиця	Ставище вулиця
Ставок хутір	Ставок хутір
Стадіона вулиця	Стадіона вулиця
Сталеварів вулиця	Сталеварів вулиця
Станційне Селище вулиця	Станційне Селище вулиця
Станція Дружба	Станція Дружба
Станція Личаків вулиця	Станція Личаків вулиця
Старе Місто вулиця	Старе Місто вулиця
Старе Село вулиця	Старе Село вулиця
Стари Поділ вулиця	Стари Поділ вулиця
Старий брід	Старий брід
Старий бульвар	Старий бульвар
Старий Вал вулиця	Старий Вал вулиця
Старий Вал провулок	Старий Вал провулок
Старий вокзал вулиця	Старий вокзал вулиця
Старий закинутий спуск до Поштової	Старий закинутий спуск до Поштової
Старий Куток вулиця	Старий Куток вулиця
Старий міст	Старий міст
Старий переїзд	Старий переїзд
Старий Поділ вулиця	Старий Поділ вулиця
Старий провулок	Старий провулок
Старий Ринок	Старий Ринок
Старий Ринок вулиця	Старий Ринок вулиця
Старий Ринок площа	Старий Ринок площа
Старий Самбір	Старий Самбір
старий траверс	старий траверс
Старий шлях вулиця	Старий шлях вулиця
Старий Шлях вулиця	Старий Шлях вулиця
Старий шлях провулок	Старий шлях провулок
Старинці вулиця	Старинці вулиця
Старицьких вулиця	Старицьких вулиця
Стародавня вулиця	Стародавня вулиця
Старожилів вулиця	Старожилів вулиця
Старої Цегельні вулиця	Старої Цегельні вулиця
Старой село вулиця	Старой село вулиця
Старокозармена вулиця	Старокозармена вулиця
Старокоротка вулиця	Старокоротка вулиця
Старосілля вулиця	Старосілля вулиця
Старчеуса вулиця	Старчеуса вулиця
Стасової вулиця	Стасової вулиця
Стасової провулок	Стасової провулок
Стачок провулок	Стачок провулок
Сташко вулиця	Сташко вулиця
Стеблиста вулиця	Стеблиста вулиця
Стежка Водоспад - Кемпінг Заросляк	Стежка Водоспад - Кемпінг Заросляк
Стежка Говерла - Водоспад	Стежка Говерла - Водоспад
Стежка до альтанки	Стежка до альтанки
Стежка до водоспадів	Стежка до водоспадів
Стежка до водоспадів Довбуш і Дзвінка	Стежка до водоспадів Довбуш і Дзвінка
стежка до водоспаду	стежка до водоспаду
Стежка до водоспаду	Стежка до водоспаду
Стежка до водоспаду Під Коминои верхній	Стежка до водоспаду Під Коминои верхній
Стежка до водоспаду Під Комином	Стежка до водоспаду Під Комином
Стежка до водоспаду Рудавець	Стежка до водоспаду Рудавець
Стежка до джерела	Стежка до джерела
Стежка до джерела і купелі	Стежка до джерела і купелі
Стежка до Зарваниці	Стежка до Зарваниці
стежка до монастиря	стежка до монастиря
Стежка до струмка	Стежка до струмка
Стежка з Явірника на траверсну дрогу	Стежка з Явірника на траверсну дрогу
Стежка здоров’я	Стежка здоровʼя
Стежка Здоров’я	Стежка Здоровʼя
Стежка кохання	Стежка кохання
Стежка майже заросла	Стежка майже заросла
Стежка на пол. Струнґи	Стежка на пол. Струнґи
стежка на полонину Крами	стежка на полонину Крами
стежка на старий кордон	стежка на старий кордон
Стежка пішої варти Державної прикордонної служби України	Стежка пішої варти Державної прикордонної служби України
стежка по валу (чисто)	стежка по валу (чисто)
стежка по лісовівй дорозі	стежка по лісовівй дорозі
стежка полонина Крами - г. Грегіг - Полонина Веснарка	стежка полонина Крами - г. Грегіг - Полонина Веснарка
стежка у лісі	стежка у лісі
Стежка через город	Стежка через город
Стежка через залізницю	Стежка через залізницю
Стежка через колію	Стежка через колію
Стежка через кущі	Стежка через кущі
Стеньгача вулиця	Стеньгача вулиця
Степанянця вулиця	Степанянця вулиця
Степной квартал	Степной квартал
Степной тупик	Степной тупик
Стефаніка вулиця	Стефаніка вулиця
Стефановичів вулиця	Стефановичів вулиця
Стефенсона вулиця	Стефенсона вулиця
Стефініних вулиця	Стефініних вулиця
Стєпная вулиця	Стєпная вулиця
Стила вулиця	Стила вулиця
Стінка вулиця	Стінка вулиця
Стожка вулиця	Стожка вулиця
Столбуна вулиця	Столбуна вулиця
Столичне шосе	Столичне шосе
Сторожниця вулиця	Сторожниця вулиця
Сторона вулиця	Сторона вулиця
Стратегічне шосе	Стратегічне шосе
Стратилата вулиця	Стратилата вулиця
Стратілана вулиця	Стратілана вулиця
Страчених вулиця	Страчених вулиця
Стрий вулиця	Стрий вулиця
Стрілка вулиця	Стрілка вулиця
Стрімка вулиця	Стрімка вулиця
Стрімка лань	Стрімка лань
Строитєля вулиця	Строитєля вулиця
Строїтелів вулиця	Строїтелів вулиця
Стройнюка вулиця	Стройнюка вулиця
Строколіса вулиця	Строколіса вулиця
Строна вулиця	Строна вулиця
Стронка вулиця	Стронка вулиця
Струве вулиця	Струве вулиця
Струглі вулиця	Струглі вулиця
Струмок вулиця	Струмок вулиця
СТСН Гавань	СТСН Гавань
СТСН Гидростроитель	СТСН Гидростроитель
СТСН Металлист	СТСН Металлист
СТСТ Гидростроитель	СТСТ Гидростроитель
Стугна - трейл	Стугна - трейл
студ. городок ЛНАУ	студ. городок ЛНАУ
Студ. городок ЛНАУ	Студ. городок ЛНАУ
Студена вулиця	Студена вулиця
Студенок вулиця	Студенок вулиця
Студенства вулиця	Студенства вулиця
Студентів вулиця	Студентів вулиця
Суанбаєва вулиця	Суанбаєва вулиця
Суботня вулиця	Суботня вулиця
Сугой вулиця	Сугой вулиця
Судейка вулиця	Судейка вулиця
Сумовиця вулиця	Сумовиця вулиця
Сумсько-Київських Дивізій вулиця	Сумсько-Київських Дивізій вулиця
Супутник вулиця	Супутник вулиця
Супутника вулиця	Супутника вулиця
Суржана провулок	Суржана провулок
Сурмичі вулиця	Сурмичі вулиця
Суровцевої вулиця	Суровцевої вулиця
Сусідня вулиця	Сусідня вулиця
Сутець вулиця	Сутець вулиця
Суха Воля вулиця	Суха Воля вулиця
Суха вулиця	Суха вулиця
Сухарєва вулиця	Сухарєва вулиця
Сухе-Батора вулиця	Сухе-Батора вулиця
Сухий Ізюмець вулиця	Сухий Ізюмець вулиця
Сухий Ізюмець провулок	Сухий Ізюмець провулок
Сухий Острів вулиця	Сухий Острів вулиця
Сухий провулок	Сухий провулок
Сухий Яр вулиця	Сухий Яр вулиця
Сухий Яр провулок	Сухий Яр провулок
Суховоля вулиця	Суховоля вулиця
Сухопілля вулиця	Сухопілля вулиця
Схід пляж	Схід пляж
Схід провулок	Схід провулок
Східно-Дальня вулиця	Східно-Дальня вулиця
Східно-об’їздне шосе	Східно-Обʼїздне шосе
Сходи кохання	Сходи Кохання
Сходи Фаренгольца	Сходи Фаренгольца
Сябро вулиця	Сябро вулиця
Сяйво волуця	Сяйво волуця
Сяйво вулиця	Сяйво вулиця
Табла вулиця	Табла вулиця
Табукашвілі вулиця	Табукашвілі вулиця
Табукашвілі провулок	Табукашвілі провулок
Тадань вулиця	Тадань вулиця
Тадоровець вулиця	Тадоровець вулиця
Тайберів провулок	Тайберів провулок
Таймиру провулок	Таймиру провулок
Тайня вулиця	Тайня вулиця
Тайтек Потік вулиця	Тайтек Потік вулиця
Талалихина вулиця	Талалихина вулиця
Талічкадомб вулиця	Талічкадомб вулиця
Тамашина вулиця	Тамашина вулиця
Тампере вулиця	Тампере вулиця
Танєва провулок	Танєва провулок
Танєєва вулиця	Танєєва вулиця
Танєєва провулок	Танєєва провулок
Танкопія вулиця	Танкопія вулиця
Танкопія провулок	Танкопія провулок
Таньа вулиця	Таньа вулиця
Тарасів Шлях вулиця	Тарасів Шлях вулиця
Тарле вулиця	Тарле вулиця
Тарлє вулиця	Тарлє вулиця
Тарнава хутір	Тарнава хутір
Тарнавка вулиця	Тарнавка вулиця
Тарниця вулиця	Тарниця вулиця
Тарновських вулиця	Тарновських вулиця
Таськина стежка	Таськина стежка
Татарів Яр вулиця	Татарів Яр вулиця
Татарка вулиця	Татарка вулиця
Татарця вулиця	Татарця вулиця
Тацея вулиця	Тацея вулиця
Творимір вулиця	Творимір вулиця
Творча вулиця	Творча вулиця
Творчий провулок	Творчий провулок
Театр ляльок	Театр ляльок
Тевелєва в’їзд	Тевелєва вʼїзд
Тевелєва вулиця	Тевелєва вулиця
Тевелєва провулок	Тевелєва провулок
Телев’яка вулиця	Телевʼяка вулиця
Телеграфна вулиця	Телеграфна вулиця
Теметев вулиця	Теметев вулиця
Темето вулиця	Темето вулиця
Темира вулиця	Темира вулиця
Темника вулиця	Темника вулиця
Темницьких вулиця	Темницьких вулиця
Темплом вулиця	Темплом вулиця
Тениста вулиця	Тениста вулиця
Тепла вулиця	Тепла вулиця
Терека вулиця	Терека вулиця
Терекшової вулиця	Терекшової вулиця
Теренок провулок	Теренок провулок
Терешковой проспект	Терешковой проспект
Терєшкової вулиця	Терєшкової вулиця
Територія паркової зони санаторія Куяльник	Територія паркової зони санаторія Куяльник
Територія ЧРЗ	Територія ЧРЗ
Тернавіотів вулиця	Тернавіотів вулиця
Тернавка вулиця	Тернавка вулиця
Терниста стежка	Терниста стежка
Тернистий шлях грішника	Тернистий шлях грішника
Тернів вулиця	Тернів вулиця
Терпеливця вулиця	Терпеливця вулиця
Теряется в лесу	Теряется в лесу
Технікум комп'ютерних технологій	Технікум компʼютерних технологій
Тещин Язик проїзд	Тещин Язик проїзд
Тєніста вулиця	Тєніста вулиця
Тєністий провулок	Тєністий провулок
Тєрєшкової вулиця	Тєрєшкової вулиця
Тимирязєва вулиця	Тимирязєва вулиця
Тинка вулиця	Тинка вулиця
Тиса вулиця	Тиса вулиця
Тиха вулиця	Тиха вулиця
Тиха вулиця (Постайні)	Тиха вулиця (Постайні)
Тихе Життя вулиця	Тихе Життя вулиця
Тихий Кут вулиця	Тихий Кут вулиця
Тихий провулок	Тихий провулок
Тихий проїзд	Тихий проїзд
Тихий тупик	Тихий тупик
Тишика вулиця	Тишика вулиця
Тищика вулиця	Тищика вулиця
Тищика провулок	Тищика провулок
Тімірязєва в'їзд	Тімірязєва вʼїзд
Тімірязєва вулиця	Тімірязєва вулиця
Тімірязєва провулок	Тімірязєва провулок
Тініста вулиця	Тініста вулиця
Тіноді вулиця	Тіноді вулиця
Тірас провулок	Тірас провулок
Ткачів вулиця	Ткачів вулиця
То-вар вулиця	То-вар вулиця
Тобілевичів провулок	Тобілевичів провулок
Тобілевічів вулиця	Тобілевічів вулиця
Товмацьке відділення вулиця	Товмацьке відділення вулиця
Товсег вулиця	Товсег вулиця
Той кут	Той кут
Токаревських вулиця	Токаревських вулиця
Толбухина вулиця	Толбухина вулиця
Толді вулиця	Толді вулиця
Толочина вулиця	Толочина вулиця
Тольмаца вулиця	Тольмаца вулиця
Тольятті вулиця	Тольятті вулиця
Тольятті провулок	Тольятті провулок
Тольятті узвіз	Тольятті узвіз
Тонель под Одесской трассой	Тонель под Одесской трассой
Тонконіг вулиця	Тонконіг вулиця
Тонконіг провулок	Тонконіг провулок
Тонкочеєва вулиця	Тонкочеєва вулиця
Тонкошнура вулиця	Тонкошнура вулиця
тоннель на пляж	тоннель на пляж
Тополєва вулиця	Тополєва вулиця
Тополина вулиця	Тополина вулиця
Тополина Вулиця	Тополина Вулиця
Тополина провулок	Тополина провулок
Топчиєва вулиця	Топчиєва вулиця
Торговиця вулиця	Торговиця вулиця
Траверс г. Кінець Ґорґану	Траверс г. Кінець Ґорґану
Траверс г.Молода	Траверс г.Молода
траверс Говерли	траверс Говерли
Траверс гори Під Ребрами	Траверс гори Під Ребрами
траверс Данцижа	траверс Данцижа
траверс Кам'янки	траверс Камʼянки
Траверс масиву Укерни	Траверс масиву Укерни
траверс на Переніз	траверс на Переніз
траверс Парашки	траверс Парашки
траверс Переслупа	траверс Переслупа
траверс Пожижевської	траверс Пожижевської
Траверс Полєнскі	Траверс Полєнскі
траверс Стогу	траверс Стогу
траверс Туркула	траверс Туркула
траверс Шешула	траверс Шешула
Трависта вулиця	Трависта вулиця
Травневої провулок	Травневої провулок
Тракторної провулок	Тракторної провулок
Трандафірілор вулиця	Трандафірілор вулиця
Транспортне шосе вулиця	Транспортне шосе вулиця
Траса газопроводу	Траса газопроводу
Траса Даунхіл	Траса Даунхіл
Траса здоров’я	Траса здоровʼя
Траса картингу	Траса картингу
Траса Мотокроса	Траса Мотокроса
Траса Фрірайд	Траса Фрірайд
Трасса для Багги	Трасса для Багги
Трасса для мотокросса	Трасса для мотокросса
Трасса Ралли Мариуполь	Трасса Ралли Мариуполь
Трачів вулиця	Трачів вулиця
Траян вулиця	Траян вулиця
Трембовецької вулиця	Трембовецької вулиця
Три мости	Три мости
Тригубенкових вулиця	Тригубенкових вулиця
Тридуба вулиця	Тридуба вулиця
Трикутник урочище	Трикутник урочище
Трінклера в’їзд	Трінклера вʼїзд
Трінклера вулиця	Трінклера вулиця
Троицка вулиця	Троицка вулиця
тропинка на вершину террикона	тропинка на вершину террикона
Тростянець вулиця	Тростянець вулиця
Тростянка вулиця	Тростянка вулиця
Трохименкове вулиця	Трохименкове вулиця
Троянд вулиця	Троянд вулиця
Троянд провулок	Троянд провулок
Троянда вулиця	Троянда вулиця
труба через канал	труба через канал
Трубіцина вулиця	Трубіцина вулиця
Трублаїні вулиця	Трублаїні вулиця
Трублаїні провулок	Трублаїні провулок
Трубне містечко	Трубне містечко
Труда вулиця	Труда вулиця
Труда площа	Труда площа
Труда провулок	Труда провулок
Труда проспект	Труда проспект
Трударів вулиця	Трударів вулиця
Трудових резервів вулиця	Трудових резервів вулиця
Трудових Резервів вулиця	Трудових Резервів вулиця
Трудових резервів провулок	Трудових резервів провулок
Трудової Алеї вулиця	Трудової Алеї вулиця
Труженіков вулиця	Труженіков вулиця
Трутка вулиця	Трутка вулиця
Труфанка вулиця	Труфанка вулиця
Труховської-Ванеєвої вулиця	Труховської-Ванеєвої вулиця
Труща провулок	Труща провулок
Трьох Космонавтів вулиця	Трьох Космонавтів вулиця
ТС Таврия	ТС Таврия
ТСН Берег	ТСН Берег
ТСН Восход	ТСН Восход
ТСН ДНТ Волга	ТСН ДНТ Волга
ТСН ДНТ Волга тер.	ТСН ДНТ Волга тер.
ТСН Импульс	ТСН Импульс
ТСН Море	ТСН Море
ТСН СНТ Гидронавт территория	ТСН СНТ Гидронавт территория
ТСН СНТ Мираж	ТСН СНТ Мираж
ТСН СНТ Риф территория	ТСН СНТ Риф территория
ТСН СНТ Сапун-гора	ТСН СНТ Сапун-гора
ТСН СНТ Сапун-гора тер.	ТСН СНТ Сапун-гора тер.
ТСН СТ Коррида	ТСН СТ Коррида
ТСН СТ Морзаводец	ТСН СТ Морзаводец
ТСН СТ Полюшко	ТСН СТ Полюшко
ТСН Строитель	ТСН Строитель
ТСН Черноморец	ТСН Черноморец
Туєва вулиця	Туєва вулиця
Тулянка вулиця	Тулянка вулиця
Тупа вулиця	Тупа вулиця
Тупий провулок	Тупий провулок
тупик Бабушкин	тупик Бабушкин
Тупик вулиця	Тупик вулиця
тупик Горовой	тупик Горовой
Тупик провулок	Тупик провулок
тупик Фрунзе	тупик Фрунзе
Тупік провулок	Тупік провулок
Тур’є Горішнє вулиця	Турʼє Горішнє вулиця
Тургєнєва вулиця	Тургєнєва вулиця
Тургєнєва провулок	Тургєнєва провулок
Туристов шоссе	Туристов шоссе
Туриха вулиця	Туриха вулиця
Турковичі вулиця	Турковичі вулиця
Турової вулиця	Турової вулиця
Туровца вулиця	Туровца вулиця
Турція вулиця	Турція вулиця
ТЦ Глобус	ТЦ Глобус
ТЦ Імідж	ТЦ Імідж
ТЦ Слон	ТЦ Слон
Тюменцева-Хвилі вулиця	Тюменцева-Хвилі вулиця
У Ведмедя	У Ведмедя
у лісовика	у лісовика
Ударник вулиця	Ударник вулиця
Ударника вулиця	Ударника вулиця
Ударника провулок	Ударника провулок
Удачі провулок	Удачі провулок
УЖЕ НЕ СУЩЕСТВУЕТ	УЖЕ НЕ СУЩЕСТВУЕТ
Узвіз вулиця	Узвіз вулиця
Узловой тупик	Узловой тупик
Уй вулиця	Уй вулиця
Уйварі вулиця	Уйварі вулиця
Уйшор вулиця	Уйшор вулиця
Українка вулиця	Українка вулиця
Українських воїнів вулиця	Українських воїнів вулиця
Українських воїнів провулок	Українських воїнів провулок
Українських Героїв вулиця	Українських Героїв вулиця
Українських Захисниць вулиця	Українських Захисниць вулиця
Українських Космонавтів вулиця	Українських Космонавтів вулиця
Українських Матерів провулок	Українських Матерів провулок
Українських партизан вулиця	Українських партизан вулиця
Українських Перемог вулиця	Українських Перемог вулиця
Українських соколів вулиця	Українських соколів вулиця
Улан-Батора вулиця	Улан-Батора вулиця
Уличнянка вулиця	Уличнянка вулиця
Ульбріхта вулиця	Ульбріхта вулиця
Ульянових вулиця	Ульянових вулиця
Ульянових провулок	Ульянових провулок
Умивальня вулиця	Умивальня вулиця
Умникової вулиця	Умникової вулиця
УНР вулиця	УНР вулиця
Уншліхта вулиця	Уншліхта вулиця
Унявко вулиця	Унявко вулиця
УПА вулиця	УПА вулиця
Упертий тупик	Упертий тупик
Упіта вулиця	Упіта вулиця
ур. Перед Ґаджиною	урочище Перед Ґаджиною
Урбайліса вулиця	Урбайліса вулиця
Урочиста вулиця	Урочиста вулиця
Урочище Береги	Урочище Береги
урочище Біля Башні	урочище Біля Башні
урочище Вишня	урочище Вишня
урочище водоканал	урочище водоканал
Урочище Довгий Грунь	Урочище Довгий Грунь
Урочище Женець	Урочище Женець
Урочище За Заволом вулиця	Урочище За Заволом вулиця
Урочище іподром вулиця	Урочище іподром вулиця
урочище Йозифсталь	урочище Йозифсталь
Урочище Кам'янка	Урочище Камʼянка
урочище Лан	урочище Лан
урочище Могилянське	урочище Могилянське
урочище Новопроектний	урочище Новопроектний
урочище Під Танком	урочище Під Танком
урочище Сад	урочище Сад
Урочище святе	Урочище святе
Урочище Святе вулиця	Урочище Святе вулиця
Урочище ферма вулиця	Урочище ферма вулиця
Усеина Баданинского	Усеина Баданинского
Успенських вулиця	Успенських вулиця
Устияновичів вулиця	Устияновичів вулиця
учбове містечко ХНАУ вулиця	учбове містечко ХНАУ вулиця
Училищна вулиця	Училищна вулиця
Ущелье Йохаган - Су	Ущелье Йохаган - Су
Уютная вулиця	Уютная вулиця
Фаберже вулиця	Фаберже вулиця
Фабрика Динамо	Фабрика Динамо
Фабрика Світанок	Фабрика Світанок
Фабриціуса вулиця	Фабриціуса вулиця
Фабриціуса провулок	Фабриціуса провулок
Фабріціуса вулиця	Фабріціуса вулиця
Фабріціуса провулок	Фабріціуса провулок
Фадеєва вулиця	Фадеєва вулиця
Фадеєва провулок	Фадеєва провулок
Фалалеєва провулок	Фалалеєва провулок
Февут вулиця	Февут вулиця
Федорці вулиця	Федорці вулиця
Федько вулиця	Федько вулиця
Федько провулок	Федько провулок
Феєш вулиця	Феєш вулиця
Фелвег вулиця	Фелвег вулиця
Фелшо Мікефалва вулиця	Фелшо Мікефалва вулиця
Фені Мотильової вулиця	Фені Мотильової вулиця
Феньвеш вулиця	Феньвеш вулиця
Феодосийское шоссе	Феодосийское шоссе
Ферсмана вулиця	Ферсмана вулиця
Филона Джалалія вулиця	Филона Джалалія вулиця
Фиолентовское шоссе	Фиолентовское шоссе
Фіалок провулок	Фіалок провулок
Фігнера вулиця	Фігнера вулиця
Фігура вулиця	Фігура вулиця
Фізкультурника провулок	Фізкультурника провулок
Фікселя вулиця	Фікселя вулиця
Фікселя провулок	Фікселя провулок
Філіпських вулиця	Філіпських вулиця
Філодорів провулок	Філодорів провулок
Фінляндія вулиця	Фінляндія вулиця
Фіньов вулиця	Фіньов вулиця
Фісака в'їзд	Фісака вʼїзд
Фісака вулиця	Фісака вулиця
Фісака провулок	Фісака провулок
Флоксов провулок	Флоксов провулок
Флоренції вулиця	Флоренції вулиця
Фогодо вулиця	Фогодо вулиця
Фогороші вулиця	Фогороші вулиця
Фоміних вулиця	Фоміних вулиця
Фонтене-су-Буа вулиця	Фонтене-су-Буа вулиця
Форраш вулиця	Форраш вулиця
Фотієвої вулиця	Фотієвої вулиця
Франко вулиця	Франко вулиця
Франко провулок	Франко провулок
Фрітаун вулиця	Фрітаун вулиця
Фролич вулиця	Фролич вулиця
Фруктових садів вулиця	Фруктових садів вулиця
Фруктових садів провулок	Фруктових садів провулок
Фрунзе в’їзд	Фрунзе вʼїзд
Фрунзе вулиця	Фрунзе вулиця
Фрунзе вуліця	Фрунзе вуліця
Фрунзе площа	Фрунзе площа
Фрунзе провулок	Фрунзе провулок
Фрунзе проспект	Фрунзе проспект
Фрунзе спуск	Фрунзе спуск
Фрунзенское шоссе	Фрунзенское шоссе
Фуко вулиця	Фуко вулиця
Фуріка вулиця	Фуріка вулиця
Фучіка вулиця	Фучіка вулиця
Фюзеш вулиця	Фюзеш вулиця
Фюрде вулиця	Фюрде вулиця
Хабаря вулиця	Хабаря вулиця
Хаврука вулиця	Хаврука вулиця
Хазана провулок	Хазана провулок
Халаменюка вулиця	Халаменюка вулиця
Халтурина вулиця	Халтурина вулиця
Хамбіра вулиця	Хамбіра вулиця
Хамковиця вулиця	Хамковиця вулиця
Хані вулиця	Хані вулиця
Харазії вулиця	Харазії вулиця
Харківських Дивізій вулиця	Харківських Дивізій вулиця
Харківця вулиця	Харківця вулиця
Харлампієва вулиця	Харлампієва вулиця
Харпака вулиця	Харпака вулиця
Харьковское шоссе	Харьковское шоссе
Хаткіної вулиця	Хаткіної вулиця
Хатрі вулиця	Хатрі вулиця
Хатхаз вулиця	Хатхаз вулиця
Хащ вулиця	Хащ вулиця
Хвилі Олентиря вулиця	Хвилі Олентиря вулиця
Хвиляста вулиця	Хвиляста вулиця
Хвилястий провулок	Хвилястий провулок
Хвої вулиця	Хвої вулиця
Хедь вулиця	Хедь вулиця
Херсонское шоссе	Херсонское шоссе
Химка вулиця	Химка вулиця
Химушина вулиця	Химушина вулиця
Хирів вулиця	Хирів вулиця
Хитрий провулок	Хитрий провулок
Хитрий Ринок провулок	Хитрий Ринок провулок
Хичія вулиця	Хичія вулиця
Хімік квартал	Хімік квартал
Хіміків вулиця	Хіміків вулиця
Хіміків провулок	Хіміків провулок
Хіміків проспект	Хіміків проспект
Хітєєва вулиця	Хітєєва вулиця
Хлібороб вулиця	Хлібороб вулиця
Хлібороба вулиця	Хлібороба вулиця
Хлібороба провулок	Хлібороба провулок
Хліборобів вулиця	Хліборобів вулиця
Хліборобів провулок	Хліборобів провулок
Хлопуші вулиця	Хлопуші вулиця
Хмелинець вулиця	Хмелинець вулиця
Хмельницьке шосе	Хмельницьке шосе
Хмельницьке шосе вулиця	Хмельницьке шосе вулиця
Хмельницьке шосе провулок	Хмельницьке шосе провулок
Хміль вулиця	Хміль вулиця
Ходарєва вулиця	Ходарєва вулиця
Холмиста вулиця	Холмиста вулиця
Хоптяра вулиця	Хоптяра вулиця
Хоробрих вулиця	Хоробрих вулиця
Хорової Капели Боян вулиця	Хорової Капели Боян вулиця
Хортицьке шосе	Хортицьке шосе
Хохтів вулиця	Хохтів вулиця
Хохтіф вулиця	Хохтіф вулиця
Храпая вулиця	Храпая вулиця
Хребет Баньков	Хребет Баньков
Хрещата вулиця	Хрещата вулиця
Хрещатик вулиця	Хрещатик вулиця
Хрещатик провулок	Хрещатик провулок
Хризантем вулиця	Хризантем вулиця
Христина вулиця	Христина вулиця
Христо Ботєва вулиця	Христо Ботєва вулиця
Христо-Ботіво вулиця	Христо-Ботіво вулиця
Хриcтини Сушко провулок	Христини Сушко провулок
Хрустальское шосе	Хрустальское шосе
Хрустальское шоссе	Хрустальское шоссе
ХТЗ вулиця	ХТЗ вулиця
ХТЗ провулок	ХТЗ провулок
Хутір Буда	Хутір Буда
Хутір вулиця	Хутір вулиця
Хутір Глинище	Хутір Глинище
хутір Горгулі вулиця	хутір Горгулі вулиця
Хутір Комінтерн вулиця	Хутір Комінтерн вулиця
хутір Мідне вулиця	хутір Мідне вулиця
Хутір Під Лісом вулиця	Хутір Під Лісом вулиця
Хутір Під Покропивнею	Хутір Під Покропивнею
Хутір провулок	Хутір провулок
Хутір Тарнава вулиця	Хутір Тарнава вулиця
Хутір Тернава вулиця	Хутір Тернава вулиця
Хутір Транспорт вулиця	Хутір Транспорт вулиця
Хуторище вулиця	Хуторище вулиця
Хуторок вулиця	Хуторок вулиця
Хущовка вулиця	Хущовка вулиця
ХХ Партз’їзда вулиця	ХХ Партзʼїзда вулиця
ХХІ Партз'їзду вулиця	ХХІ Партзʼїзду вулиця
Цадика вулиця	Цадика вулиця
Цадика провулок	Цадика провулок
Царина площа	Царина площа
Царицина вулиця	Царицина вулиця
Цвітаєва вулиця	Цвітаєва вулиця
Цвяньковець вулиця	Цвяньковець вулиця
Цеглянка вулиця	Цеглянка вулиця
Целіш вулиця	Целіш вулиця
Цендрівських вулиця	Цендрівських вулиця
Центр вулиця	Центр вулиця
Центральної вулиці провулок	Центральної вулиці провулок
Центральня вулиця	Центральня вулиця
Ценцарівщина вулиця	Ценцарівщина вулиця
Цепреуза вулиця	Цепреуза вулиця
Церетелі вулиця	Церетелі вулиця
Цертія вулиця	Цертія вулиця
Цеткін вулиця	Цеткін вулиця
Цибулько вулиця	Цибулько вулиця
Циганика провулок	Циганика провулок
Цимбалиста вулиця	Цимбалиста вулиця
Цимбалів Яр вулиця	Цимбалів Яр вулиця
Цимбалів Яр провулок	Цимбалів Яр провулок
ЦНС вулиця	ЦНС вулиця
ЦТР вулиця	ЦТР вулиця
Цукрозавод вулиця	Цукрозавод вулиця
Цукрозаводу вулиця	Цукрозаводу вулиця
Цулукидзе вулиця	Цулукидзе вулиця
Цуперів провулок	Цуперів провулок
Чабан Кале	Чабан Кале
Чадунелі вулиця	Чадунелі вулиця
Чайка вулиця	Чайка вулиця
Чайкіної вулиця	Чайкіної вулиця
Чайкіної провулок	Чайкіної провулок
Чайкіной вулиця	Чайкіной вулиця
Чалаплюка вулиця	Чалаплюка вулиця
Чалдаєва вулиця	Чалдаєва вулиця
Чанчибадзе вулиця	Чанчибадзе вулиця
Чапаевской дивизии	Чапаевской дивизии
Чапаєвка вулиця	Чапаєвка вулиця
Чапраєва вулиця	Чапраєва вулиця
Частника вулиця	Частника вулиця
Чебанця вулиця	Чебанця вулиця
Чекалових вулиця	Чекалових вулиця
Чекаля вулиця	Чекаля вулиця
Чекіста вулиця	Чекіста вулиця
Чекістів-Гайно вулиця	Чекістів-Гайно вулиця
Челебі Джихана вулиця	Челебі Джихана вулиця
Челпана вулиця	Челпана вулиця
Челюскина вулиця	Челюскина вулиця
Челюскинцев вулиця	Челюскинцев вулиця
Челюскінцев вулиця	Челюскінцев вулиця
Чемпіонів вулиця	Чемпіонів вулиця
Ченцових вулиця	Ченцових вулиця
Чепаш вулиця	Чепаш вулиця
Червениця вулиця	Червениця вулиця
Червогоро Хреста провулок	Червогоро Хреста провулок
Червона Алея в’їзд	Червона Алея вʼїзд
Червона Алея вулиця	Червона Алея вулиця
Червона вулиця	Червона вулиця
Червона гірка вулиця	Червона гірка вулиця
Червона Гірка вулиця	Червона Гірка вулиця
Червона Гірка провулок	Червона Гірка провулок
Червона гора вулиця	Червона гора вулиця
Червона Гребля вулиця	Червона Гребля вулиця
Червона долина вулиця	Червона долина вулиця
Червона Зірка вулиця	Червона Зірка вулиця
Червона Зоря вулиця	Червона Зоря вулиця
Червона площа	Червона площа
Червона Рута вулиця	Червона Рута вулиця
Червона Січ вулиця	Червона Січ вулиця
Червона Слобода вулиця	Червона Слобода вулиця
Червоне Селище вулиця	Червоне Селище вулиця
Червоних Зорь вулиця	Червоних Зорь вулиця
Червоних Зорь провулок	Червоних Зорь провулок
Червоних Командирів вулиця	Червоних Командирів вулиця
Червоних Курсантів вулиця	Червоних Курсантів вулиця
Червоних партизан вулиця	Червоних партизан вулиця
Червоних Партизан вулиця	Червоних Партизан вулиця
Червоних партизан провулок	Червоних партизан провулок
Червоних Партизан провулок	Червоних Партизан провулок
Червоних Пілотів в’їзд	Червоних Пілотів вʼїзд
Червоних Пілотів вулиця	Червоних Пілотів вулиця
Червоних Робітниць вулиця	Червоних Робітниць вулиця
Червоних Слідопитів вулиця	Червоних Слідопитів вулиця
Червоних Старшин вулиця	Червоних Старшин вулиця
Червоних Троянд вулиця	Червоних Троянд вулиця
Червоних Троянд провулок	Червоних Троянд провулок
Червонія вулиця	Червонія вулиця
Червонія провулок	Червонія провулок
Червонокозача вулиця	Червонокозача вулиця
Червоноселищна вулиця	Червоноселищна вулиця
Череднюка вулиця	Череднюка вулиця
Через карьер	Через карьер
через поляну	через поляну
Черемоша вулиця	Черемоша вулиця
Черепвивдь вулиця	Черепвивдь вулиця
Черлінка вулиця	Черлінка вулиця
Черлінка провулок	Черлінка провулок
Черная дорога	Черная дорога
Чернеча вулиця	Чернеча вулиця
Чернечий провулок	Чернечий провулок
Чернещина вулиця	Чернещина вулиця
Черницина вулиця	Черницина вулиця
Черничко вулиця	Черничко вулиця
Чернігівсьна вулиця	Чернігівсьна вулиця
Черноморское шоссе	Черноморское шоссе
Чернопятка вулиця	Чернопятка вулиця
Чернявка провулок	Чернявка провулок
Чертежик вулиця	Чертежик вулиця
Чертіж вулиця	Чертіж вулиця
Чесака вулиця	Чесака вулиця
Чечеловка вулиця	Чечеловка вулиця
Чибінєєва вулиця	Чибінєєва вулиця
Чигор вулиця	Чигор вулиця
Чижевських вулиця	Чижевських вулиця
Чижевських провулок	Чижевських провулок
Чикериса вулиця	Чикериса вулиця
Чирганка вулиця	Чирганка вулиця
Чиста вулиця	Чиста вулиця
Чистий провулок	Чистий провулок
Чистопілля вулиця	Чистопілля вулиця
Читачів вулиця	Читачів вулиця
Чичиклія вулиця	Чичиклія вулиця
Чігосуг вулиця	Чігосуг вулиця
Чікош Керт вулиця	Чікош Керт вулиця
Чіпі вулиця	Чіпі вулиця
Чкалову вулиця	Чкалову вулиця
Чмилів провулок	Чмилів провулок
Чоботаря вулиця	Чоботаря вулиця
Чоботька вулиця	Чоботька вулиця
Чолнокі вулиця	Чолнокі вулиця
Чонкаш вулиця	Чонкаш вулиця
Чорнобаївка вулиця	Чорнобаївка вулиця
Чорновіла вулиця	Чорновіла вулиця
Чорноп’ятка вулиця	Чорнопʼятка вулиця
Чороновола вулиця	Чороновола вулиця
Чорторийських вулиця	Чорторийських вулиця
Чпаєва вулиця	Чпаєва вулиця
Чрновола вулиця	Чрновола вулиця
Чубінідзе вулиця	Чубінідзе вулиця
Чубчика вулиця	Чубчика вулиця
Чугаєва вулиця	Чугаєва вулиця
Чугайстра вулиця	Чугайстра вулиця
Чуляка вулиця	Чуляка вулиця
Чумак провулок	Чумак провулок
Чумацтва вулиця	Чумацтва вулиця
Чупрея вулиця	Чупрея вулиця
Чурай вулиця	Чурай вулиця
Чутовка вулиця	Чутовка вулиця
Чхаїдзе вулиця	Чхаїдзе вулиця
Шаврина вулиця	Шаврина вулиця
Шагая вулиця	Шагая вулиця
Шайба вулиця	Шайба вулиця
Шакала вулиця	Шакала вулиця
Шакала провулок	Шакала провулок
Шаму Цабана вулиця	Шаму Цабана вулиця
Шанковських вулиця	Шанковських вулиця
Шанцера вулиця	Шанцера вулиця
Шапка вулиця	Шапка вулиця
Шарабана вулиця	Шарабана вулиця
Шарі Федак вулиця	Шарі Федак вулиця
Шаркуна вулиця	Шаркуна вулиця
Шахна вулиця	Шахна вулиця
Шахово вулиця	Шахово вулиця
Шахтарів вулиця	Шахтарів вулиця
Шахтарів Донбасу вулиця	Шахтарів Донбасу вулиця
Шахтарів провулок	Шахтарів провулок
Шахтарів проспект	Шахтарів проспект
Шахтаря вулиця	Шахтаря вулиця
Шахтостроитєлєй вулиця	Шахтостроитєлєй вулиця
Шахунянца провулок	Шахунянца провулок
Шашко провулок	Шашко провулок
Шваленберга вулиця	Шваленберга вулиця
Шверніка провулок	Шверніка провулок
Шевчена вулиця	Шевчена вулиця
Шелепаєва вулиця	Шелепаєва вулиця
Шенгелія вулиця	Шенгелія вулиця
Шепотинника провулок	Шепотинника провулок
Шептицьких вулиця	Шептицьких вулиця
Шептицьких провулок	Шептицьких провулок
Шерегія вулиця	Шерегія вулиця
Шереметка вулиця	Шереметка вулиця
Шереметка провулок	Шереметка провулок
Шереметка проїзд	Шереметка проїзд
Шеші вулиця	Шеші вулиця
Шибене - Стіг	Шибене - Стіг
Шиблеї вулиця	Шиблеї вулиця
Шилінгера вулиця	Шилінгера вулиця
Ширван-Заде вулиця	Ширван-Заде вулиця
Широка вулиця	Широка вулиця
Широка площа	Широка площа
Широка площа вулиця	Широка площа вулиця
Широке вулиця	Широке вулиця
Шитів Потік вулиця	Шитів Потік вулиця
Шімзерів вулиця	Шімзерів вулиця
Шімона Голлоші вулиця	Шімона Голлоші вулиця
Шімона Меньгерта вулиця	Шімона Меньгерта вулиця
Шкирмановка -Антоновка	Шкирмановка -Антоновка
Шкільній провулок	Шкільній провулок
Шкрібляків вулиця	Шкрібляків вулиця
Шкуматових вулиця	Шкуматових вулиця
Шкурко вулиця	Шкурко вулиця
Шлюз вулиця	Шлюз вулиця
Шлямара вулиця	Шлямара вулиця
Шлях вулиця	Шлях вулиця
Шлях до Великої галявини	Шлях до Великої галявини
Шлях До Греблі проїзд	Шлях До Греблі проїзд
Шлях до Комунізму вулиця	Шлях до Комунізму вулиця
Шлях Комсомольский	Шлях Комсомольский
Шлях провулок	Шлях провулок
шлях Теренкур	шлях Теренкур
Шляхотчина Долина вулиця	Шляхотчина Долина вулиця
Шляхта вулиця	Шляхта вулиця
Шмiдта вулиця	Шмідта вулиця
Шнеєрсона вулиця	Шнеєрсона вулиця
Шовгениха вулиця	Шовгениха вулиця
Шовковиць вулиця	Шовковиць вулиця
Шовкостанція вулиця	Шовкостанція вулиця
Шорса вулиця	Шорса вулиця
Шосселя вулиця	Шосселя вулиця
Шостопарк в’їзд	Шостопарк вʼїзд
Шостопарк вулиця	Шостопарк вулиця
Шостопарк провулок	Шостопарк провулок
Шпіндяка вулиця	Шпіндяка вулиця
Шпудейка вулиця	Шпудейка вулиця
Штагера провулок	Штагера провулок
Штефаника вулиця	Штефаника вулиця
Штронд вулиця	Штронд вулиця
Штурмовой тупик	Штурмовой тупик
Шугар вулиця	Шугар вулиця
Шуліко вулиця	Шуліко вулиця
Шульгіних вулиця	Шульгіних вулиця
Шумейко вулиця	Шумейко вулиця
Шумлявщина вулиця	Шумлявщина вулиця
Шумлянських вулиця	Шумлянських вулиця
Шунделевих вулиця	Шунделевих вулиця
Шутуство вулиця	Шутуство вулиця
Шутько вулиця	Шутько вулиця
Шухевичів вулиця	Шухевичів вулиця
Шухляєва площа	Шухляєва площа
Щастя вулиця	Щастя вулиця
Щастя провулок	Щастя провулок
Щебетунів вулиця	Щебетунів вулиця
Щедра вулиця	Щедра вулиця
Щедрий провулок	Щедрий провулок
Щербініних вулиця	Щербініних вулиця
Щєрбака вулиця	Щєрбака вулиця
Щимель вулиця	Щимель вулиця
Энергетиков квартал	Энергетиков квартал
Ювілейне коло	Ювілейне коло
Южина вулиця	Южина вулиця
Южнобережное шоссе	Южнобережное шоссе
Южнокольцевой тупик	Южнокольцевой тупик
Южноуральскій провулок	Южноуральскій провулок
Юзикевичів вулиця	Юзикевичів вулиця
Юність вулиця	Юність вулиця
Юннатів вулиця	Юннатів вулиця
Юннатів провулок	Юннатів провулок
Юннатів тупик	Юннатів тупик
Юона вулиця	Юона вулиця
Юр’єва бульвар	Юрʼєва бульвар
Юр’єва вулиця	Юрʼєва вулиця
Юрдига вулиця	Юрдига вулиця
Юрдика вулиця	Юрдика вулиця
Юрковиця вулиця	Юрковиця вулиця
Юрчинських вулиця	Юрчинських вулиця
Юстиції вулиця	Юстиції вулиця
Юхимука вулиця	Юхимука вулиця
Яблонєвая вулиця	Яблонєвая вулиця
Яблочкіної вулиця	Яблочкіної вулиця
Яблочкіної провулок	Яблочкіної провулок
Яблуново вулиця	Яблуново вулиця
Яворів вулиця	Яворів вулиця
Якира квартал	Якира квартал
Яківчика вулиця	Яківчика вулиця
Якіра вулиця	Якіра вулиця
Якіра квартал	Якіра квартал
Якіра провулок	Якіра провулок
Якорное кольцо	Якорное кольцо
Ялинка вулиця	Ялинка вулиця
Яловець вулиця	Яловець вулиця
Ялта Карт	Ялта Карт
Ялтинское шоссе	Ялтинское шоссе
Яндюків вулиця	Яндюків вулиця
Яноніса вулиця	Яноніса вулиця
Яр вулиця	Яр вулиця
Яремче - пол Маковиця - Ямна	Яремче - пол Маковиця - Ямна
Яремче - пол. Маковиця	Яремче - пол. Маковиця
Яржина вулиця	Яржина вулиця
Ярий провулок	Ярий провулок
Ярі вулиця	Ярі вулиця
Ярмарок майстрів	Ярмарок майстрів
Ярмошука вулиця	Ярмошука вулиця
Ярмуша вулиця	Ярмуша вулиця
Яровиця вулиця	Яровиця вулиця
Ярославів Вал вулиця	Ярославів Вал вулиця
Ярошка вулиця	Ярошка вулиця
Яршиця вулиця	Яршиця вулиця
Ясеничче вулиця	Ясеничче вулиця
Ясенів вулиця	Ясенів вулиця
Ясиня (Свидовець) ― пол.Шиса	Ясиня (Свидовець) ― пол.Шиса
Яскрава вулиця	Яскрава вулиця
Ятрань вулиця	Ятрань вулиця
Яцьківа вулиця	Яцьківа вулиця
Bohuna вулиця	вулиця Богуна
Cвітла вулиця	Світла вулиця
Cемена Гризла вулиця	Семена Гризла вулиця
I Лиман вулиця	I Лиман вулиця
II Лиман вулиця	II Лиман вулиця
III Інтернаціоналу вулиця	III Інтернаціоналу вулиця
III Інтернаціоналу провулок	III Інтернаціоналу провулок
III Лиман вулиця	III Лиман вулиця
Kам'яниста вулиця	Камʼяниста вулиця
Kocмонавтів вулиця	Космонавтів вулиця
VI з’їзд Рад вулиця	вулиця VI зʼїзду Рад вулиця
VII З’їзду Рад вулиця	VII Зʼїзду Рад вулиця
VIII з’їзду Рад вулиця	VIII зʼїзду Рад вулиця
XIX Партз’їзду вулиця	XIX Партзʼїзду вулиця
XX Партз’їзду вулиця	XX Партзʼїзду вулиця
XX Партз’їзду провулок	XX Партзʼїзду провулок
XX-го Партз’їзду провулок	XX-го Партзʼїзду провулок
XXI З’їзду КПРС вулиця	XXI Зʼїзду КПРС вулиця
XXII з’їзду КПРС вулиця	XXII зʼїзду КПРС вулиця
XXII Партз’їзду вулиця	XXII Партзʼїзду вулиця
XXIII Партз'їзду вулиця	XXIII Партзʼїзду вулиця
XXIV з’їзду КПРС вулиця	XXIV зʼїзду КПРС вулиця
XXIV Партз’їзду вулиця	XXIV Партзʼїзду вулиця
XXV з'їзду КПРС вулиця	XXV зʼїзду КПРС вулиця
XXV партз’їзду вулиця	XXV партзʼїзду вулиця
XXVII Партз’їзду вулиця	XXVII Партзʼїзду вулиця