Авєріна вулиця	вулиця Авєріна
Азбукіна вулиця	вулиця Азбукіна
Азіна вулиця	вулиця Азіна
Академіка Бєлянкіна вулиця	вулиця Академіка Бєлянкіна
Академіка Весніна вулиця	вулиця Академіка Весніна
Академіка Вєркіна вулиця	вулиця Академіка Вєркіна
Академіка Крип’якевича вулиця	вулиця Академіка Крипʼякевича
Академіка Лисіна вулиця	вулиця Академіка Лисіна
Академіка Лисіна провулок	провулок Академіка Лисіна
Алгазіна вулиця	вулиця Алгазіна
Алехновича вулиця	вулиця Алехновича
Аношкіна проспект	проспект Аношкіна
Антіна Могильницького вулиця	вулиця Антіна Могильницького
Антіпіна вулиця	вулиця Антіпіна
Анюткіна вулиця	вулиця Анюткіна
Арзамакіна вулиця	вулиця Арзамакіна
Архиповича провулок	провулок Архиповича
Архітектора Нємкіна провулок	провулок Архітектора Нємкіна
Асташкіна вулиця	вулиця Асташкіна
Асташкіна провулок	провулок Асташкіна
Бабаріна вулиця	вулиця Бабаріна
Бабкевича вулиця	вулиця Бабкевича
Бадигіна вулиця	вулиця Бадигіна
Бадигіна провулок	провулок Бадигіна
Баєевича вулиця	вулиця Баєевича
Баклагіна вулиця	вулиця Баклагіна
Барболіна вулиця	вулиця Барболіна
Бардіна вулиця	вулиця Бардіна
Бахуріна вулиця	вулиця Бахуріна
Белавіна вулиця	вулиця Белавіна
Бенедиктовича вулиця	вулиця Бенедиктовича
Берзаріна вулиця	вулиця Берзаріна
Билкіна вулиця	вулиця Билкіна
Білівіна вулиця	вулиця Білівіна
Білютіна вулиця	вулиця Білютіна
Біна Суховільскої вулиця	вулиця Бічна Суховільська
Блажевича вулиця	вулиця Блажевича
Блюменталь-Тамаріна вулиця	вулиця Блюменталь-Тамаріна
Бобикевича вулиця	вулиця Бобикевича
Богушевича вулиця	вулиця Богушевича
Боролича вулиця	вулиця Боролича
Бороховича вулиця	вулиця Бороховича
Ботвіна вулиця	вулиця Ботвіна
Ботвіна вулицяё	вулиця Ботвіна
Бочковича вулиця	вулиця Бочковича
Бочковича провулок	провулок Бочковича
Бредихіна вулиця	вулиця Бредихіна
Брусиловича вулиця	вулиця Брусиловича
Брускіна вулиця	вулиця Брускіна
Буваліна провулок	провулок Буваліна
Будівнича вулиця	вулиця Будівнича
Будкевича вулиця	вулиця Будкевича
Буздаліна вулиця	вулиця Буздаліна
Буковича вулиця	вулиця Буковича
Буреніна вулиця	вулиця Буреніна
Бутиріна вулиця	вулиця Бутиріна
Буховича вулиця	вулиця Буховича
Буховича провулок	провулок Буховича
В’ячеслава Тютіна провулок	провулок Вʼячеслава Тютіна
Варанкіна провулок	провулок Варанкіна
Васяніна вулиця	вулиця Васяніна
Ватуніна вулиця	вулиця Ватуніна
Ватутiна вулиця	вулиця Ватутіна
Вашкевича вулиця	вулиця Вашкевича
Веденіна вулиця	вулиця Веденіна
Величковича вулиця	вулиця Величковича
Велігіна вулиця	вулиця Велігіна
Венгриновича вулиця	вулиця Венгриновича
Веригіна вулиця	вулиця Веригіна
Весніна вулиця	вулиця Весніна
Весніна провулок	провулок Весніна
Весніна узвіз	узвіз Весніна
Вєрещагіна вулиця	вулиця Вєрещагіна
Видавнича вулиця	вулиця Видавнича
Виробнича вулиця	вулиця Виробнича
Висовіна вулиця	вулиця Висовіна
Високовича вулиця	вулиця Високовича
Віхніна вулиця	вулиця Віхніна
Водолазкіна вулиця	вулиця Водолазкіна
Водолазкіна вулиця 	вулиця Водолазкіна 
Войцеховича вулиця	вулиця Войцеховича
Волосевича вулиця	вулиця Волосевича
Вороніхіна вулиця	вулиця Вороніхіна
Вороніхіна провулок	провулок Вороніхіна
Вострухіна вулиця	вулиця Вострухіна
Вукаловича вулиця	вулиця Вукаловича
Гавсевича вулиця	вулиця Гавсевича
Гагагіна вулиця	вулиця Гагаріна
гагаріна вулиця	вулиця Гагаріна
гАГАРІНА вулиця	вулиця Гагаріна
Гагарiна вулиця	вулиця Гагаріна
Газіна вулиця	вулиця Газіна
Галочкіна вулиця	вулиця Галочкіна
Галушкіна вулиця	вулиця Галушкіна
Гамазіна вулиця	вулиця Гамазіна
Гардіна вулиця	вулиця Гардіна
Гарфункіна вулиця	вулиця Гарфункіна
Гафановича вулиця	вулиця Гафановича
Генерала Гудовича вулиця	вулиця Генерала Гудовича
Генерала Ляскіна вулиця	вулиця Генерала Ляскіна
Генерала Пилькевича вулиця	вулиця Генерала Пилькевича
Генерала Пилькевича провулок	провулок Генерала Пилькевича
Генерала Швигіна вулиця	вулиця Генерала Швигіна
Генерала Шовколовича вулиця	вулиця Генерала Шовколовича
Генкіна вулиця	вулиця Генкіна
Гербича вулиця	вулиця Гербича
Гількевича вулиця	вулиця Гількевича
Гірнича вулиця	вулиця Гірнича
Глобіна провулок	провулок Глобіна
Гнєдича вулиця	вулиця Гнєдича
Гнєдича провулок	провулок Гнєдича
Голубіна вулиця	вулиця Голубіна
Городнича вулиця	вулиця Городнича
Гороновича вулиця	вулиця Гороновича
Гороновича провулок	провулок Гороновича
Горюшкіна вулиця	вулиця Горюшкіна
Горячкіна вулиця	вулиця Горячкіна
Горячкіна провулок	провулок Горячкіна
Гребьонкіна провулок	провулок Гребьонкіна
Гречихіна вулиця	вулиця Гречихіна
Гринішкіна вулиця	вулиця Гринішкіна
Гринкевича Полковника вулиця	вулиця Полковника Гринкевича
Гринкевича проспект	проспект Гринкевича
Гринцевича вулиця	вулиця Гринцевича
Грициніна вулиця	вулиця Грициніна
Грузевича провулок	провулок Грузевича
Губайдуліна вулиця	вулиця Губайдуліна
Гулькіна вулиця	вулиця Гулькіна
Дамʼянича вулиця	вулиця Дамʼянича
Даневича вулиця	вулиця Даневича
Данкевича вулиця	вулиця Данкевича
Дарвiна провулок	провулок Дарвіна
Дахновича вулиця	вулиця Дахновича
Демьохіна вулиця	вулиця Демьохіна
Дерябіна вулиця	вулиця Дерябіна
Дисевича вулиця	вулиця Дисевича
Дівича вулиця	вулиця Дівича
Дівовича вулиця	вулиця Дівовича
Доброславіна вулиця	вулиця Доброславіна
Довговича вулиця	вулиця Довговича
Дрогобича вулиця	вулиця Дрогобича
Дрьоміна вулиця	вулиця Дрьоміна
Дубиніна вулиця	вулиця Дубиніна
Дуднича вулиця	вулиця Дуднича
Душкіна вулиця	вулиця Душкіна
Дюміна вулиця	вулиця Дюміна
Дюмiна вулиця	вулиця Дюміна
Єгоровича вулиця	вулиця Єгоровича
Єлагіна вулиця	вулиця Єлагіна
Єлькіна вулиця	вулиця Єлькіна
Єрахіна вулиця	вулиця Єрахіна
Єсєніна вулиця	вулиця Єсєніна
Єсєніна провулок	провулок Єсєніна
Єчіна вулиця	вулиця Єчіна
Жатковича вулиця	вулиця Жатковича
Желяніна вулиця	вулиця Желяніна
Жигаріна вулиця	вулиця Жигаріна
Жилуновича вулиця	вулиця Жилуновича
Заварзіна вулиця	вулиця Заварзіна
Заваріхіна вулиця	вулиця Заваріхіна
Завенягіна вулиця	вулиця Завенягіна
Загаєвича вулиця	вулиця Загаєвича
Загоскіна вулиця	вулиця Загоскіна
Загоськіна вулиця	вулиця Загоськіна
Залізнича вулиця	вулиця Залізнича
Замарайкіна вулиця	вулиця Замарайкіна
Звягіна вулиця	вулиця Звягіна
Зигіна вулиця	вулиця Зигіна
Зигіна провулок	провулок Зигіна
Золіна вулиця	вулиця Золіна
Золіна провулок	провулок Золіна
Зубриліна вулиця	вулиця Зубриліна
Зубриліна провулок	провулок Зубриліна
Зубриліна проїзд	проїзд Зубриліна
Ілярія Бриковича вулиця	вулиця Ілярія Бриковича
Іоаникія Базиловича вулиця	вулиця Іоаникія Базиловича
Іоаникія Базиловича провулок	провулок Іоаникія Базиловича
Іоанікія Базиловича вулиця	вулиця Іоанікія Базиловича
Іови Кондзелевича вулиця	вулиця Іови Кондзелевича
Іоніна вулиця	вулиця Іоніна
Калабердіна вулиця	вулиця Калабердіна
Калiнiна вулиця	вулиця Калініна
Камозіна вулиця	вулиця Камозіна
Каржавіна вулиця	вулиця Каржавіна
Карнаухіна вулиця	вулиця Карнаухіна
Каспіровича вулиця	вулиця Каспіровича
Кассіна вулиця	вулиця Кассіна
Кашевича вулиця	вулиця Кашевича
Кедріна вулиця	вулиця Кедріна
Кирилкіна вулиця	вулиця Кирилкіна
Кібальчича вулиця	вулиця Кібальчича
Кілініна вулиця	вулиця Кілініна
Кіріна провулок	провулок Кіріна
Кірюхіна вулиця	вулиця Кірюхіна
Князькіна вулиця	вулиця Князькіна
Ковшевича вулиця	вулиця Ковшевича
Кожем’якіна вулиця	вулиця Кожемʼякіна
Кокоріна вулиця	вулиця Кокоріна
Кокотіна вулиця	вулиця Кокотіна
Кокушкіна вулиця	вулиця Кокушкіна
Колодіна вулиця	вулиця Колодіна
Кольчугіна вулиця	вулиця Кольчугіна
Командира Юніна вулиця	вулиця Командира Юніна
Кондзелевича вулиця	вулиця Кондзелевича
Кондрашкіна вулиця	вулиця Кондрашкіна
Конкіна вулиця	вулиця Конкіна
Константиновича вулиця	вулиця Константиновича
Конякіна вулиця	вулиця Конякіна
Копенкіна вулиця	вулиця Копенкіна
Копьонкіна вулиця	вулиця Копьонкіна
Короткевича вулиця	вулиця Короткевича
Коршуновича вулиця	вулиця Коршуновича
Корятовича вулиця	вулиця Корятовича
Корятовича площа	площа Корятовича
Корятовича провулок	провулок Корятовича
Костроміна вулиця	вулиця Костроміна
Костюріна вулиця	вулиця Костюріна
Котіна вулиця	вулиця Котіна
Кочагіна провулок	провулок Кочагіна
Кочебіна вулиця	вулиця Кочебіна
Крамнича вулиця	вулиця Крамнича
Красноперича вулиця	вулиця Красноперича
Красiна вулиця	вулиця Красіна
Кременіна вулиця	вулиця Кременіна
Кривошеіна вулиця	вулиця Кривошеіна
Крип’якевича вулиця	вулиця Крипʼякевича
Крючонкіна вулиця	вулиця Крючонкіна
Крючонкіна провулок	провулок Крючонкіна
Крючонкіна проїзд	проїзд Крючонкіна
Кубишкіна вулиця	вулиця Кубишкіна
Кулибіна вулиця	вулиця Кулибіна
Курловича вулиця	вулиця Курловича
Кутліна вулиця	вулиця Кутліна
Лабаторіна вулиця	вулиця Лабаторіна
Лавочкіна вулиця	вулиця Лавочкіна
Лазутіна вулиця	вулиця Лазутіна
Латіна провулок	провулок Латіна
Леженіна вулиця	вулиця Леженіна
Леженіна провулок	провулок Леженіна
Ленiна вулиця	вулиця Леніна
Лікаря Тарашкевича вулиця	вулиця Лікаря Тарашкевича
Ліпіна вулиця	вулиця Ліпіна
Ліснича вулиця	вулиця Ліснича
Лозановича вулиця	вулиця Лозановича
Лохтіна вулиця	вулиця Лохтіна
Лук’яновича вулиця	вулиця Лукʼяновича
Лутігіна вулиця	вулиця Лутігіна
Лутугіна вулиця	вулиця Лутугіна
Любавіна вулиця	вулиця Любавіна
Любовича вулиця	вулиця Любовича
Ляскіна вулиця	вулиця Ляскіна
Мазіна вулиця	вулиця Мазіна
Максиміхіна вулиця	вулиця Максиміхіна
Макушкіна вулиця	вулиця Макушкіна
Малашевича вулиця	вулиця Малашевича
Малигіна вулиця	вулиця Малигіна
Малишкіна вулиця	вулиця Малишкіна
Мальовнича вулиця	вулиця Мальовнича
Маневича провулок	провулок Маневича
Мануліна вулиця	вулиця Мануліна
Манькевича вулиця	вулиця Манькевича
Марченича вулиця	вулиця Марченича
Маршала Пересипкіна вулиця	вулиця Маршала Пересипкіна
Матьокіна вулиця	вулиця Матьокіна
Машкевича вулиця	вулиця Машкевича
Межевича вулиця	вулиця Межевича
Мелешкіна вулиця	вулиця Мелешкіна
Мисіна вулиця	вулиця Мисіна
Мисiна вулиця	вулиця Мисіна
Митькіна вулиця	вулиця Митькіна
Мілегіна вулиця	вулиця Мілегіна
Місевича вулиця	вулиця Місевича
Мішечкіна вулиця	вулиця Мішечкіна
Молокіна вулиця	вулиця Молокіна
Моріна вулиця	вулиця Моріна
Москвітіна вулиця	вулиця Москвітіна
Мякотіна вулиця	вулиця Мякотіна
Мялкіна вулиця	вулиця Мялкіна
Мiчурiна вулиця	вулиця Мічуріна
Надеждіна вулиця	вулиця Надеждіна
Надьожкіна вулиця	вулиця Надьожкіна
Найдіна вулиця	вулиця Найдіна
Намьоткіна вулиця	вулиця Намьоткіна
Насвітевича вулиця	вулиця Насвітевича
Недєліна вулиця	вулиця Недєліна
Недєліна Маршала вулиця	вулиця Недєліна Маршала
Недосєкіна вулиця	вулиця Недосєкіна
Неманихіна вулиця	вулиця Неманихіна
Неретіна вулиця	вулиця Неретіна
Неретіна провулок	провулок Неретіна
Нероновича вулиця	вулиця Нероновича
Неушкіна вулиця	вулиця Неушкіна
Нємкіна вулиця	вулиця Нємкіна
Нікініна провулок	провулок Нікініна
Новобудівнича вулиця	вулиця Новобудівнича
Ногіна вулиця	вулиця Ногіна
Ногіна провулок	провулок Ногіна
Носіна провулок	провулок Носіна
Оксенича вулиця	вулиця Оксенича
Оленіна вулиця	вулиця Оленіна
Опаріна провулок	провулок Опаріна
Ополонича вулиця	вулиця Ополонича
Остріяніна вулиця	вулиця Остріяніна
Оськіна вулиця	вулиця Оськіна
Осьмухіна вулиця	вулиця Осьмухіна
Осьмьоркіна вулиця	вулиця Осьмьоркіна
Отамана Мордалевича вулиця	вулиця Отамана Мордалевича
Охотнича вулиця	вулиця Охотнича
П’ятьоркіна вулиця	вулиця Пʼятьоркіна
Павлусевича вулиця	вулиця Павлусевича
Папаніна вулиця	вулиця Папаніна
Папаніна провулок	провулок Папаніна
Пересипкіна вулиця	вулиця Пересипкіна
Петліна вулиця	вулиця Петліна
Петруковича вулиця	вулиця Петруковича
Петькіна вулиця	вулиця Петькіна
Пишкіна вулиця	вулиця Пишкіна
Підгіна вулиця	вулиця Підгіна
Піддівича вулиця	вулиця Піддівича
Пілягіна вулиця	вулиця Пілягіна
Пічугіна вулиця	вулиця Пічугіна
Платухіна вулиця	вулиця Платухіна
Поворіна вулиця	вулиця Поворіна
Поворіна провулок	провулок Поворіна
Поднєвича вулиця	вулиця Поднєвича
Полбіна вулиця	вулиця Полбіна
Полбіна провулок	провулок Полбіна
Полідовича вулиця	вулиця Полідовича
Поліна вулиця	вулиця Поліна
Полосухіна вулиця	вулиця Полосухіна
Полосухіна провулок	провулок Полосухіна
Полухіна вулиця	вулиця Полухіна
Понєдєліна вулиця	вулиця Понєдєліна
Поповкіна вулиця	вулиця Поповкіна
Поручника Кедюлича вулиця	вулиця Поручника Кедюлича
Потаніна вулиця	вулиця Потаніна
Потехіна вулиця	вулиця Потехіна
Похилевича вулиця	вулиця Похилевича
Пришвіна вулиця	вулиця Пришвіна
Прішвіна вулиця	вулиця Прішвіна
Професора Зиблікевича вулиця	вулиця Професора Зиблікевича
Професора Скідіна вулиця	вулиця Професора Скідіна
Птахіна вулиця	вулиця Птахіна
Птухіна вулиця	вулиця Птухіна
Пудовкіна вулиця	вулиця Пудовкіна
Пуріна вулиця	вулиця Пуріна
Путіліна вулиця	вулиця Путіліна
Пухтаєвича вул.	вулиця Пухтаєвича
Пушкiна вулиця	вулиця Пушкіна
Пушкiна провулок	провулок Пушкіна
Ракітіна вулиця	вулиця Ракітіна
Ракітіна провулок	провулок Ракітіна
Рахівнича вулиця	вулиця Рахівнича
Рахматуліна вулиця	вулиця Рахматуліна
Ревіна провулок	провулок Ревіна
Ревякіна вулиця	вулиця Ревякіна
Реміснича вулиця	вулиця Реміснича
Репіна вулиця	вулиця Репіна
Репіна провулок	провулок Репіна
Репiна вулиця	вулиця Репіна
Рецкевича вулиця	вулиця Рецкевича
Рєдіна вулиця	вулиця Рєдіна
Рєпкіна вулиця	вулиця Рєпкіна
Ринчича Базара вулиця	вулиця Ринчича Базара
Рільнича вулиця	вулиця Рільнича
Робітнича вулиця	вулиця Робітнича
Робітнича Вулиця	Вулиця Робітнича
Робітнича зупинка вулиця	вулиця Робітнича Зупинка
Ровдича вулиця	вулиця Ровдича
Ромашкіна вулиця	вулиця Ромашкіна
Рукіна вулиця	вулиця Рукіна
Русановича вулиця	вулиця Русановича
Русановича провулок	провулок Русановича
Рутковича вулиця	вулиця Рутковича
Рюміна вулиця	вулиця Рюміна
Рябіна вулиця	вулиця Рябіна
Рябушкіна вулиця	вулиця Рябушкіна
Сабліна вулиця	вулиця Сабліна
Савкіна вулиця	вулиця Савкіна
Садівнича вулиця	вулиця Садівнича
Сайкіна вулиця	вулиця Сайкіна
Салманіна вулиця	вулиця Салманіна
Самишкіна провулок	провулок Самишкіна
Самусевича вулиця	вулиця Самусевича
Сапегіна вулиця	вулиця Сапегіна
Сапєгіна вулиця	вулиця Сапєгіна
Сапіна вулиця	вулиця Сапіна
Саполовича вулиця	вулиця Саполовича
Сахаліна вулиця	вулиця Сахаліна
Свірьопкіна вулиця	вулиця Свірьопкіна
Севергіна вулиця	вулиця Севергіна
Сейфуліна вулиця	вулиця Сейфуліна
Селявкіна вулиця	вулиця Селявкіна
Серафімовича вулиця	вулиця Серафімовича
Серафімовича провулок	провулок Серафімовича
Серебрича вулиця	вулиця Серебрича
Сєрафімовича вулиця	вулиця Сєрафімовича
Сєрьогіна вулиця	вулиця Сєрьогіна
Сєчкіна вулиця	вулиця Сєчкіна
Сивухіна вулиця	вулиця Сивухіна
Синявіна вулиця	вулиця Синявіна
Сисолятіна вулиця	вулиця Сисолятіна
Сікіріна вулиця	вулиця Сікіріна
Славутича вулиця	вулиця Славутича
Слатіна вулиця	вулиця Слатіна
Смекалкіна вулиця	вулиця Смекалкіна
Смирнихіна провулок	провулок Смирнихіна
Смоліна вулиця	вулиця Смоліна
Солодухіна вулиця	вулиця Солодухіна
Сопіна вулиця	вулиця Сопіна
Сопіна провулок	провулок Сопіна
Станкіна вулиця	вулиця Станкіна
Станюкєвича вулиця	вулиця Станюкєвича
Стеніна вулиця	вулиця Стеніна
Струпіна провулок	провулок Струпіна
Стубелевича вулиця	вулиця Стубелевича
Ступіна вулиця	вулиця Ступіна
Сушкіна вулиця	вулиця Сушкіна
Талалихіна вулиця	вулиця Талалихіна
Талаліхіна вулиця	вулиця Талаліхіна
Талаліхіна провулок	провулок Талаліхіна
Тараскіна вулиця	вулиця Тараскіна
Тарутіна вулиця	вулиця Тарутіна
Тєрьошкіна вулиця	вулиця Тєрьошкіна
Тиріна вулиця	вулиця Тиріна
Тирса Венгриновича вулиця	вулиця Тирса Венгриновича
Толбухiна вулиця	вулиця Толбухіна
Томіліна вулиця	вулиця Томіліна
Третякевича вулиця	вулиця Третякевича
Трудівнича вулиця	вулиця Трудівнича
Трункіна вулиця	вулиця Трункіна
Трушкевича вулиця	вулиця Трушкевича
Туркенича вулиця	вулиця Туркенича
Туркенича провулок	провулок Туркенича
Турутіна вулиця	вулиця Турутіна
Тьоміна вулиця	вулиця Тьоміна
Тюленіна вулиця	вулиця Тюленіна
Тюленіна провулок	провулок Тюленіна
Тюлєніна вулиця	вулиця Тюлєніна
Тюлєніна провулок	провулок Тюлєніна
Тюркіна вулиця	вулиця Тюркіна
Убаревича вулиця	вулиця Убаревича
Увлаховича вулиця	вулиця Увлаховича
Устияновича вулиця	вулиця Устияновича
Утіна вулиця	вулиця Утіна
Уткiна вулиця	вулиця Уткіна
Утiна вулиця	вулиця Утіна
Федковича вулиця	вулиця Федковича
Фісановича вулиця	вулиця Фісановича
Фісановича провулок	провулок Фісановича
Хадотовича вулиця	вулиця Хадотовича
Хатаєвича вулиця	вулиця Хатаєвича
Хворостіна вулиця	вулиця Хворостіна
Хітріна Архітектора вулиця	вулиця Архітектора Хітріна
Хлопіна вулиця	вулиця Хлопіна
Хлюпіна вулиця	вулиця Хлюпіна
Ходневича вулиця	вулиця Ходневича
Цибулькіна вулиця	вулиця Цибулькіна
Чагіна вулиця	вулиця Чагіна
Чегоріна вулиця	вулиця Чегоріна
Чекаліна вулиця	вулиця Чекаліна
Челюскіна в’їзд	вʼїзд Челюскіна
Челюскіна вулиця	вулиця Челюскіна
Челюскіна провулок	провулок Челюскіна
Чепчуріна вулиця	вулиця Чепчуріна
Черепіна вулиця	вулиця Черепіна
Черепніна проспект	проспект Черепніна
Чернавіна вулиця	вулиця Чернавіна
Чернишевича вулиця	вулиця Чернишевича
Черьомушкіна вулиця	вулиця Черьомушкіна
Чечоріна вулиця	вулиця Чечоріна
Чиркіна вулиця	вулиця Чиркіна
Чича вулиця	вулиця Чича
Чукаріна вулиця	вулиця Чукаріна
Шавріна вулиця	вулиця Шавріна
Шапоріна вулиця	вулиця Шапоріна
Шарохіна вулиця	вулиця Шарохіна
Шашуріна вулиця	вулиця Шашуріна
Шепаровича вулиця	вулиця Шепаровича
Шершавіна вулиця	вулиця Шершавіна
Шестерніна вулиця	вулиця Шестерніна
Шешкевича вулиця	вулиця Шешкевича
Широніна вулиця	вулиця Широніна
Шкапіна вулиця	вулиця Шкапіна
Шкапіна провулок	провулок Шкапіна
Шкуріна вулиця	вулиця Шкуріна
Шляховича вулиця	вулиця Шляховича
Шолбіна вулиця	вулиця Шолбіна
Шоніна вулиця	вулиця Шоніна
Шопіна вулиця	вулиця Шопіна
Шоріна вулиця	вулиця Шоріна
Шоріна провулок	провулок Шоріна
Шпагіна вулиця	вулиця Шпагіна
Штепіна вулиця	вулиця Штепіна
Шукліна вулиця	вулиця Шукліна
Шукліна провулок	провулок Шукліна
Шулейкіна вулиця	вулиця Шулейкіна
Щепкiна вулиця	вулиця Щепкіна
Щепоткіна вулиця	вулиця Щепоткіна
Щетиніна вулиця	вулиця Щетиніна
Щєпкіна вулиця	вулиця Щєпкіна
Щучкіна вулиця	вулиця Щучкіна
Юбкіна вулиця	вулиця Юбкіна
Юркіна вулиця	вулиця Юркіна
Юхневича вулиця	вулиця Юхневича
Яблочкіна вулиця	вулиця Яблочкіна
Яблочкіна провулок	провулок Яблочкіна
Яківа Миколаєвича вулиця	вулиця Яківа Миколаєвича
Яневича вулиця	вулиця Яневича
Яра Славутича вулиця	вулиця Яра Славутича
Яхимовича вулиця	вулиця Яхимовича
Cушкевича вулиця	вулиця Сушкевича