Абдалієва вулиця	вулиця Абдалієва
Авальяні вулиця	вулиця Авальяні
Августо Донніні вулиця	вулиця Августо Донніні
Авіамістечко вулиця	вулиця Авіамістечко
Авіаторів вулиця	вулиця Авіаторів
Авіації вулиця	вулиця Авіації
Автобуду вулиця	вулиця Автобуду
Автолюбителів вулиця	вулиця Автолюбителів
Агабек-Заде вулиця	вулиця Агабек-Заде
Агап’єва вулиця	вулиця Агапʼєва
Агнії Барто вулиця	вулиця Агнії Барто
Агнона вулиця	вулиця Агнона
Аграрана вулиця	Аграрна вулиця
Агромістечко вулиця	вулиця Агромістечко
Адермаха вулиця	вулиця Адермаха
Адмірала Завойка вулиця	вулиця Адмірала Завойка
Адмірала Траверсе вулиця	вулиця Адмірала Траверсе
Адягош вулиця	вулиця Адягош
Аеродром вулиця	вулиця Аеродром
Аеронавтів вулиця	вулиця Аеронавтів
Аерофлоту вулиця	вулиця Аерофлоту
Азєва вулиця	вулиця Азєва
Азовсталі вулиця	вулиця Азовсталі
Аіровое вулиця	вулиця Аіровое
Акац вулиця	вулиця Акац
Акацієва вулиця	вулиця Акацієва
Акації вулиця	вулиця Акації
Акацій вулиця	вулиця Акацій
Акацфа вулиця	вулиця Акацфа
Акіма вулиця	вулиця Акіма
Аккерман вулиця	вулиця Аккерман
Аксьонкіної вулиця	вулиця Аксьонкіної
Алвег вулиця	вулиця Алвег
Алеєва вулиця	вулиця Алеєва
Алеї вулиця	вулиця Алеї
Алея вулиця	вулиця Алея
Алея Миру вулиця	вулиця Алея Миру
Алєєксєєва вулиця	вулиця Алєєксєєва
Алих роз вулиця	вулиця Алих роз
Алімпія Галика вулиця	вулиця Алімпія Галика
Алфатар вулиця	вулиця Алфатар
Алчевських вулиця	вулиця Алчевських
Алшо Мікефалва вулиця	вулиця Алшо Мікефалва
Алшокерт вулиця	вулиця Алшокерт
Алюмінієва вулиця	вулиця Алюмінієва
Аляб’єва вулиця	вулиця Алябʼєва
Америка вулиця	вулиця Америка
Ананьїна вулиця	вулиця Ананьїна
Ангеліної вулиця	вулиця Ангеліної
Андруса вулиця	вулиця Андруса
Андрущишиних вулиця	вулиця Андрущишиних
Анжея Хцюка вулиця	вулиця Анжея Хцюка
Анруд вулиця	вулиця Анруд
Антонінка вулиця	вулиця Антонінка
Антоніо-Бланко вулиця	вулиця Антоніо-Бланко
Апша вулиця	вулиця Апша
Арвата вулиця	вулиця Арвата
Аргунових вулиця	вулиця Аргунових
Ардов вулиця	вулиця Ардов
Ареф’єва вулиця	вулиця Арефʼєва
Армії вулиця	вулиця Армії
Армії УНР вулиця	вулиця Армії УНР
Аросєва вулиця	вулиця Аросєва
Артозєєва вулиця	вулиця Артозєєва
Архитектора Кобелєва вулиця	вулиця Архитектора Кобелєва
Архітектора Бургіньйона вулиця	вулиця Архітектора Бургіньйона
Архітектора Дольніка вулиця	вулиця Архітектора Дольніка
Архітектора Кобелєва вулиця	вулиця Архітектора Кобелєва
Архітекторів вулиця	вулиця Архітекторів
Асало вулиця	вулиця Асало
Асаулюка вулиця	вулиця Асаулюка
Асаф’єва вулиця	вулиця Асафʼєва
Асталоша вулиця	вулиця Асталоша
Атерлея вулиця	вулиця Атерлея
Аттіло вулиця	вулиця Аттіло
Ахієзерів вулиця	вулиця Ахієзерів
Ахромєєва вулиця	вулиця Ахромєєва
Б'єжика вулиця	вулиця Бʼєжика
Баблідзе вулиця	вулиця Баблідзе
Баботка вулиця	вулиця Баботка
Бавикі вулиця	вулиця Бавикі
Багата вулиця	Багата вулиця
Баглія вулиця	вулиця Баглія
Бадаєва вулиця	вулиця Бадаєва
База вулиця	вулиця База
Базанової вулиця	вулиця Базанової
Базарная вулиця	Базарная вулиця
Базилєєва вулиця	вулиця Базилєєва
Базів Кут вулиця	вулиця Базів Кут
Баївка вулиця	вулиця Баївка
Байка вулиця	вулиця Байка
Байрам вулиця	вулиця Байрам
Бакинских комиссаров вулиця	вулиця Бакинських Комісарів
Бакинських Комісарів вулиця	вулиця Бакинських Комісарів
Бакінських Комісарів вулиця	вулиця Бакинських Комісарів
Бакоцино вулиця	вулиця Бакоцино
Бакшеєва вулиця	вулиця Бакшеєва
Балаєва вулиця	вулиця Балаєва
БАМ вулиця	вулиця БАМ
Бані вулиця	вулиця Бані
Барабася вулиця	вулиця Барабася
Барабаш вулиця	вулиця Барабаш
Барабашів вулиця	вулиця Барабашів
Барахтія вулиця	вулиця Барахтія
Барвиста вулиця	Барвиста вулиця
Барвіновка вулиця	вулиця Барвіновка
Барвінських вулиця	вулиця Барвінських
Баржака вулиця	вулиця Баржака
Барила вулиця	вулиця Барила
Бариш вулиця	вулиця Бариш
Барляєва вулиця	вулиця Барляєва
Батарея вулиця	вулиця Батарея
Батаршина вулиця	вулиця Батаршина
Батиря вулиця	вулиця Батиря
Батіг вулиця	вулиця Батіг
Батракової вулиця	вулиця Батракової
Батурко вулиця	вулиця Батурко
Батька вулиця	вулиця Батька
Батьківщина вулиця	вулиця Батьківщина
Бахірєва вулиця	вулиця Бахірєва
Бахметьєва вулиця	вулиця Бахметьєва
Бахрушина вулиця	вулиця Бахрушина
Бачинських вулиця	вулиця Бачинських
Башта вулиця	вулиця Башта
Баюка вулиця	вулиця Баюка
Бежика вулиця	вулиця Бежика
Безводня вулиця	Безводня вулиця
Безкаравайної вулиця	вулиця Безкаравайної
Безкрайня вулиця	Безкрайня вулиця
Безпалько вулиця	вулиця Безпалько
Безрадецької вулиця	вулиця Безрадецької
Безрук вулиця	вулиця Безрук
Бейкешчобо вулиця	вулиця Бейкешчобо
Бейли Іллейша вулиця	вулиця Бейли Іллейша
Беке вулиця	вулиця Беке
Бельмаж вулиця	вулиця Бельмаж
Бенделіані вулиця	вулиця Бенделіані
Бендяка вулиця	вулиця Бендяка
Берві вулиця	вулиця Берві
Бердо вулиця	вулиця Бердо
Берег вулиця	вулиця Берег
Берегдаровці вулиця	вулиця Берегдаровці
Берегівщина вулиця	вулиця Берегівщина
Береговщиина вулиця	вулиця Береговщиина
Береґовець вулиця	вулиця Береґовець
Бережанка вулиця	вулиця Бережанка
Бережок вулиця	вулиця Бережок
Березена вулиця	вулиця Березена
Березнегувата вулиця	вулиця Березнегувата
Березня вулиця	вулиця Березня
Березняк вулиця	вулиця Березняк
Березовка вулиця	вулиця Березовка
Берзіня вулиця	вулиця Берзіня
Беркоса вулиця	вулиця Беркоса
Берута вулиця	вулиця Берута
Берчені вулиця	вулиця Берчені
Берiнга вулиця	вулиця Берінга
Бесарабія вулиця	вулиця Бесарабія
Бєгоулєва вулиця	вулиця Бєгоулєва
Бистрячок вулиця	вулиця Бистрячок
Біблика вулиця	вулиця Біблика
Бігуча вулиця	Бігуча вулиця
Бізе вулиця	вулиця Бізе
Білгород вулиця	вулиця Білгород
Біле Джерело вулиця	вулиця Біле Джерело
Білика вулиця	вулиця Білика
Білих Акацій вулиця	вулиця Білих Акацій
Білокур вулиця	вулиця Білокур
Білосток вулиця	вулиця Білосток
Білостоцьких вулиця	вулиця Білостоцьких
Білчина вулиця	Білчина вулиця
Більче-Волиця вулиця	вулиця Більче-Волиця
Біляївка вулиця	вулиця Біляївка
Бірок вулиця	вулиця Бірок
Благовіщення вулиця	вулиця Благовіщення
Благодиря вулиця	вулиця Благодиря
Благоєва вулиця	вулиця Благоєва
Блажевич вулиця	вулиця Блажевич
Бланка вулиця	вулиця Бланка
Блашкуна вулиця	вулиця Блашкуна
Бобрових вулиця	вулиця Бобрових
Богата вулиця	Богата вулиця
Богойка вулиця	вулиця Богойка
Богомольца вулиця	вулиця Богомольца
Богунія вулиця	вулиця Богунія
Богуславка вулиця	вулиця Богуславка
Бодинька вулиця	вулиця Бодинька
Бодянських вулиця	вулиця Бодянських
Божків Яр вулиця	вулиця Божків Яр
Бойківчанка вулиця	вулиця Бойківчанка
Бойко вулиця	вулиця Бойко
Бойчак вулиця	вулиця Бойчак
Бокія вулиця	вулиця Бокія
Бокорашилор вулиця	вулиця Бокорашилор
Болгарка вулиця	вулиця Болгарка
Болденюка вулиця	вулиця Болденюка
Болдусєва вулиця	вулиця Болдусєва
Болоня вулиця	вулиця Болоня
Болота вулиця	вулиця Болота
Болотиста вулиця	Болотиста вулиця
Большак вулиця	вулиця Большак
Болярка вулиця	вулиця Болярка
Болятка вулиця	вулиця Болятка
Борисівька вулиця	вулиця Борисівька
Борисових вулиця	вулиця Борисових
Бориспольця вулиця	вулиця Бориспольця
Бористеня вулиця	вулиця Бористеня
Борисяка вулиця	вулиця Борисяка
Боричів Тік вулиця	вулиця Боричів Тік
Боркан вулиця	вулиця Боркан
Борканюка вулиця	вулиця Борканюка
Боровиця вулиця	вулиця Боровиця
Бородіно вулиця	вулиця Бородіно
Борсоєва вулиця	вулиця Борсоєва
Борчі вулиця	вулиця Борчі
Бособрода вулиця	вулиця Бособрода
Боярських Майстрів вулиця	вулиця Боярських Майстрів
Бразильця вулиця	вулиця Бразильця
Браїка вулиця	вулиця Браїка
Бранця вулиця	вулиця Бранця
Братеничі вулиця	вулиця Братеничі
Братерства вулиця	вулиця Братерства
Братив Сугаків вулиця	вулиця Братив Сугаків
Братня вулиця	Братня вулиця
Брачуна вулиця	вулиця Брачуна
Бридька вулиця	вулиця Бридька
Брикеля вулиця	вулиця Брикеля
Брилів Шлях вулиця	вулиця Брилів Шлях
Бринька вулиця	вулиця Бринька
Брів-ла-Гайард вулиця	вулиця Брів-ла-Гайард
Брідок вулиця	вулиця Брідок
Бровещина вулиця	вулиця Бровещина
Бродок вулиця	вулиця Бродок
Бродських вулиця	вулиця Бродських
Броненосця «Потьомкін» вулиця	вулиця Броненосця «Потьомкін»
Броненосця Потьомкін вулиця	вулиця Броненосця «Потьомкін»
Бронзоса вулиця	вулиця Бронзоса
Бруно вулиця	вулиця Бруно
Брюховця вулиця	вулиця Брюховця
Бугаївка вулиця	вулиця Бугаївка
Бугриста вулиця	Бугриста вулиця
Буда вулиця	вулиця Буда
Будаєва вулиця	вулиця Будаєва
Будая вулиця	вулиця Будая
Будинки МПС вулиця	вулиця Будинки МПС
Будинку Відпочинку вулиця	вулиця Будинку Відпочинку
Будинок Відпочинку вулиця	вулиця Будинок Відпочинку
Будителів вулиця	вулиця Будителів
Будівельниа вулиця	вулиця Будівельниа
Будівельникі вулиця	вулиця Будівельників
Будівника вулиця	вулиця Будівника
Будіндустрії вулиця	вулиця Будіндустрії
Будникової вулиця	вулиця Будникової
Будьогоно вулиця	вулиця Будьогоно
Будьоннівських Партизан вулиця	вулиця Будьоннівських Партизан
Бузника вулиця	вулиця Бузника
Букаєва вулиця	вулиця Букаєва
Буковина вулиця	вулиця Буковина
Буковинка вулиця	вулиця Буковинка
Буковиця вулиця	вулиця Буковиця
Булгаркерт вулиця	вулиця Булгаркерт
Бульвар Миру вулиця	вулиця Бульвар Миру
Бураковка вулиця	вулиця Бураковка
Бурачека вулиця	вулиця Бурачека
Бурга вулиця	вулиця Бурга
Буревісника вулиця	вулиця Буревісника
Бурзі вулиця	вулиця Бурзі
Бурих вулиця	вулиця Бурих
Буркут вулиця	вулиця Буркут
Буркута вулиця	вулиця Буркута
Бурякопункт вулиця	вулиця Бурякопункт
Буханець вулиця	вулиця Буханець
Буча вулиця	вулиця Буча
Бучацькі Гаї вулиця	вулиця Бучацькі Гаї
Бучиха вулиця	вулиця Бучиха
Буштрук вулиця	вулиця Буштрук
В’ячеслава Малі вулиця	вулиця Вʼячеслава Малі
В’ячеслава Чонровола вулиця	вулиця Вʼячеслава Чонровола
Вабля вулиця	вулиця Вабля
Вавилових вулиця	вулиця Вавилових
Вавілових вулиця	вулиця Вавілових
Вагина вулиця	вулиця Вагина
Вагона вулиця	вулиця Вагона
Вадас вулиця	вулиця Вадас
Вайгеля вулиця	вулиця Вайгеля
Вайнагія вулиця	вулиця Вайнагія
Вайнерів вулиця	вулиця Вайнерів
Вайсера вулиця	вулиця Вайсера
Вакарів вулиця	вулиця Вакарів
Валько вулиця	вулиця Валько
Вальсроде вулиця	вулиця Вальсроде
Валявка вулиця	вулиця Валявка
Ванагса вулиця	вулиця Ванагса
Ванцетті вулиця	вулиця Ванцетті
Варейкіса вулиця	вулиця Варейкіса
Варена вулиця	вулиця Варена
Варзара вулиця	вулиця Варзара
Вароді вулиця	вулиця Вароді
Вародія вулиця	вулиця Вародія
Вартових Неба вулиця	вулиця Вартових Неба
Варуш вулиця	вулиця Варуш
Василенкове Поле вулиця	вулиця Василенкове Поле
Васильєвих вулиця	вулиця Васильєвих
Васильєвка вулиця	вулиця Васильєвка
Васкула вулиця	вулиця Васкула
Васляєва вулиця	вулиця Васляєва
Васюніних вулиця	вулиця Васюніних
Ватоліної вулиця	вулиця Ватоліної
Вахрамеєва вулиця	вулиця Вахрамеєва
Вацетіса вулиця	вулиця Вацетіса
Вашартер вулиця	вулиця Вашартер
Вашут вулиця	вулиця Вашут
Веденєєва вулиця	вулиця Веденєєва
Ведмежий вулиця	вулиця Ведмежий
Веленце вулиця	вулиця Веленце
Велетень вулиця	вулиця Велетень
Велика Безкупчина вулиця	Велика Безкупчина вулиця
Велика вулиця	Велика вулиця
Велика Гольма вулиця	вулиця Велика Гольма
Велика Гряда вулиця	вулиця Велика Гряда
Велика Лубянка вулиця	вулиця Велика Лубянка
Велика Лунка вулиця	вулиця Велика Лунка
Велика Нараївка вулиця	вулиця Велика Нараївка
Велика Слобідка вулиця	вулиця Велика Слобідка
Велика Царинка вулиця	вулиця Велика Царинка
Велике Передмістя вулиця	вулиця Велике Передмістя
Великодня вулиця	вулиця Великодня
Величкіної вулиця	вулиця Величкіної
Величко вулиця	вулиця Величко
Венгерщина вулиця	вулиця Венгерщина
Веприк вулиця	вулиця Веприк
Вербанця вулиця	вулиця Вербанця
Вербник вулиця	вулиця Вербник
Вербоноля вулиця	вулиця Вербоноля
Верді вулиця	вулиця Верді
Веремієвої вулиця	вулиця Веремієвої
Верені вулиця	вулиця Верені
Веретка вулиця	вулиця Веретка
Верешморті вулиця	вулиця Верешморті
Верке вулиця	вулиця Верке
Веркепорт вулиця	вулиця Веркепорт
Верлана вулиця	вулиця Верлана
Вероне вулиця	вулиця Вероне
Верхні Кіреші вулиця	вулиця Верхні Кіреші
Верхній блок вулиця	вулиця Верхній Блок
Верхній вал вулиця	вулиця Верхній Вал
Верхній Вал вулиця	вулиця Верхній Вал
Верхній Зворець вулиця	вулиця Верхній Зворець
Верхній Кінець вулиця	вулиця Верхній Кінець
Верхній Підгай вулиця	вулиця Верхній Підгай
Верхня вулиця	Верхня вулиця
Верхня Гребля вулиця	вулиця Верхня Гребля
Верхня Слобідка вулиця	вулиця Верхня Слобідка
Верхня Чабанка вулиця	вулиця Верхня Чабанка
Верховина вулиця	вулиця Верховина
Весела вулиця	Весела вулиця
Весела Дача вулиця	вулиця Весела Дача
Веселка вулиця	вулиця Веселка
Весилий Хутір вулиця	вулиця Веселий Хутір
Весіння вулиця	Весіння вулиця
Весіча вулиця	вулиця Весіча
Веснянка вулиця	вулиця Веснянка
Вечірня вулиця	Вечірня вулиця
Взуттєва вулиця	Взуттєва вулиця
Вибрика вулиця	вулиця Вибрика
Вигін вулиця	вулиця Вигін
Вигнанка вулиця	вулиця Вигнанка
Вигода вулиця	вулиця Вигода
Вигон вулиця	вулиця Вигон
Вигуляра вулиця	вулиця Вигуляра
Видригана вулиця	вулиця Видригана
Видумка вулиця	вулиця Видумка
Вижула вулиця	вулиця Вижула
Визволення вулиця	вулиця Визволення
Визволення Донбасу вулиця	вулиця Визволення Донбасу
Визволителів вулиця	вулиця Визволителів
Викладачів вулиця	вулиця Викладачів
Викреста вулиця	вулиця Викреста
Виксюка вулиця	вулиця Виксюка
Винниця вулиця	вулиця Винниця
Виноробів вулиця	вулиця Виноробів
Випробувачів вулиця	вулиця Випробувачів
Вираг вулиця	вулиця Вираг
Висаджена вулиця	Висаджена вулиця
Виселок вулиця	вулиця Виселок
Висока вулиця	вулиця Висока
Височанка вулиця	вулиця Височанка
Вись вулиця	вулиця Вись
Вихорєва вулиця	вулиця Вихорєва
Вишивана вулиця	вулиця Вишивана
Вишиванка вулиця	вулиця Вишиванка
Вишневецьких вулиця	вулиця Вишневецьких
Вишня вулиця	вулиця Вишня
Вівальді вулиця	вулиця Вівальді
Відважних вулиця	вулиця Відважних
Віддалена вулиця	Віддалена вулиця
Відкрита вулиця	Відкрита вулиця
Відоняка вулиця	вулиця Відоняка
Відпочинку вулиця	вулиця Відпочинку
Відродження вулиця	вулиця Відродження
Віжень вулиця	вулиця Віжень
Військбуд вулиця	вулиця Військбуд
Військове Містечко вулиця	вулиця Військове Містечко
Військових Хірургів вулиця	вулиця Військових Хірургів
Військової Доблесті вулиця	вулиця Військової Доблесті
Вікторія вулиця	вулиця Вікторія
Віліса Лаціса вулиця	вулиця Віліса Лаціса
Вільних Козаків вулиця	вулиця Вільних Козаків
Вільних матросів вулиця	вулиця Вільних Матросів
Вільшана вулиця	Вільшана вулиця
Віля Надворнюка вулиця	вулиця Віля Надворнюка
Вілʼямса вулиця	вулиця Вілʼямса
Віннера вулиця	вулиця Віннера
Вінницьке лісництво вулиця	вулиця Вінницьке Лісництво
Віраг вулиця	вулиця Віраг
Вісконта вулиця	вулиця Вісконта
Вісника вулиця	вулиця Вісника
Віта вулиця	вулиця Віта
Вітрика вулиця	вулиця Вітрика
Вітрила вулиця	вулиця Вітрила
Вітру вулиця	вулиця Вітру
Віцана вулиця	вулиця Віцана
Вішталя вулиця	вулиця Вішталя
Вовчок вулиця	вулиця Вовчок
Вогнетривка вулиця	Вогнетривка вулиця
Водас вулиця	вулиця Водас
Водиця вулиця	вулиця Водиця
Водіїв вулиця	вулиця Водіїв
Водоканалбуд вулиця	вулиця Водоканалбуд
Водопровідника вулиця	вулиця Водопровідника
Водтелеп вулиця	вулиця Водтелеп
Воз'єднання вулиця	вулиця Воззʼєднання
Воз’ єднання вулиця	вулиця Воззʼєднання
Воз’єднання вулиця	вулиця Воззʼєднання
Возз'єднання вулиця	вулиця Воззʼєднання
Возз’єднання вулиця	вулиця Воззʼєднання
Воззʼєднання вулиця	вулиця Воззʼєднання
Воінів УПА вулиця	вулиця Воїнів УПА
Воїнів Визволителів вулиця	вулиця Воїнів-визволителів
Воїнів вулиця	вулиця Воїнів
Воїнів УНР вулиця	вулиця Воїнів УНР
Воїнів УПА вулиця	вулиця Воїнів УПА
Воїнів-визволителів вулиця	вулиця Воїнів-визволителів
Воїнів-Сибіряків вулиця	вулиця Воїнів-сибіряків
Воїнiв вулиця	вулиця Воїнів
Войтул вулиця	вулиця Войтул
Войциха вулиця	вулиця Войциха
Волинських Чехів вулиця	вулиця Волинських Чехів
Волиця вулиця	вулиця Волиця
Воловець вулиця	вулиця Воловець
Воловиця вулиця	вулиця Воловиця
Волонтерів вулиця	вулиця Волонтерів
Волосика вулиця	вулиця Волосика
Волочаєва вулиця	вулиця Волочаєва
Волошиних вулиця	вулиця Волошиних
Волховбуду вулиця	вулиця Волховбуду
Воля вулиця	вулиця Воля
Воронці вулиця	вулиця Воронці
Ворошина вулиця	вулиця Ворошина
Восток-I вулиця	вулиця Восток-I
Восток-II вулиця	вулиця Восток-II
Восходу вулиця	вулиця Восходу
Вошкина вулиця	вулиця Вошкина
Вояків Дивізії Галичина вулиця	вулиця Вояків Дивізії Галичина
Вояків УПА вулиця	вулиця Вояків УПА
Врізана вулиця	Врізана вулиця
Вротновських вулиця	вулиця Вротновських
Втіха вулиця	вулиця Втіха
Втората вулиця	вулиця Втората
Вузькоколійка вулиця	вулиця Вузькоколійка
вулиця Базарна	Базарна вулиця
вулиця Битий Шлях	вулиця Битий Шлях
вулиця Бідненків	вулиця Бідненків
вулиця Бічна	Бічна вулиця
вулиця Благовісна	Благовісна вулиця
вулиця Будівельників	вулиця Будівельників
вулиця Варинського	вулиця Варинського
вулиця Весни	вулиця Весни
вулиця Ветеранів	вулиця Ветеранів
вулиця Визволителів	вулиця Визволителів
вулиця Виноградна	Виноградна вулиця
вулиця Вишнева	Вишнева вулиця
вулиця Гастелло	вулиця Гастелло
вулиця Героїв Крут	вулиця Героїв Крут
вулиця Героїв Майдану	вулиця Героїв Майдану
вулиця Героїв Маріуполя	вулиця Героїв Маріуполя
вулиця Героїв Пожежників	вулиця Героїв Пожежників
вулиця Героїв Рятувальників	вулиця Героїв Рятувальників
вулиця Героїв України	вулиця Героїв України
вулиця Головна	Головна вулиця
вулиця Горняків	вулиця Горняків
вулиця Дворянская	Дворянская вулиця
вулиця Добра	вулиця Добра
вулиця Дружби	вулиця Дружби
вулиця Дружби ІІ	2-га вулиця Дружби
вулиця Дружби народів	вулиця Дружби Народів
вулиця Єдності	вулиця Єдності
вулиця Жовтнева	Жовтнева вулиця
вулиця Замостянка	вулиця Замостянка
вулиця Запотічна	Запотічна вулиця
вулиця Затишна	Затишна вулиця
вулиця Зелена	Зелена вулиця
вулиця І. Килющика	вулиця І. Килющика
вулиця Колгоспна	Колгоспна вулиця
вулиця Комінтерна	вулиця Комінтерна
вулиця Копань	вулиця Копань
вулиця Космічна	Космічна вулиця
вулиця Космодемянської	вулиця Космодемянської
вулиця Космонавтів	вулиця Космонавтів
вулиця Левчишина	вулиця Левчишина
вулиця Лісна	Лісна вулиця
вулиця Межева	Межева вулиця
вулиця Металургів	вулиця Металургів
вулиця Миру	вулиця Миру
вулиця Мусорського	вулиця Мусорського
вулиця Незалежності	вулиця Незалежності
вулиця Обболонь	вулиця Обболонь
вулиця Огуленко	вулиця Огуленко
вулиця Перелісна	Перелісна вулиця
вулиця Перемоги	вулиця Перемоги
вулиця Першотравнева	Першотравнева вулиця
вулиця Підлісна	Підлісна вулиця
вулиця Правосуддя	вулиця Правосуддя
вулиця Праці	вулиця Праці
вулиця Примирення	вулиця Примирення
вулиця Приозерна	Приозерна вулиця
вулиця Прошинського	вулиця Прошинського
вулиця Роз вулиця	вулиця Роз
вулиця Руставі	вулиця Руставі
вулиця Свободи	вулиця Свободи
вулиця Середня	Середня вулиця
вулиця Січових Стрільців	вулиця Січових Стрільців
вулиця Слобода	вулиця Слобода
Вулиця Соборності	вулиця Соборності
вулиця Сороківщина	вулиця Сороківщина
вулиця Струмінського	вулиця Струмінського
Вулиця Тиха	Тиха вулиця
вулиця Травнева	Травнева вулиця
вулиця Українських Повстанців	вулиця Українських Повстанців
вулиця Ульянових	вулиця Ульянових
вулиця Фрунзе	вулиця Фрунзе
вулиця Хрещатик	вулиця Хрещатик
вулиця ЦТР	вулиця ЦТР
вулиця Чекістів	вулиця Чекістів
вулиця Червона	Червона вулиця
вулиця Чулея	вулиця Чулея
Вулиця Шептицьких	Вулиця Шептицьких
вулиця Щастя	вулиця Щастя
вулиця Юності	вулиця Юності
вулиця Яблочна	Яблочна вулиця
вулиця Яблунева	Яблунева вулиця
Вуліса вулиця	вулиця Вуліса
Вулшава вулиця	вулиця Вулшава
Вургуна вулиця	вулиця Вургуна
Вутіша вулиця	вулиця Вутіша
Вучкана вулиця	вулиця Вучкана
Вчених вулиця	вулиця Вчених
Вчителів вулиця	вулиця Вчителів
Вiдродження вулиця	вулиця Відродження
Гаврана вулиця	вулиця Гаврана
Гавришів Кут вулиця	вулиця Гавришів Кут
Гавришко вулиця	вулиця Гавришко
Гагарина вулиця	вулиця Гагарина
Гагенмейстера вулиця	вулиця Гагенмейстера
Газети «Іскра» вулиця	вулиця Газети «Іскра»
Газети «Комсомолець Донбасу» вулиця	вулиця Газети «Комсомолець Донбасу»
Газети «Правда» вулиця	вулиця Газети «Правда»
Газети Зоря вулиця	вулиця Газети «Зоря»
Газети Правда вулиця	вулиця Газети «Правда»
Газло вулиця	вулиця Газло
Газовиков вулиця	вулиця Газовиков
Газовка вулиця	вулиця Газовка
Газопровід вулиця	вулиця Газопровід
Гаї вулиця	вулиця Гаї
Гай вулиця	вулиця Гай
Гайок вулиця	вулиця Гайок
Галаєва вулиця	вулиця Галаєва
Галафеєва вулиця	вулиця Галафеєва
Галафєєва вулиця	вулиця Галафєєва
Галечко вулиця	вулиця Галечко
Галицьких Вояків вулиця	вулиця Галицьких Вояків
Галковскої вулиця	вулиця Галковскої
Гамаюна вулиця	вулиця Гамаюна
Гамбург вулиця	вулиця Гамбург
Гамора вулиця	вулиця Гамора
Ганді вулиця	вулиця Ганді
Гарама вулиця	вулиця Гарама
Гарамишина вулиця	вулиця Гарамишина
Гараса вулиця	вулиця Гараса
Гарб вулиця	вулиця Гарб
Гаргаєва вулиця	вулиця Гаргаєва
Гардимана вулиця	вулиця Гардимана
Гардоні вулиця	вулиця Гардоні
Гаришина вулиця	вулиця Гаришина
Гарібальді вулиця	вулиця Гарібальді
Гаркушина вулиця	вулиця Гаркушина
Гармонії вулиця	вулиця Гармонії
Гарнієра вулиця	вулиця Гарнієра
Гасина вулиця	вулиця Гасина
Гастелло вулиця	вулиця Гастелло
Гастело вулиця	вулиця Гастело
Гатила вулиця	вулиця Гатила
Гафурі вулиця	вулиця Гафурі
Гвая вулиця	вулиця Гвая
Гвоздичная вулиця	Гвоздична явулиця
Гевденя вулиця	вулиця Гевденя
Гевліча вулиця	вулиця Гевліча
Гедьолйо вулиця	вулиця Гедьолйо
Гейдена вулиця	вулиця Гейдена
Гейзи Оноді вулиця	вулиця Гейзи Оноді
Гейне вулиця	вулиця Гейне
Гелевана вулиця	вулиця Гелевана
Гелевера вулиця	вулиця Гелевера
Гелевея вулиця	вулиця Гелевея
Генерала Арабея вулиця	вулиця Генерала Арабея
Генерала Видригана вулиця	вулиця Генерала Видригана
генерала Дерев’ янка вулиця	вулиця генерала Деревʼянка
Генерала Дерев’янка вулиця	вулиця Генерала Деревʼянка
Генерала Єруха вулиця	вулиця Генерала Єруха
Генерала Куркчі вулиця	вулиця Генерала Куркчі
Генерала Лашина вулиця	вулиця Генерала Лашина
Генерала Леселідзе вулиця	вулиця Генерала Леселідзе
Генерала Обруча вулиця	вулиця Генерала Обруча
Генерала Плієва вулиця	вулиця Генерала Плієва
Генерала Путейка вулиця	вулиця Генерала Путейка
Генерала Трейка вулиця	вулиця Генерала Трейка
Генерала Цветаєва вулиця	вулиця Генерала Цветаєва
Геологів вулиця	вулиця Геологів
Георге Біяне вулиця	вулиця Георге Біяне
Геранієва вулиця	Геранієва вулиця
Гербурга вулиця	вулиця Гербурга
Геребенюка вулиця	вулиця Геребенюка
Героів Праці вулиця	вулиця Героїв Праці
Героїв Авіаторів вулиця	вулиця Героїв Авіаторів
Героїв Азову вулиця	вулиця Героїв Азову
Героїв Армії УНР вулиця	вулиця Героїв Армії УНР
Героїв Ато вулиця	вулиця Героїв АТО
Героїв АТО вулиця	вулиця Героїв АТО
Героїв Афганістану вулиця	вулиця Героїв Афганістану
Героїв Базару вулиця	вулиця Героїв Базару
Героїв Берестечка вулиця	вулиця Героїв Берестечка
Героїв Бреста вулиця	вулиця Героїв Бреста
Героїв Бронепоїзда вулиця	вулиця Героїв Бронепоїзда
Героїв Бучі вулиця	вулиця Героїв Бучі
Героїв Ворзеля вулиця	вулиця Героїв Ворзеля
Героїв вулиця	вулиця Героїв
Героїв Гостомеля вулиця	вулиця Героїв Гостомеля
Героїв Гурб вулиця	вулиця Героїв Гурб
Героїв Дніпра вулиця	вулиця Героїв Дніпра
Героїв Євромайдану вулиця	вулиця Героїв Євромайдану
Героїв ЗСУ вулиця	вулиця Героїв ЗСУ
Героїв Ірпіня вулиця	вулиця Героїв Ірпіня
Героїв Києва вулиця	вулиця Героїв Києва
Героїв Космосу вулиця	вулиця Героїв Космосу
Героїв Краснодона вулиця	вулиця Героїв Краснодона
Героїв Краснодону вулиця	вулиця Героїв Краснодону
Героїв Крут вулиця	вулиця Героїв Крут
ГероЇв Крут вулиця	вулиця Героїв Крут
Героїв Ленінграду вулиця	вулиця Героїв Ленінграду
Героїв Майдану вулиця	вулиця Героїв Майдану
Героїв Маріуполя вулиця	вулиця Героїв Маріуполя
Героїв Миколаєва вулиця	вулиця Героїв Миколаєва
Героїв Мирополя вулиця	вулиця Героїв Мирополя
Героїв Міуса вулиця	вулиця Героїв Міуса
Героїв Нацгвардії вулиця	вулиця Героїв Нацгвардії
Героїв небесної сотні вулиця	вулиця Героїв Небесної Сотні
Героїв ОУН вулиця	вулиця Героїв ОУН
Героїв ОУН-УПА вулиця	вулиця Героїв ОУН-УПА
Героїв Перекопу вулиця	вулиця Героїв Перекопу
Героїв Підпілля вулиця	вулиця Героїв Підпілля
Героїв Пілотів вулиця	вулиця Героїв Пілотів
Героїв Пожежних вулиця	вулиця Героїв Пожежних
Героїв поліції вулиця	вулиця Героїв Поліції
Героїв Поліції вулиця	вулиця Героїв Поліції
Героїв полку «Азов» вулиця	вулиця Героїв Полку «Азов»
Героїв Полку Азов вулиця	вулиця Героїв Полку «Азов»
Героїв праці вулиця	вулиця Героїв Праці
Героїв Праці вулиця	вулиця Героїв Праці
Героїв Революції вулиця	вулиця Героїв Революції
Героїв Севастополя вулиця	вулиця Героїв Севастополя
Героїв Союзу вулиця	вулиця Героїв Союзу
Героїв Сталінграда вулиця	вулиця Героїв Сталінграду
Героїв Сталінграду вулиця	вулиця Героїв Сталінграду
Героїв Трипілля вулиця	вулиця Героїв Трипілля
Героїв труда вулиця	вулиця Героїв Труда
Героїв УПА вулиця	вулиця Героїв УПА
Героїв Херсона вулиця	вулиця Героїв Херсона
Героїв Чернобиля вулиця	вулиця Героїв Чорнобиля
Героїв Чорнобиля вулиця	вулиця Героїв Чорнобиля
Героїв-пожежних вулиця	вулиця Героїв-пожежних
Героїзму вулиця	вулиця Героїзму
Героя Бараболько вулиця	вулиця Героя Бараболько
ГЕС вулиця	вулиця ГЕС
Геся вулиця	вулиця Геся
Гете вулиця	вулиця Гете
Гечеі вулиця	вулиця Гечеі
Гибало вулиця	вулиця Гибало
Гиївка вулиця	вулиця Гиївка
Гіжицьких вулиця	вулиця Гіжицьких
Гізелли Дравої вулиця	вулиця Гізелли Дравої
Гінцака вулиця	вулиця Гінцака
Гірка вулиця	Гірка вулиця
Гіркиня вулиця	вулиця Гіркиня
Гірниче Селище вулиця	вулиця Гірниче Селище
Гіршмана вулиця	вулиця Гіршмана
Гладка вулиця	Гладка вулиця
Глезоса вулиця	вулиця Глезоса
Глибка вулиця	вулиця Глибка
Глибока вулиця	Глибока вулиця
Глибока Долина вулиця	вулиця Глибока Долина
Глибочиця вулиця	вулиця Глибочиця
Глинище вулиця	вулиця Глинище
Глинне вулиця	вулиця Глинне
Глинянка вулиця	вулиця Глинянка
Глібка вулиця	вулиця Глібка
Глібовських вулиця	вулиця Глібовських
Глієвих вулиця	вулиця Глієвих
Глушець вулиця	вулиця Глушець
Гнилицької вулиця	вулиця Гнилицької
Гнучка вулиця	Гнучка вулиця
Голлоші вулиця	вулиця Голлоші
Голобородько вулиця	вулиця Голобородько
Головболгарбуд вулиця	вулиця Головболгарбуд
Гололя вулиця	вулиця Гололя
Голондія вулиця	вулиця Голондія
Голоско Фтизіатир вулиця	вулиця Голоско Фтизіатир
Голубий Кут вулиця	вулиця Голубий Кут
Голубина вулиця	Голубина вулиця
Голядкина вулиця	вулиця Голядкина
Голятин вулиця	вулиця Голятин
Гомолка вулиця	вулиця Гомолка
Гомонової вулиця	вулиця Гомонової
Гоначара вулиця	вулиця Гоначара
Гонча вулиця	Гонча вулиця
Гончариха вулиця	вулиця Гончариха
Гончарі вулиця	вулиця Гончарі
Гончарів вулиця	вулиця Гончарів
Гопнер вулиця	вулиця Гопнер
Горб вулиця	вулиця Горб
Горби Пролісок вулиця	вулиця Горби Пролісок
Горбиста вулиця	Горбиста вулиця
Горбка вулиця	вулиця Горбка
Горбок вулиця	вулиця Горбок
Горбочок вулиця	вулиця Горбочок
Горбушка вулиця	вулиця Горбушка
Гордика вулиця	вулиця Гордика
Гординських вулиця	вулиця Гординських
Гордіюк вулиця	вулиця Гордіюк
Гордолина вулиця	вулиця Гордолина
Горішків вулиця	вулиця Горішків
Горішній Кінець вулиця	вулиця Горішній Кінець
Горішній кут вулиця	вулиця Горішній Кут
Горішня Брама вулиця	вулиця Горішня Брама
Горішня вулиця	Горішня вулиця
Горішнянка вулиця	вулиця Горішнянка
Горка вулиця	вулиця Горка
Гормот вулиця	вулиця Гормот
Горностаєва вулиця	вулиця Горностаєва
Горняк вулиця	вулиця Горняк
Горняка вулиця	вулиця Горняка
Гороб'я вулиця	вулиця Горобʼя
Городища вулиця	вулиця Городища
Городище вулиця	вулиця Городище
Городищина вулиця	вулиця Городищина
Городня вулиця	Городня вулиця
Городок вулиця	вулиця Городок
Горука вулиця	вулиця Горука
Горчака вулиця	вулиця Горчака
Горянка вулиця	вулиця Горянка
Господарчий масив вулиця	вулиця Господарчий Масив
Гостєва вулиця	вулиця Гостєва
Гостинець вулиця	вулиця Гостинець
Грабина вулиця	вулиця Грабина
Грабівець вулиця	вулиця Грабівець
Грабник вулиця	вулиця Грабник
Грабовець вулиця	вулиця Грабовець
Граве вулиця	вулиця Граве
Грайонца вулиця	вулиця Грайонца
Границя вулиця	вулиця Границя
Гранкар'єр вулиця	вулиця Гранкарʼєр
Графа фон Гарнієра вулиця	вулиця Графа фон Гарнієра
Граффа вулиця	вулиця Граффа
Гребеля вулиця	вулиця Гребеля
Гребля вулиця	вулиця Гребля
Грендєш вулиця	вулиця Грендєш
Гречко вулиця	вулиця Гречко
Гречнєва вулиця	вулиця Гречнєва
Грига вулиця	вулиця Грига
Григор’ єва вулиця	вулиця Григорʼєва
Григор’єва вулиця	вулиця Григорʼєва
Григоровичів-Барських вулиця	вулиця Григоровичів-Барських
Гризодубових вулиця	вулиця Гризодубових
Гризодубової вулиця	вулиця Гризодубової
Гризун вулиця	вулиця Гризун
Грималюк вулиця	вулиця Грималюк
Гримучка вулиця	вулиця Гримучка
Гриневичів вулиця	вулиця Гриневичів
Гринчевої вулиця	вулиця Гринчевої
Грицевця вулиця	вулиця Грицевця
Гришана вулиця	вулиця Гришана
Грієвза вулиця	вулиця Грієвза
Грінвальда вулиця	вулиця Грінвальда
Грішина вулиця	вулиця Грішина
Громових вулиця	вулиця Громових
Грузія вулиця	вулиця Грузія
Груїшор вулиця	вулиця Груїшор
Грунських вулиця	вулиця Грунських
Грунь вулиця	вулиця Грунь
Грушевсько вулиця	вулиця Грушевського
Грушко вулиця	вулиця Грушко
Грядкувата вулиця	Грядкувата вулиця
Гугеля вулиця	вулиця Гугеля
Гулаї вулиця	вулиця Гулаї
Гулевич вулиця	вулиця Гулевич
Гуняді вулиця	вулиця Гуняді
Гур’єва вулиця	вулиця Гурʼєва
Гурамішвілі вулиця	вулиця Гурамішвілі
Гурвіча вулиця	вулиця Гурвіча
Гуреєва вулиця	вулиця Гуреєва
Гусинка вулиця	вулиця Гусинка
Гуті вулиця	вулиця Гуті
Гюго вулиця	вулиця Гюго
Ґвадані вулиця	вулиця Ґвадані
Ґеорґе Асакі вулиця	вулиця Ґеорґе Асакі
Ґете вулиця	вулиця Ґете
Ґрохольських вулиця	вулиця Ґрохольських
Давниця вулиця	вулиця Давниця
Давній вал вулиця	вулиця Давній Вал
Давня вулиця	Давня вулиця
Дадіані вулиця	вулиця Дадіані
Далека вулиця	Далека вулиця
Дальня вулиця	Дальня вулиця
Даньшина вулиця	вулиця Даньшина
Дарко вулиця	вулиця Дарко
Дарничанка вулиця	вулиця Дарничанка
Дачка вулиця	вулиця Дачка
Дачная вулиця	Дачная вулиця
Дванадцятихатка вулиця	вулиця Дванадцятихатка
Двір вулиця	вулиця Двір
Дворище вулиця	вулиця Дворище
Девдюка вулиця	вулиця Девдюка
Деволана вулиця	вулиця Деволана
Дедишко вулиця	вулиця Дедишко
Деже Дьєрі вулиця	вулиця Деже Дьєрі
Дезидерія Задора вулиця	вулиця Дезидерія Задора
Дейгана вулиця	вулиця Дейгана
Дейнеко вулиця	вулиця Дейнеко
Декабристві вулиця	вулиця Декабристів
Делу-Дітре-Вей вулиця	вулиця Делу-Дітре-Вей
Дем’янів Лаз вулиця	вулиця Демʼянів Лаз
Деманта вулиця	вулиця Деманта
Деметра вулиця	вулиця Деметра
Демчуков вулиця	вулиця Демчуков
Депутатів вулиця	вулиця Депутатів
Дерев'янко вулиця	вулиця Деревʼянко
Дерев’янка вулиця	вулиця Деревʼянка
Деревянко вулиця	вулиця Деревянко
Дерекосег вулиця	вулиця Дерекосег
Дересів вулиця	вулиця Дересів
Дерчені вулиця	вулиця Дерчені
Детюка вулиця	вулиця Детюка
Дехтяря вулиця	вулиця Дехтяря
Децика І. вулиця	вулиця І. Децика
Дечебал вулиця	вулиця Дечебал
Дешево вулиця	вулиця Дешево
Джабаєва вулиця	вулиця Джабаєва
Джакомо Пуччіні вулиця	вулиця Джакомо Пуччіні
Джалія вулиця	вулиця Джалія
Джамбула вулиця	вулиця Джамбула
Джамбула Джабаєва вулиця	вулиця Джамбула Джабаєва
Джанаєва вулиця	вулиця Джанаєва
Джапарідзе вулиця	вулиця Джапарідзе
Джеджелія вулиця	вулиця Джеджелія
Джерело вулиця	вулиця Джерело
Джингарадзе вулиця	вулиця Джингарадзе
Джублик вулиця	вулиця Джублик
Джузеппе Верді вулиця	вулиця Джузеппе Верді
Джузеппе Гарібальді вулиця	вулиця Джузеппе Гарібальді
Джулаївка вулиця	вулиця Джулаївка
Дзвінка вулиця	вулиця Дзвінка
Дибковка вулиця	вулиця Дибковка
Диктатури Пролетаріату вулиця	вулиця Диктатури Пролетаріату
Димніча вулиця	вулиця Димніча
Динамо вулиця	вулиця Динамо
Директорії вулиця	вулиця Директорії
Дитинства вулиця	вулиця Дитинства
Діаманди Ґалас вулиця	вулиця Діаманди Ґалас
Дібровка вулиця	вулиця Дібровка
Дівоча вулиця	Дівоча вулиця
Дівче вулиця	вулиця Дівче
Діда Трофима вулиця	вулиця Діда Трофима
Дідріхсона вулиця	вулиця Дідріхсона
Дідро вулиця	вулиця Дідро
Дінця вулиця	вулиця Дінця
Дніпрельстан вулиця	вулиця Дніпрельстан
Дніпробуду вулиця	вулиця Дніпробуду
Дніпровскька вулиця	вулиця Дніпровська
Дніпрогесу вулиця	вулиця Дніпрогесу
Дня Шахтаря вулиця	вулиця Дня Шахтаря
Добичіних вулиця	вулиця Добичіних
Добра Вода вулиця	вулиця Добра Вода
Добра вулиця	Добра вулиця
Добрий хутір вулиця	вулиця Добрий Хутір
Добрий Шлях вулиця	вулиця Добрий Шлях
Добрих Сусідів вулиця	вулиця Добрих Сусідів
Добробут вулиця	вулиця Добробут
Добровідка вулиця	вулиця Добровідка
Добровольчих батальйонів вулиця	вулиця Добровольчих Батальйонів
Добровольчих Батальйонів вулиця	вулиця Добровольчих Батальйонів
Добровольчих батальйонiв вулиця	вулиця Добровольчих Батальйонів
Добромир вулиця	вулиця Добромир
Добросусідства вулиця	вулиця Добросусідства
Довга балка вулиця	вулиця Довга Балка
Довга вулиця	Довга вулиця
Довге Озеро вулиця	вулиця Довге Озеро
Довгий Грунь вулиця	вулиця Довгий Грунь
Довгий Куток вулиця	вулиця Довгий Куток
Довжа вулиця	вулиця Довжа
Довжик вулиця	вулиця Довжик
Довжинець вулиця	вулиця Довжинець
Довжок вулиця	вулиця Довжок
Догаєва вулиця	вулиця Догаєва
Долгий вулиця	вулиця Долгий
Долгоша вулиця	вулиця Долгоша
Долина вулиця	вулиця Долина
Долина Княжа вулиця	вулиця Княжа Долина
Долинка вулиця	вулиця Долинка
Долишня вулиця	Долишня вулиця
Долі вулиця	вулиця Долі
Долішня вулиця	Долішня вулиця
Долішнянка вулиця	вулиця Долішнянка
Долорес Ібаррурі вулиця	вулиця Долорес Ібаррурі
Дольне вулиця	вулиця Дольне
Домб вулиця	вулиця Домб
Доненерго вулиця	вулиця Доненерго
Доробок вулиця	вулиця Доробок
Дородніцина вулиця	вулиця Дородніцина
Дорошок вулиця	вулиця Дорошок
Досвітня вулиця	Досвітня вулиця
Дослідне Поле вулиця	вулиця Дослідне Поле
Достатку вулиця	вулиця Достатку
Досягнень вулиця	вулиця Досягнень
Дощадець вулиця	вулиця Дощадець
Драбановець вулиця	вулиця Драбановець
Дроб’язка вулиця	вулиця Дробʼязка
Дробця вулиця	вулиця Дробця
Дрофаня вулиця	вулиця Дрофаня
Другетів вулиця	вулиця Другетів
Дружба вулиця	вулиця Дружба
Дружби народів вулиця	вулиця Дружби Народів
Дружби Народів вулиця	вулиця Дружби Народів
Друзів вулиця	вулиця Друзів
Друкарів вулиця	вулиця Друкарів
Друця вулиця	вулиця Друця
Дубенщина вулиця	вулиця Дубенщина
Дубина вулиця	вулиця Дубина
Дубинка вулиця	вулиця Дубинка
Дубовиця вулиця	вулиця Дубовиця
Дубок вулиця	вулиця Дубок
Дубоноса вулиця	вулиця Дубоноса
Дубровка вулиця	вулиця Дубровка
Дульчика вулиця	вулиця Дульчика
Думбрава вулиця	вулиця Думбрава
Дурбака вулиця	вулиця Дурбака
Дьогтярина вулиця	вулиця Дьогтярина
Дьордя Довжа вулиця	вулиця Дьордя Довжа
Дьошина вулиця	вулиця Дьошина
Дьячишина вулиця	вулиця Дьячишина
Дюли Кепеша вулиця	вулиця Дюли Кепеша
Дюма вулиця	вулиця Дюма
Дякущина вулиця	вулиця Дякущина
Дялу Боулуй вулиця	вулиця Дялу Боулуй
Егер вулиця	вулиця Егер
Едельвейсів вулиця	вулиця Едельвейсів
Едомера Тассоні вулиця	вулиця Едомера Тассоні
Ейгер вулиця	вулиця Ейгер
Ейдемана вулиця	вулиця Ейдемана
Електрометалургів вулиця	вулиця Електрометалургів
Еліберерій вулиця	вулиця Еліберерій
Еліезера Штейнбарга вулиця	вулиця Еліезера Штейнбарга
Елінг вулиця	вулиця Елінг
Ельворті вулиця	вулиця Ельворті
Емінеску вулиця	вулиця Емінеску
Енґельса вулиця	вулиця Енґельса
Ендре Аді вулиця	вулиця Ендре Аді
Ендре Оді вулиця	вулиця Ендре Оді
Епіка вулиця	вулиця Епіка
Ердев вулиця	вулиця Ердев
Ерделі вулиця	вулиця Ерделі
Ердехіватал вулиця	вулиця Ердехіватал
Ересвень вулиця	вулиця Ересвень
Етвеша вулиця	вулиця Етвеша
євпака вулиця	вулиця Євпака
Євстаф’єва вулиця	вулиця Євстафʼєва
Євстафьєва вулиця	вулиця Євстафьєва
Єдина вулиця	вулиця Єдина
Єдинача вулиця	вулиця Єдинача
Єднання вулиця	вулиця Єднання
Єлизарової вулиця	вулиця Єлизарової
Єпанчина вулиця	вулиця Єпанчина
Єретика вулиця	вулиця Єретика
Єрмішина вулиця	вулиця Єрмішина
Єрусалимка вулиця	вулиця Єрусалимка
Жайворона вулиця	вулиця Жайворона
Жамбила Жабаєва вулиця	вулиця Жамбила Жабаєва
Жамбила Тулаєва вулиця	вулиця Жамбила Тулаєва
Жвава вулиця	Жвава вулиця
Жвана вулиця	вулиця Жвана
Жебелєва вулиця	вулиця Жебелєва
Жежків вулиця	вулиця Жежків
Желязняка вулиця	вулиця Желязняка
Жердєва вулиця	вулиця Жердєва
Жердія вулиця	вулиця Жердія
Жертв революції вулиця	вулиця Жертв Революції
Жибчина вулиця	вулиця Жибчина
Жигаївка вулиця	вулиця Жигаївка
Жигоровка вулиця	вулиця Жигоровка
Жигуліних вулиця	вулиця Жигуліних
Жилко вулиця	вулиця Жилко
Жиловка вулиця	вулиця Жиловка
Житлове містечко вулиця	вулиця Житлове Містечко
Житлове Містечко вулиця	вулиця Житлове Містечко
Житлоселище вулиця	вулиця Житлоселище
Житній Ринок вулиця	вулиця Житній Ринок
Житня вулиця	Житня вулиця
Жігмонда Перені вулиця	вулиця Жігмонда Перені
Жігмонда Шіпоша вулиця	вулиця Жігмонда Шіпоша
Жовкевських вулиця	вулиця Жовкевських
Жовта вулиця	Жовта вулиця
Жовтенят вулиця	вулиця Жовтенят
Жовтневої революції вулиця	вулиця Жовтневої Революції
Жовтневої Революції вулиця	вулиця Жовтневої Революції
Жовтня вулиця	вулиця Жовтня
Жовтонога вулиця	вулиця Жовтонога
Жовтоножко вулиця	вулиця Жовтоножко
Жоліо Кюрі вулиця	вулиця Жоліо Кюрі
Жомера вулиця	вулиця Жомера
Жон Мироносиць вулиця	вулиця Жон Мироносиць
Жофії Баторі вулиця	вулиця Жофії Баторі
Жуйка вулиця	вулиця Жуйка
Жуковських вулиця	вулиця Жуковських
Жупан вулиця	вулиця Жупан
Журі вулиця	вулиця Журі
З’єднана вулиця	Зʼєднана вулиця
За Грабцем вулиця	вулиця За Грабцем
За двором вулиця	вулиця За Двором
За Долиною вулиця	вулиця За Долиною
За мир вулиця	вулиця За Мир
За мостом вулиця	вулиця За Мостом
За Рудкою вулиця	вулиця За Рудкою
Забава вулиця	вулиця Забава
Забалка вулиця	вулиця Забалка
Заберезина вулиця	Заберезина вулиця
Забілявка вулиця	вулиця Забілявка
Забіркіне вулиця	вулиця Забіркіне
Заболото вулиця	вулиця Заболото
Заболоття вулиця	вулиця Заболоття
Забрама вулиця	вулиця Забрама
Забрід вулиця	вулиця Забрід
Забріддя вулиця	вулиця Забріддя
Завадка вулиця	вулиця Завадка
Завалля вулиця	вулиця Завалля
Заварихина вулиця	вулиця Заварихина
Завгородніх вулиця	вулиця Завгородніх
Завгородня вулиця	Завгородня вулиця
Завертяєва вулиця	вулиця Завертяєва
Заверх вулиця	вулиця Заверх
Заверхня вулиця	Заверхня вулиця
Завода вулиця	вулиця Завода
Заводище вулиця	вулиця Заводище
Заводу Комсомолець вулиця	вулиця Заводу Комсомолець
Завойка вулиця	вулиця Завойка
Завойко вулиця	вулиця Завойко
Заворуєва вулиця	вулиця Заворуєва
Загатці вулиця	вулиця Загатці
Загать вулиця	вулиця Загать
Загиблих Героїв вулиця	вулиця Загиблих Героїв
Загір'я вулиця	вулиця Загірʼя
Загір’я вулиця	вулиця Загірʼя
Загірка вулиця	вулиця Загірка
Заглиння вулиця	вулиця Заглиння
Заговда вулиця	вулиця Заговда
Загора вулиця	вулиця Загора
Загород вулиця	вулиця Загород
Загорода вулиця	вулиця Загорода
Загороддя вулиця	вулиця Загороддя
Загородня вулиця	Загородня вулиця
Загоруйко вулиця	вулиця Загоруйко
Загорянка вулиця	вулиця Загорянка
Загребелля вулиця	вулиця Загребелля
Загребля вулиця	вулиця Загребля
Задвір вулиця	вулиця Задвір
Задвір’я вулиця	вулиця Задвірʼя
Задвориння вулиця	вулиця Задвориння
Задернюка вулиця	вулиця Задернюка
Заділ вулиця	вулиця Заділ
Заділок вулиця	вулиця Заділок
Задільниця вулиця	вулиця Задільниця
Задовга вулиця	Задовга вулиця
Задор вулиця	вулиця Задор
Зазамче вулиця	вулиця Зазамче
Закичера вулиця	вулиця Закичера
Заклинських вулиця	вулиця Заклинських
Закоротина вулиця	вулиця Закоротина
Закорчма вулиця	вулиця Закорчма
Закоршма вулиця	вулиця Закоршма
Закоханих вулиця	вулиця Закоханих
Закрупець вулиця	вулиця Закрупець
Залаегерсег вулиця	вулиця Залаегерсег
Залесья вулиця	вулиця Залесья
Залиман вулиця	вулиця Залиман
Залисий вулиця	вулиця Залисий
Залізниця вулиця	вулиця Залізниця
Залізничина вулиця	Залізничина вулиця
Залізничка вулиця	вулиця Залізничка
Залізної Дивізії вулиця	вулиця Залізної Дивізії
Залісся вулиця	вулиця Залісся
Заломана Річка вулиця	вулиця Заломана Річка
Залуг вулиця	вулиця Залуг
Залужжя вулиця	вулиця Залужжя
Залуцьківщина вулиця	вулиця Залуцьківщина
Замір'я вулиця	вулиця Замірʼя
Замір’я вулиця	вулиця Замірʼя
Заміст вулиця	вулиця Заміст
Замістя вулиця	вулиця Замістя
Замкнена вулиця	Замкнена вулиця
Замкнута вулиця	Замкнута вулиця
Замковище вулиця	вулиця Замковище
Замлиння вулиця	вулиця Замлиння
Замлинських вулиця	вулиця Замлинських
Замогилка вулиця	вулиця Замогилка
Замок вулиця	вулиця Замок
Замость вулиця	вулиця Замость
Замостя вулиця	вулиця Замостя
Замотаєва вулиця	вулиця Замотаєва
Занковецької вулиця	вулиця Занковецької
Заокіп вулиця	вулиця Заокіп
Заповідник вулиця	вулиця Заповідник
Заподрино вулиця	вулиця Заподрино
Запоріжця вулиця	вулиця Запоріжця
Запорізьких козаків вулиця	вулиця Запорізьких Козаків
Запорізької Січі вулиця	вулиця Запорізької Січі
Запорозької Січі вулиця	вулиця Запорозької Січі
Запотік вулиця	вулиця Запотік
Запотіччя вулиця	вулиця Запотіччя
Запрутина вулиця	Запрутина вулиця
Заребро вулиця	вулиця Заребро
Заречная вулиця	Заречная вулиця
Зарєчная вулиця	Зарєчная вулиця
Зарицьких вулиця	вулиця Зарицьких
Заріг вулиця	вулиця Заріг
Заріка вулиця	вулиця Заріка
Зарінок вулиця	вулиця Зарінок
Зарічка вулиця	вулиця Зарічка
Зарічок вулиця	вулиця Зарічок
Заріччя вулиця	вулиця Заріччя
Зарниця вулиця	вулиця Зарниця
Зарогатка вулиця	вулиця Зарогатка
Зародової вулиця	вулиця Зародової
Заруда вулиця	вулиця Заруда
Заруддя вулиця	вулиця Заруддя
Зарудка вулиця	вулиця Зарудка
Засаддя вулиця	вулиця Засаддя
Засадя вулиця	вулиця Засадя
Засивка вулиця	вулиця Засивка
Засілля вулиця	вулиця Засілля
Застав вулиця	вулиця Застав
Застав'я вулиця	вулиця Заставʼя
Застав’є вулиця	вулиця Заставʼє
Застав’я вулиця	вулиця Заставʼя
Застава вулиця	вулиця Застава
Заставок вулиця	вулиця Заставок
Заступ’я вулиця	вулиця Заступʼя
Засулич вулиця	вулиця Засулич
Засядько вулиця	вулиця Засядько
Затиша вулиця	вулиця Затиша
Затишшя вулиця	вулиця Затишшя
Зауглище вулиця	вулиця Зауглище
Захар'єва вулиця	вулиця Захарʼєва
Захоролля вулиця	вулиця Захоролля
Зацерква вулиця	вулиця Зацерква
Зацерків'я вулиця	вулиця Зацерківʼя
Зацерків’я вулиця	вулиця Зацерківʼя
Зачиняєва вулиця	вулиця Зачиняєва
Зашкапії вулиця	вулиця Зашкапії
Защирок вулиця	вулиця Защирок
Заяма вулиця	вулиця Заяма
Заяр’я вулиця	вулиця Заярʼя
Заячий Гай вулиця	вулиця Заячий Гай
Збараж вулиця	вулиця Збараж
Збаразьке кільце вулиця	вулиця Збаразьке Кільце
Збоїща вулиця	вулиця Збоїща
Зв’язку вулиця	вулиця Звʼязку
Зваричі вулиця	вулиця Зваричі
Звейнека вулиця	вулиця Звейнека
Звивиста вулиця	Звивиста вулиця
Звилиста вулиця	Звилиста вулиця
Звільнена вулиця	Звільнена вулиця
Звільнення вулиця	вулиця Звільнення
Звір вулиця	вулиця Звір
Звіринець вулиця	вулиця Звіринець
Зворець вулиця	вулиця Зворець
Здвижка вулиця	вулиця Здвижка
Здоров'я вулиця	вулиця Здоровʼя
Здоров’я вулиця	вулиця Здоровʼя
Зелдфа вулиця	вулиця Зелдфа
Зелена Брама вулиця	вулиця Зелена Брама
Зелена вулиця	Зелена вулиця
Зелена Гірка вулиця	вулиця Зелена Гірка
Зелена Долина вулиця	вулиця Зелена Долина
Зелена Роща вулиця	вулиця Зелена Роща
Зеленбуд вулиця	вулиця Зеленбуд
Зелених Янголів вулиця	вулиця Зелених Янголів
Землеробів вулиця	вулиця Землеробів
Зиґзаґ вулиця	вулиця Зиґзаґ
Зільберта вулиця	вулиця Зільберта
Зіндельса вулиця	вулиця Зіндельса
Зінчаші вулиця	вулиця Зінчаші
Зіньковецької вулиця	вулиця Зіньковецької
Зірка вулиця	вулиця Зірка
Змагання вулиця	вулиця Змагання
Зовнішня вулиця	Зовнішня вулиця
Зодчих вулиця	вулиця Зодчих
Золної вулиця	вулиця Золної
Золота Баня вулиця	вулиця Золота Баня
Золота вулиця	Золота вулиця
Золотарка вулиця	вулиця Золотарка
Золотий берег вулиця	вулиця Золотий Берег
Золотий Лан вулиця	вулиця Золотий Лан
Золотий Потік вулиця	вулиця Золотий Потік
Золотий Яр вулиця	вулиця Золотий Яр
Золотиста вулиця	Золотиста вулиця
Золоті Ключі вулиця	вулиця Золоті Ключі
Золотів Яр вулиця	вулиця Золотів Яр
Золотоосіння вулиця	Золотоосіння вулиця
Зорге вулиця	вулиця Зорге
Зоресвітня вулиця	Зоресвітня вулиця
Зору вулиця	вулиця Зору
Зоря вулиця	вулиця Зоря
Зоря Комунізму вулиця	вулиця Зоря Комунізму
Зофоре вулиця	вулиця Зофоре
Зруб вулиця	вулиця Зруб
Зубрицьких вулиця	вулиця Зубрицьких
Зузука вулиця	вулиця Зузука
Зулена вулиця	вулиця Зулена
Илʼїча вулиця	вулиця Илʼїча
І. Алба вулиця	вулиця І. Алба
І. Вільде вулиця	вулиця І. Вільде
І. Данеко вулиця	вулиця І. Данеко
І. Калуша вулиця	вулиця І. Калуша
І. Шило вулиця	вулиця І. Шило
І.Прашка вулиця	вулиця І. Прашка
Івокут вулиця	вулиця Івокут
Ігенєлт вулиця	вулиця Ігенєлт
Ігнат'єва вулиця	вулиця Ігнатʼєва
Ігнатових вулиця	вулиця Ігнатових
Ігорєва вулиця	вулиця Ігорєва
Ізвєстій вулиця	вулиця Ізвєстій
Ізвилиста вулиця	Ізвилиста вулиця
Ізвиліста вулиця	Ізвиліста вулиця
Ізвіліста вулиця	Ізвіліста вулиця
Ізугенєва вулиця	вулиця Ізугенєва
ім. героя Білоножко вулиця	вулиця імені Героя Білоножко
ім.Фрунзе вулиця	вулиця імені Фрунзе
Імре Текелі вулиця	вулиця Імре Текелі
Інглезі вулиця	вулиця Інглезі
Індустріалізації вулиця	вулиця Індустріалізації
Індустрії вулиця	вулиця Індустрії
Інженера Веденеєва вулиця	вулиця Інженера Веденеєва
Інженерів вулиця	вулиця Інженерів
Інститутській проріз вулиця	вулиця Інститутській Проріз
Іона Кілару вулиця	вулиця Іона Кілару
Ісаханяня вулиця	вулиця Ісаханяня
Ісковщина вулиця	вулиця Ісковщина
Існюка вулиця	вулиця Існюка
ІТР вулиця	вулиця ІТР
Іфюшаг вулиця	вулиця Іфюшаг
Йовжефа Онтола вулиця	вулиця Йовжефа Онтола
Йовжефа Шорі вулиця	вулиця Йовжефа Шорі
Йокаї вулиця	вулиця Йокаї
Йонко вулиця	вулиця Йонко
Кабівці вулиця	вулиця Кабівці
Кавалерідзе вулиця	вулиця Кавалерідзе
Кавалерії вулиця	вулиця Кавалерії
Кагамлика вулиця	вулиця Кагамлика
Кадинця вулиця	вулиця Кадинця
Кадуб вулиця	вулиця Кадуб
Кадуна вулиця	вулиця Кадуна
Казанової вулиця	вулиця Казанової
Казбек вулиця	вулиця Казбек
Казінці вулиця	вулиця Казінці
Казішвілі вулиця	вулиця Казішвілі
Казьмірі вулиця	вулиця Казьмірі
Казьонщина вулиця	вулиця Казьонщина
Кайданка вулиця	вулиця Кайданка
Каландирця вулиця	вулиця Каландирця
Калатур вулиця	вулиця Калатур
Календюка вулиця	вулиця Календюка
Калниші вулиця	вулиця Калниші
Калошина вулиця	вулиця Калошина
Кальварії вулиця	вулиця Кальварії
Кальницькой вулиця	вулиця Кальницькой
Калiнiча вулиця	вулиця Калініча
Кам'яниста вулиця	Камʼяниста вулиця
Кам'янка вулиця	вулиця Камʼянка
Кам’янець вулиця	вулиця Камʼянець
Кам’яниста вулиця	Камʼяниста вулиця
Кам’янка вулиця	вулиця Камʼянка
Кам’яногірка вулиця	вулиця Камʼяногірка
Кам’янчанина вулиця	вулиця Камʼянчанина
Камая вулиця	вулиця Камая
Каменець вулиця	вулиця Каменець
Каменьщіків вулиця	вулиця Каменьщіків
Каменьщікiв вулиця	вулиця Каменьщіків
Каменяра вулиця	вулиця Каменяра
Каменярів вулиця	вулиця Каменярів
Камишевата вулиця	Камишевата вулиця
Камка вулиця	вулиця Камка
Камневата вулиця	Камневата вулиця
Камо вулиця	вулиця Камо
Камяниха вулиця	вулиця Камяниха
Камянка вулиця	вулиця Камянка
Канора вулиця	вулиця Канора
Капанеллі вулиця	вулиця Капанеллі
Карбунешть вулиця	вулиця Карбунешть
Карканиці вулиця	вулиця Карканиці
Кармаєва вулиця	вулиця Кармаєва
Кароя Тарці вулиця	вулиця Кароя Тарці
Картвелішвілі вулиця	вулиця Картвелішвілі
Каруна вулиця	вулиця Каруна
Кархута вулиця	вулиця Кархута
Каспра вулиця	вулиця Каспра
Каталін вулиця	вулиця Каталін
Каховка вулиця	вулиця Каховка
Кашарня вулиця	вулиця Кашарня
Каштей вулиця	вулиця Каштей
Кащєєва вулиця	вулиця Кащєєва
Кащія вулиця	вулиця Кащія
Квітів вулиця	вулиця Квітів
Квітко вулиця	вулиця Квітко
Квітуча вулиця	Квітуча вулиця
Квятека вулиця	вулиця Квятека
Кевелів вулиця	вулиця Кевелів
Кекпатак вулиця	вулиця Кекпатак
Келчеї вулиця	вулиця Келчеї
Кеніга вулиця	вулиця Кеніга
Керпініш вулиця	вулиця Керпініш
Керт вулиця	вулиця Керт
Кертолйо вулиця	вулиця Кертолйо
Кийка вулиця	вулиця Кийка
Кийків вулиця	вулиця Кийків
Кийкiв вулиця	вулиця Кийків
Киктя вулиця	вулиця Киктя
КИМ вулиця	вулиця КИМ
Кипуча вулиця	Кипуча вулиця
Киртка вулиця	вулиця Киртка
Кисляк вулиця	вулиця Кисляк
Кистяківських вулиця	вулиця Кистяківських
Китобоїв вулиця	вулиця Китобоїв
Кихна вулиця	вулиця Кихна
Кичерка вулиця	вулиця Кичерка
Кіблер вулиця	вулиця Кіблер
Кіборгів вулиця	вулиця Кіборгів
Кібрика вулиця	вулиця Кібрика
Ківшана вулиця	вулиця Ківшана
Кігіма вулиця	вулиця Кігіма
Кіквідзе вулиця	вулиця Кіквідзе
Кікень вулиця	вулиця Кікень
Кікоша вулиця	вулиця Кікоша
Кім вулиця	вулиця Кім
КІМа вулиця	вулиця КІМа
Кіндратьєва вулиця	вулиця Кіндратьєва
Кінець вулиця	вулиця Кінець
Кініжі вулиця	вулиця Кініжі
Кіорпе вулиця	вулиця Кіорпе
Кіото вулиця	вулиця Кіото
Кіпті вулиця	вулиця Кіпті
Кіраль вулиця	вулиця Кіраль
Кірічека вулиця	вулиця Кірічека
Кіш вулиця	вулиця Кіш
Кішвашут вулиця	вулиця Кішвашут
Кішгедь вулиця	вулиця Кішгедь
Кішкез вулиця	вулиця Кішкез
Кіштемете вулиця	вулиця Кіштемете
Кішфолуді вулиця	вулиця Кішфолуді
Классона вулиця	вулиця Классона
Клебанщина вулиця	вулиця Клебанщина
Клешканя вулиця	вулиця Клешканя
Клибанія вулиця	вулиця Клибанія
Кливака вулиця	вулиця Кливака
Климпуші вулиця	вулиця Климпуші
Клинець вулиця	вулиця Клинець
Клочко вулиця	вулиця Клочко
Клушина вулиця	вулиця Клушина
Клюткавиця вулиця	вулиця Клюткавиця
Клюхька вулиця	вулиця Клюхька
Ключинських вулиця	вулиця Ключинських
Кмитів Яр вулиця	вулиця Кмитів Яр
Княгинин вулиця	вулиця Княгинин
Княжа вулиця	Княжа вулиця
Княжий Брід вулиця	вулиця Княжий Брід
Княжий Затон вулиця	вулиця Княжий Затон
Княжина вулиця	Княжина вулиця
Князів Ґедиміновичів вулиця	вулиця Князів Ґедиміновичів
Князів Коріатовичів вулиця	вулиця Князів Коріатовичів
Князів острозьких вулиця	вулиця Князів Острозьких
Князів Острозьких вулиця	вулиця Князів Острозьких
Князів Ружинських вулиця	вулиця Князів Ружинських
Князів Сангушків вулиця	вулиця Князів Сангушків
Князів Сангушко вулиця	вулиця Князів Сангушко
Кобеєва вулиця	вулиця Кобеєва
Кобера вулиця	вулиця Кобера
Коберідзе вулиця	вулиця Коберідзе
Кобзарів вулиця	вулиця Кобзарів
Кобозєва вулиця	вулиця Кобозєва
Кобринських вулиця	вулиця Кобринських
Кобринця вулиця	вулиця Кобринця
Кобринюка вулиця	вулиця Кобринюка
Кобриш вулиця	вулиця Кобриш
Ковбуза вулиця	вулиця Ковбуза
Ковельмана вулиця	вулиця Ковельмана
Ковната вулиця	вулиця Ковната
Коворот вулиця	вулиця Коворот
Ковтюха вулиця	вулиця Ковтюха
Кодриш вулиця	вулиця Кодриш
Кожбук вулиця	вулиця Кожбук
Кожем’яків вулиця	вулиця Кожемʼяків
Кожухаря вулиця	вулиця Кожухаря
Кожушко вулиця	вулиця Кожушко
Козача вулиця	Козача вулиця
Козачий вулиця	Козачий провулок
Козачий Шлях вулиця	вулиця Козачий Шлях
Козинець вулиця	вулиця Козинець
Козинці вулиця	вулиця Козинці
Козиря вулиця	вулиця Козиря
Козіївка вулиця	вулиця Козіївка
Козіно вулиця	вулиця Козіно
Козові вулиця	вулиця Козові
Козоріса вулиця	вулиця Козоріса
Койнаша вулиця	вулиця Койнаша
Кокирлату вулиця	вулиця Кокирлату
Кокінакі вулиця	вулиця Кокінакі
Коккінакі вулиця	вулиця Коккінакі
Кокоєва вулиця	вулиця Кокоєва
Коксохіміків вулиця	вулиця Коксохіміків
Колективізації вулиця	вулиця Колективізації
Колесня вулиця	вулиця Колесня
Коллонтай вулиця	вулиця Коллонтай
Коло Моста вулиця	вулиця Коло Моста
Колодязьна вулиця	Колодязьна вулиця
Колонія вулиця	вулиця Колонія
Колосиста вулиця	Колосиста вулиця
Колоскових вулиця	вулиця Колоскових
Колпаковой вулиця	вулиця Колпаковой
Колуково вулиця	вулиця Колуково
Кольчака вулиця	вулиця Кольчака
Колюбаєва вулиця	вулиця Колюбаєва
Командарма Корка вулиця	вулиця Командарма Корка
Комарвоа вулиця	вулиця Комарова
Комбайнерів вулиця	вулиця Комбайнерів
Комінника вулиця	вулиця Комінника
Комінтерну  вулиця	вулиця Комінтерну 
Комінтерну вулиця	вулиця Комінтерну
Комка вулиця	вулиця Комка
Комонавтів вулиця	вулиця Космонавтів
Композиторів вулиця	вулиця Композиторів
Комунара вулиця	вулиця Комунара
Комунарів вулиця	вулиця Комунарів
Комуністичної праці вулиця	вулиця Комуністичної Праці
Конгресів Яр вулиця	вулиця Конгресів Яр
Кондака вулиця	вулиця Кондака
Кондарєва вулиця	вулиця Кондарєва
Кондратка вулиця	вулиця Кондратка
Кондратця вулиця	вулиця Кондратця
Кондрашина вулиця	вулиця Кондрашина
Коник вулиця	вулиця Коник
Конопельця вулиця	вулиця Конопельця
Конопницької вулиця	вулиця Конопницької
Коноптицької вулиця	вулиця Коноптицької
Конституції вулиця	вулиця Конституції
Конструкторілор вулиця	вулиця Конструкторілор
Конько вулиця	вулиця Конько
Коняєва вулиця	вулиця Коняєва
Коняшиних вулиця	вулиця Коняшиних
Копана вулиця	Копана вулиця
Копанка вулиця	вулиця Копанка
Копань вулиця	вулиця Копань
Копачів вулиця	вулиця Копачів
Копчин вулиця	вулиця Копчин
Корабелів вулиця	вулиця Корабелів
Корабельника вулиця	вулиця Корабельника
Корабліної вулиця	вулиця Корабліної
Корбутяка вулиця	вулиця Корбутяка
Корда вулиця	вулиця Корда
Корея вулиця	вулиця Корея
Корзо вулиця	вулиця Корзо
Корлюка вулиця	вулиця Корлюка
Корман вулиця	вулиця Корман
Корнії вулиця	вулиця Корнії
Корніліча вулиця	вулиця Корніліча
Королівщина вулиця	вулиця Королівщина
Корота вулиця	Коротка вулиця
Коротка вулиця	Коротка вулиця
Корпанюків вулиця	вулиця Корпанюків
Корсунка вулиця	вулиця Корсунка
Корфа вулиця	вулиця Корфа
Корчі вулиця	вулиця Корчі
Корчіївка вулиця	вулиця Корчіївка
Корчунок вулиця	вулиця Корчунок
Косвена вулиця	Косвена вулиця
Косий хутір вулиця	вулиця Косий Хутір
Космача вулиця	вулиця Космача
Космонавта Пацаєва вулиця	вулиця Космонавта Пацаєва
Космонавтів вулиця	вулиця Космонавтів
Космонавтiв вулиця	вулиця Космонавтів
Косовських вулиця	вулиця Косовських
Косогона вулиця	вулиця Косогона
Костенюк вулиця	вулиця Костенюк
Костьолок вулиця	вулиця Костьолок
Костюків Ліс вулиця	вулиця Костюків Ліс
Костюшко вулиця	вулиця Костюшко
Косяк вулиця	вулиця Косяк
Коте Шилокадзе вулиця	вулиця Коте Шилокадзе
Котирло вулиця	вулиця Котирло
Котовка вулиця	вулиця Котовка
Коцка вулиця	вулиця Коцка
Коцорина вулиця	вулиця Коцорина
Коцюба вулиця	вулиця Коцюба
Кочегарів вулиця	вулиця Кочегарів
Коштель вулиця	вулиця Коштель
Крагульця вулиця	вулиця Крагульця
Краєва вулиця	Краєва вулиця
Краєзнавча вулиця	Краєзнавча вулиця
Країще вулиця	вулиця Країще
Крайня вулиця	Крайня вулиця
Крайняя вулиця	Крайняя вулиця
Краківщина вулиця	вулиця Краківщина
Красина вулиця	вулиця Красина
Красино вулиця	вулиця Красино
Красицьких вулиця	вулиця Красицьких
Красінських вулиця	вулиця Красінських
Красная вулиця	Красная вулиця
Красне Плесо вулиця	вулиця Красне Плесо
Красних зір вулиця	вулиця Красних Зір
Красних Партизан вулиця	вулиця Красних Партизан
Красногірка вулиця	вулиця Красногірка
Красностав вулиця	вулиця Красностав
Красношапка вулиця	вулиця Красношапка
Красноштана вулиця	вулиця Красноштана
Краснянка вулиця	вулиця Краснянка
Красопулька вулиця	вулиця Красопулька
Крачуна вулиця	вулиця Крачуна
Крегулець вулиця	вулиця Крегулець
Крейсера «Аврора» вулиця	вулиця Крейсера «Аврора»
Крейсера Аврора вулиця	вулиця Крейсера «Аврора»
Крейтера вулиця	вулиця Крейтера
Креміня вулиця	вулиця Креміня
Кремлівських Курсантів вулиця	вулиця Кремлівських Курсантів
Кренкеля вулиця	вулиця Кренкеля
Криве вулиця	вулиця Криве
Кривець вулиця	вулиця Кривець
Кривлюка вулиця	вулиця Кривлюка
Кривня Горішня вулиця	вулиця Кривня Горішня
Кривня Долішня вулиця	вулиця Кривня Долішня
Криворіжсталі вулиця	вулиця Криворіжсталі
Криворучко вулиця	вулиця Криворучко
Кривохижина вулиця	вулиця Кривохижина
Кривошеї вулиця	вулиця Кривошеї
Кривуля вулиця	вулиця Кривуля
Кривча вулиця	вулиця Кривча
Криклия вулиця	вулиця Криклия
Крим-Кавказ вулиця	вулиця Крим-Кавказ
Кримця вулиця	вулиця Кримця
Криничанка вулиця	вулиця Криничанка
Криничувата вулиця	вулиця Криничувата
Крікента вулиця	вулиця Крікента
Кротона вулиця	вулиця Кротона
Кроцолин вулиця	вулиця Кроцолин
Круг вулиця	вулиця Круг
Круг Городище вулиця	вулиця Круг Городище
Кругла вулиця	Кругла вулиця
Кругле вулиця	вулиця Кругле
Круглий вулиця	вулиця Круглий
Круглик вулиця	вулиця Круглик
Круглицької вулиця	вулиця Круглицької
Кругляк вулиця	вулиця Кругляк
Кружляк вулиця	вулиця Кружляк
Крупскої вулиця	вулиця Крупської
Крута вулиця	Крута вулиця
Крутий Яр вулиця	вулиця Крутий Яр
Крутнів Яр вулиця	вулиця Крутнів Яр
Круча вулиця	вулиця Круча
Крушельницьких вулиця	вулиця Крушельницьких
Крушина вулиця	вулиця Крушина
Крушник вулиця	вулиця Крушник
Крянге вулиця	вулиця Крянге
Крiвая вулиця	вулиця Крівая
Кубинця вулиця	вулиця Кубинця
Кубишко вулиця	вулиця Кубишко
Кубійовичів вулиця	вулиця Кубійовичів
Кубіка вулиця	вулиця Кубіка
Кударя  вулиця	вулиця Кударя 
Кударя вулиця	вулиця Кударя
Кудрява вулиця	Кудрява вулиця
Кузнеча вулиця	вулиця Кузнеча
Кузьменщина вулиця	вулиця Кузьменщина
Куінджі вулиця	вулиця Куїнджі
Куїнджі вулиця	вулиця Куїнджі
Кукля вулиця	вулиця Кукля
Кулеша вулиця	вулиця Кулеша
Культосвітня вулиця	вулиця Культосвітня
Куляб’єва вулиця	вулиця Кулябʼєва
Куманець вулиця	вулиця Куманець
Купальниця вулиця	вулиця Купальниця
Купиня вулиця	вулиця Купиня
Купов’янової вулиця	вулиця Куповʼянової
Куптія вулиця	вулиця Куптія
Курака вулиця	вулиця Курака
Куракина вулиця	вулиця Куракина
Курако вулиця	вулиця Курако
Курило вулиця	вулиця Курило
Куріса вулиця	вулиця Куріса
Курлука вулиця	вулиця Курлука
Курноса вулиця	вулиця Курноса
Курсантів вулиця	вулиця Курсантів
Курявка вулиця	вулиця Курявка
Кустов'є вулиця	вулиця Кустовʼє
Кустря вулиця	вулиця Кустря
Кут вулиця	вулиця Кут
Кутець вулиця	вулиця Кутець
Кутня вулиця	Кутня вулиця
Куток вулиця	вулиця Куток
Кухарєва вулиця	вулиця Кухарєва
Кучарка вулиця	вулиця Кучарка
Кучерява вулиця	Кучерява вулиця
Кушакевичів вулиця	вулиця Кушакевичів
Кушвіда вулиця	вулиця Кушвіда
Куяльник вулиця	вулиця Куяльник
Кюрі вулиця	вулиця Кюрі
Лабуза вулиця	вулиця Лабуза
Лагайка вулиця	вулиця Лагайка
Лагерне Поле вулиця	вулиця Лагерне Поле
Ладо Кецховелі вулиця	вулиця Ладо Кецховелі
Лазника вулиця	вулиця Лазника
Лазня вулиця	вулиця Лазня
Лазо вулиця	вулиця Лазо
Лазок вулиця	вулиця Лазок
Лалаянца вулиця	вулиця Лалаянца
Ламана вулиця	вулиця Ламана
Лан вулиця	вулиця Лан
Лангемака вулиця	вулиця Лангемака
Ландау вулиця	вулиця Ландау
Ланок вулиця	вулиця Ланок
Лапаївка вулиця	вулиця Лапаївка
Лаптєвих вулиця	вулиця Лаптєвих
Лапшин вулиця	вулиця Лапшин
Ласкава вулиця	Ласкава вулиця
Ласла Шафарі вулиця	вулиця Ласла Шафарі
Ласло Оцела вулиця	вулиця Ласло Оцела
Ластовча вулиця	вулиця Ластовча
Латаша вулиця	вулиця Латаша
Латориця вулиця	вулиця Латориця
Лауреатів вулиця	вулиця Лауреатів
Лафазана вулиця	Лафазана вулиця
Лебідя вулиця	вулиця Лебідя
Левкоєва вулиця	вулиця Левкоєва
Левшиних вулиця	вулиця Левшиних
Леглич вулиця	вулиця Леглич
Леініа вулиця	вулиця Леніна
Лейзмана вулиця	вулиця Лейзмана
Лейтенанта Бараха вулиця	вулиця Лейтенанта Бараха
Лейтенанта Верхових вулиця	вулиця Лейтенанта Верхових
Лейтенанта Кібенок вулиця	вулиця Лейтенанта Кібенок
Лейтенанта Пугасія вулиця	вулиця Лейтенанта Пугасія
Лейтенантів вулиця	вулиця Лейтенантів
Лелеча вулиця	вулиця Лелеча
Ленина вулиця	вулиця Леніна
Леніга вулиця	вулиця Леніга
Леніні вулиця	вулиця Леніні
Ленківщина вулиця	вулиця Ленківщина
Ленських Подій вулиця	вулиця Ленських Подій
Лео Мола вулиця	вулиця Лео Мола
Леоні вулиця	вулиця Леоні
Леонтовіча вулиця	вулиця Леонтовіча
Лепішка вулиця	вулиця Лепішка
Леппіка вулиця	вулиця Леппіка
Лепсе вулиця	вулиця Лепсе
Леселідзе вулиця	вулиця Леселідзе
Лесная вулиця	Лісна вулиця
Лехела вулиця	вулиця Лехела
Лецовка вулиця	вулиця Лецовка
Лечин вулиця	вулиця Лечин
Лємєхової вулиця	вулиця Лємєхової
Лип’я вулиця	вулиця Липʼя
Липовиця-І вулиця	1-ша вулиця Липовиця
Листвена вулиця	Листвена вулиця
Литвиненко-Вольгемут вулиця	вулиця Литвиненко-Вольгемут
Литвяк вулиця	вулиця Литвяк
Литовка вулиця	вулиця Литовка
Лицоєва вулиця	вулиця Лицоєва
Лишеня вулиця	вулиця Лишеня
Лівий Гай вулиця	вулиця Лівий Гай
Лідіце вулиця	вулиця Лідіце
Лікаря Дедю вулиця	вулиця Лікаря Дедю
Ліквідаторів ЧАЕС вулиця	вулиця Ліквідаторів ЧАЕС
Лілаакац вулиця	вулиця Лілаакац
Лінія А вулиця	вулиця Лінія А
Лінія Б вулиця	вулиця Лінія Б
Лінія В вулиця	вулиця Лінія В
Лінія Г вулиця	вулиця Лінія Г
Лінія Залізниці вулиця	вулиця Лінія Залізниці
Ліпницької вулиця	вулиця Ліпницької
Лісгосп вулиця	вулиця Лісгосп
Лісництва вулиця	вулиця Лісництва
Лісов вулиця	вулиця Лісов
Лісові вулиця	вулиця Лісові
Лісоводів вулиця	вулиця Лісоводів
Лісок вулиця	вулиця Лісок
Лісорозсадник вулиця	вулиця Лісорозсадник
Лісорубів вулиця	вулиця Лісорубів
Літке вулиця	вулиця Літке
Літкє вулиця	вулиця Літкє
Літня вулиця	вулиця Літня
Лішинських вулиця	вулиця Лішинських
Логаша вулиця	вулиця Логаша
Логозаря вулиця	вулиця Логозаря
Логойдових вулиця	вулиця Логойдових
Лозовик вулиця	вулиця Лозовик
Лозуватка вулиця	вулиця Лозуватка
Ломана вулиця	вулиця Ломана
Ломачина вулиця	вулиця Ломачина
Ломонососа вулиця	вулиця Ломонососа
Лонка вулиця	вулиця Лонка
Лоняї вулиця	вулиця Лоняї
Лосевої вулиця	вулиця Лосевої
Лотошина вулиця	вулиця Лотошина
Лотута вулиця	вулиця Лотута
Луг вулиця	вулиця Луг
Луганка вулиця	вулиця Луганка
Лужок вулиця	вулиця Лужок
Лучиста вулиця	Лучиста вулиця
Любава вулиця	вулиця Любава
Люксембург вулиця	вулиця Люксембург
Лютневої Революції вулиця	вулиця Лютневої Революції
Лялі Убийвовк вулиця	вулиця Лялі Убийвовк
Лялі-Убийвовк вулиця	вулиця Лялі Убийвовк
Лянгуса вулиця	вулиця Лянгуса
Магнолій вулиця	вулиця Магнолій
Магура вулиця	вулиця Магура
Мазана вулиця	вулиця Мазана
Мазая вулиця	вулиця Мазая
Майдан вулиця	вулиця Майдан
Майдан Героїв вулиця	вулиця Майдан Героїв
майдан Княжий двір вулиця	вулиця Майдан Княжий Двір
Майдан УСС вулиця	вулиця Майдан УСС
Майдана вулиця	вулиця Майдана
Майзенберга вулиця	вулиця Майзенберга
Майстерюка вулиця	вулиця Майстерюка
Майстрів вугілля вулиця	вулиця Майстрів Вугілля
Майстрів вулиця	вулиця Майстрів
Макаренщина вулиця	вулиця Макаренщина
Маккош вулиця	вулиця Маккош
Маковщина вулиця	вулиця Маковщина
Макогоніва вулиця	вулиця Макогоніва
Макортет вулиця	вулиця Макортет
Мала Безкупчина вулиця	вулиця Мала Безкупчина
Мала вулиця	Мала вулиця
Мала Нараївка вулиця	вулиця Мала Нараївка
Мала Спринька вулиця	вулиця Мала Спринька
Малаєвої вулиця	вулиця Малаєвої
Мале Передмістя вулиця	вулиця Мале Передмістя
Малий Боуц вулиця	вулиця Малий Боуц
Малий Кінець вулиця	вулиця Малий Кінець
Малий кут вулиця	вулиця Малий Кут
Малий Кут вулиця	вулиця Малий Кут
Малий Куток вулиця	вулиця Малий Куток
Малий Ринок вулиця	вулиця Малий Ринок
Малишко вулиця	вулиця Малишко
Малі Кривчиці вулиця	вулиця Малі Кривчиці
Малі Лісовикі вулиця	вулиця Малі Лісовикі
Малієвських вулиця	вулиця Малієвських
Малом вулиця	вулиця Малом
Мальв вулиця	вулиця Мальв
Мамаївщина вулиця	вулиця Мамаївщина
Мамайсура вулиця	вулиця Мамайсура
Маметової вулиця	вулиця Маметової
Мамкіної вулиця	вулиця Мамкіної
Манжиєва вулиця	вулиця Манжиєва
Манюшка вулиця	вулиця Манюшка
Мар’янка вулиця	вулиця Марʼянка
Марамуреш вулиця	вулиця Марамуреш
Марапульця вулиця	вулиця Марапульця
Маргосюків вулиця	вулиця Маргосюків
Маресьєва вулиця	вулиця Маресьєва
Марінеско вулиця	вулиця Марінеско
Марко Вовчок вулиця	вулиця Марко Вовчок
Маркусів вулиця	вулиця Маркусів
Мартірок вулиця	вулиця Мартірок
Марунька вулиця	вулиця Марунька
Марфіцина вулиця	вулиця Марфіцина
Марципіль вулиця	вулиця Марципіль
Маршала Гречко вулиця	вулиця Маршала Гречко
Маршала Рибалко вулиця	вулиця Маршала Рибалко
Маршала Судця вулиця	вулиця Маршала Судця
Маршала Толубка вулиця	вулиця Маршала Толубка
Масив Новоселів вулиця	вулиця Масив Новоселів
Масив Середній вулиця	вулиця Масив Середній
Мастюка вулиця	вулиця Мастюка
Масюткіних вулиця	вулиця Масюткіних
Матійціва вулиця	вулиця Матійціва
Матлаєва вулиця	вулиця Матлаєва
Матросов вулиця	вулиця Матросов
Матяшівочка вулиця	вулиця Матяшівочка
Мауриція Ґоттлєба вулиця	вулиця Мауриція Ґоттлєба
Маханько вулиця	вулиця Маханько
Махарадзе вулиця	вулиця Махарадзе
Махинько вулиця	вулиця Махинько
Махінової вулиця	вулиця Махінової
Махно вулиця	вулиця Махно
Мацуєва вулиця	вулиця Мацуєва
Мацука вулиця	вулиця Мацука
Маширя вулиця	вулиця Маширя
Маюш вулиця	вулиця Маюш
Маяк вулиця	вулиця Маяк
Маяк Революції вулиця	вулиця Маяк Революції
Маяка вулиця	вулиця Маяка
Мегура вулиця	вулиця Мегура
Медведиця вулиця	вулиця Медведиця
Медвежа вулиця	Медвежа вулиця
Меденція вулиця	вулиця Меденція
Медніка вулиця	вулиця Медніка
Межева-сад вулиця	вулиця Межева-Сад
Межлаука вулиця	вулиця Межлаука
Мезев вулиця	вулиця Мезев
Мезевгомок вулиця	вулиця Мезевгомок
Меліоратів вулиця	вулиця Меліоратів
Меліораторів вулиця	вулиця Меліораторів
Мелітопольських Дивізій вулиця	вулиця Мелітопольських Дивізій
Меля вулиця	вулиця Меля
Менахем-Мендл Шнеєрсона вулиця	вулиця Менахем-Мендл Шнеєрсона
Мендєлєєва вулиця	вулиця Мендєлєєва
Мендуса вулиця	вулиця Мендуса
Менчів вулиця	вулиця Менчів
Менькіної вулиця	вулиця Менькіної
Мересьєва вулиця	вулиця Мересьєва
Мерзляка вулиця	вулиця Мерзляка
Меріме вулиця	вулиця Меріме
Металіста вулиця	вулиця Металіста
Металоконструкцій вулиця	вулиця Металоконструкцій
Металургів вулиця	вулиця Металургів
Метеорологічне вулиця	вулиця Метеорологічне
Мехліса вулиця	вулиця Мехліса
Мигловця вулиця	вулиця Мигловця
Мигуна вулиця	вулиця Мигуна
Мизо вулиця	вулиця Мизо
Микгород вулиця	вулиця Микгород
Микиші вулиця	вулиця Микиші
Миколаєва вулиця	вулиця Миколаєва
Миколаї Божук вулиця	вулиця Миколаї Божук
Миколаїва вулиця	вулиця Миколаїва
Миколаївка вулиця	вулиця Миколаївка
Миколія вулиця	вулиця Миколія
Мила вулиця	Мила вулиця
Милорадовичів вулиця	вулиця Милорадовичів
Миндру вулиця	вулиця Миндру
Мира вулиця	вулиця Мира
Миргородських вулиця	вулиця Миргородських
Миргородських дивізій вулиця	вулиця Миргородських Дивізій
Миру вулиця	вулиця Миру
Миру Вулиця	вулиця Миру
Мистецтв вулиця	вулиця Мистецтв
Митниця вулиця	вулиця Митниця
Митрака вулиця	вулиця Митрака
Михайлевичів вулиця	вулиця Михайлевичів
Михаця вулиця	вулиця Михаця
Мігалі вулиця	вулиця Мігалі
Мігуна вулиця	вулиця Мігуна
Міжріччя вулиця	вулиця Міжріччя
Мізюна вулиця	вулиця Мізюна
Мікеша вулиця	вулиця Мікеша
Міклея вулиця	вулиця Міклея
Мікрорайон вулиця	вулиця Мікрорайон
Мікроцентр вулиця	вулиця Мікроцентр
Міксата вулиця	вулиця Міксата
Мільнера вулиця	вулиця Мільнера
Міляшково вулиця	вулиця Міляшково
Міра вулиця	вулиця Міра
Міста Шалетт вулиця	вулиця Міста Шалетт
Містечко вулиця	вулиця Містечко
Містечок вулиця	вулиця Містечок
Місцевих Рад вулиця	вулиця Місцевих Рад
Місцепрому вулиця	вулиця Місцепрому
Міськдачі вулиця	вулиця Міськдачі
Міхлі вулиця	вулиця Міхлі
Міцкевица вулиця	вулиця Міцкевица
Міцна вулиця	Міцна вулиця
Мічурана вулиця	вулиця Мічурана
Мічурина вулиця	вулиця Мічурина
Могильчака вулиця	вулиця Могильчака
Моїсеєва вулиця	вулиця Моїсеєва
Мокра вулиця	Мокра вулиця
Мокріївка вулиця	вулиця Мокріївка
Мокрушина вулиця	вулиця Мокрушина
Молода Гвардія вулиця	вулиця Молода Гвардія
Молодих Партизан вулиця	вулиця Молодих Партизан
Молодих Патріотів вулиця	вулиця Молодих Патріотів
Молодих Шахтарів вулиця	вулиця Молодих Шахтарів
Молоді вулиця	вулиця Молоді
Молодіжка вулиця	вулиця Молодіжка
Молодої гвардії вулиця	вулиця Молодої Гвардії
Молодої Гвардії вулиця	вулиця Молодої Гвардії
Монастир вулиця	вулиця Монастир
Монастирок вулиця	вулиця Монастирок
Монтана вулиця	вулиця Монтана
Мончака вулиця	вулиця Мончака
Монюшко вулиця	вулиця Монюшко
Мопра вулиця	вулиця Мопра
МОПРа вулиця	вулиця МОПРа
Мора Йокаі вулиця	вулиця Мора Йокаі
Мордар'єва вулиця	вулиця Мордарʼєва
Москва-Донбас вулиця	вулиця Москва-Донбас
Московських студентів вулиця	вулиця Московських Студентів
Мохнюка вулиця	вулиця Мохнюка
Мочир вулиця	вулиця Мочир
Мошляка вулиця	вулиця Мошляка
Мрії вулиця	вулиця Мрії
Мрія вулиця	вулиця Мрія
МТС вулиця	вулиця МТС
Мудрьона вулиця	Мудрьона вулиця
Мукіївка вулиця	вулиця Мукіївка
Мулявка вулиця	вулиця Мулявка
Мурінсона вулиця	вулиця Мурінсона
Мухамадєєва вулиця	вулиця Мухамадєєва
Мухамедієва вулиця	вулиця Мухамедієва
МЮДа вулиця	вулиця МЮДа
Мячина вулиця	вулиця Мячина
На Копані вулиця	вулиця На Копані
На Нивах вулиця	вулиця На Нивах
На Сторожі вулиця	вулиця На Сторожі
На Таборищі вулиця	вулиця На Таборищі
На Чвертях вулиця	вулиця На Чвертях
Набивка вулиця	вулиця Набивка
Навколишня вулиця	Навколишня вулиця
Навої вулиця	вулиця Навої
Нагаївщина вулиця	вулиця Нагаївщина
Нагірних вулиця	вулиця Нагірних
Нагірянка вулиця	вулиця Нагірянка
Наголюка вулиця	вулиця Наголюка
Нагоринка верхня вулиця	вулиця Нагоринка Верхня
Нагоринка вулиця	вулиця Нагоринка
Нагорінка вулиця	вулиця Нагорінка
Нагорянка вулиця	вулиця Нагорянка
Нагрощина вулиця	вулиця Нагрощина
Над Бугом вулиця	вулиця Над Бугом
Над Гуком вулиця	вулиця Над Гуком
Над Джерелом вулиця	вулиця Над Джерелом
Над Липою вулиця	вулиця Над Липою
Над Лугом вулиця	вулиця Над Лугом
Над потоком вулиця	вулиця Над Потоком
Над Потоком вулиця	вулиця Над Потоком
Над Рудкою вулиця	вулиця Над Рудкою
Над ставом вулиця	вулиця Над Ставом
Над Ставом вулиця	вулиця Над Ставом
Над Яром вулиця	вулиця Над Яром
Надбужжя вулиця	вулиця Надбужжя
Надош вулиця	вулиця Надош
Надстав вулиця	вулиця Надстав
Надсяння вулиця	вулиця Надсяння
Надь Ердев вулиця	вулиця Надь Ердев
Надьона вулиця	вулиця Надьона
Надьсер вулиця	вулиця Надьсер
Надьтемете вулиця	вулиця Надьтемете
Надьшамутаг вулиця	вулиця Надьшамутаг
Найкраща вулиця	Найкраща вулиця
Наливайко вулиця	вулиця Наливайко
Нандора Плотені вулиця	вулиця Нандора Плотені
Нараївка вулиця	вулиця Нараївка
Нарбутів вулиця	вулиця Нарбутів
Народів вулиця	вулиця Народів
Народних Депутатів вулиця	вулиця Народних Депутатів
Народовладдя вулиця	вулиця Народовладдя
Нарцисів вулиця	вулиця Нарцисів
Нарціс вулиця	вулиця Нарціс
Наташи Малаєвої вулиця	вулиця Наташи Малаєвої
Нафтомістечко вулиця	вулиця Нафтомістечко
Нації Нескорених вулиця	вулиця Нації Нескорених
Національної Гвардії вулиця	вулиця Національної Гвардії
Наш Шлях вулиця	вулиця Наш Шлях
Невелика вулиця	Невелика вулиця
Невеличка вулиця	Невеличка вулиця
Невідомих Солдат вулиця	вулиця Невідомих Солдат
Неділина вулиця	Неділина вулиця
Недовга вулиця	Недовга вулиця
Недужка вулиця	вулиця Недужка
Нежумирі вулиця	вулиця Нежумирі
Незабудок вулиця	вулиця Незабудок
Незнайка вулиця	вулиця Незнайка
Немо вулиця	вулиця Немо
Немовлят вулиця	вулиця Немовлят
Неофіта Кибалюка вулиця	вулиця Неофіта Кибалюка
Неплюєва вулиця	вулиця Неплюєва
Несвицької вулиця	вулиця Несвицької
Нескорених вулиця	вулиця Нескорених
Нетеча вулиця	вулиця Нетеча
Нефелейч вулиця	вулиця Нефелейч
Неціла вулиця	Неціла вулиця
Нєжданової вулиця	вулиця Нєжданової
Низамі вулиця	вулиця Низамі
Никифоряка вулиця	вулиця Никифоряка
Николаївка вулиця	вулиця Николаївка
Нізамі вулиця	вулиця Нізамі
Нікіфора вулиця	вулиця Нікіфора
Нінелі Бокій вулиця	вулиця Нінелі Бокій
Нірідьсег вулиця	вулиця Нірідьсег
Нічлава вулиця	вулиця Нічлава
Нове життя вулиця	вулиця Нове Життя
Нове Життя вулиця	вулиця Нове Життя
Нове Селище вулиця	вулиця Нове Селище
Нове Село вулиця	вулиця Нове Село
Нове Шосе вулиця	вулиця Нове Шосе
Новобуд вулиця	вулиця Новобуд
Новобудов вулиця	вулиця Новобудов
Новозагородня вулиця	Новозагородня вулиця
Новозелена вулиця	Новозелена вулиця
Нової Конституції вулиця	вулиця Нової Конституції
Новоклубная вулиця	Новоклубная вулиця
Новолелів вулиця	вулиця Новолелів
Новолинника вулиця	вулиця Новолинника
Новомоспіно вулиця	вулиця Новомоспіно
Новопрокладена вулиця	Новопрокладена вулиця
Новопроложена вулиця	Новопроложена вулиця
Новоселиця вулиця	вулиця Новоселиця
Новоселищна вулиця	Новоселищна вулиця
Новоселів вулиця	вулиця Новоселів
Новоселка вулиця	вулиця Новоселка
Новоселов вулиця	вулиця Новоселов
Новосілка вулиця	вулиця Новосілка
Новосілля вулиця	вулиця Новосілля
Новоставці вулиця	вулиця Новоставці
Новостроївка вулиця	вулиця Новостроївка
Новостройка вулиця	вулиця Новостройка
Новосьолов вулиця	вулиця Новосьолов
Новрузалієва вулиця	вулиця Новрузалієва
Нодькез вулиця	вулиця Нодькез
Нодьполой вулиця	вулиця Нодьполой
Номікосових вулиця	вулиця Номікосових
Нони Погуляйло вулиця	вулиця Нони Погуляйло
Нососелів вулиця	вулиця Нососелів
Носса вулиця	вулиця Носса
Нiни Соснiної вулиця	вулиця Ніни Сосніної
Об’єднана вулиця	Обʼєднана вулиця
Об’їжджа вулиця	вулиця Обʼїжджа
Оберлі вулиця	вулиця Оберлі
Обіуха вулиця	вулиця Обіуха
Облазці вулиця	вулиця Облазці
Ободовка вулиця	вулиця Ободовка
Обозище вулиця	вулиця Обозище
Оболонь вулиця	вулиця Оболонь
Оболоня вулиця	вулиця Оболоня
Оборона вулиця	вулиця Оборона
Оборони Києва вулиця	вулиця Оборони Києва
Оборони Ленінграду вулиця	вулиця Оборони Ленінграду
Обрежа вулиця	вулиця Обрежа
Обривиста вулиця	Обривиста вулиця
Обручєва вулиця	вулиця Обручєва
Овочеводів вулиця	вулиця Овочеводів
Овочівництва вулиця	вулиця Овочівництва
Огієвських вулиця	вулиця Огієвських
Огородня вулиця	Огородня вулиця
Огрод вулиця	вулиця Огрод
Одарія вулиця	вулиця Одарія
Одностороння вулиця	Одностороння вулиця
ОДПУ вулиця	вулиця ОДПУ
Озаркевичів вулиця	вулиця Озаркевичів
Оздоровча вулиця	Оздоровча вулиця
Озеленювачів вулиця	вулиця Озеленювачів
Озера Хасан вулиця	вулиця Озера Хасан
Озерце вулиця	вулиця Озерце
Озерянка вулиця	вулиця Озерянка
Окапці вулиця	вулиця Окапці
Окрема вулиця	Окрема вулиця
Окремий Хутір вулиця	вулиця Окремий Хутір
Октября вулиця	вулиця Октября
Октябрят вулиця	вулиця Октябрят
Окунєва вулиця	вулиця Окунєва
Олегове поле вулиця	вулиця Олегове Поле
Олейнюка вулиця	вулиця Олейнюка
Олександрів вулиця	вулиця Олександрів
Олексієва вулиця	вулиця Олексієва
Омнога вулиця	вулиця Омнога
Онопрійка вулиця	вулиця Онопрійка
Онуфрієва вулиця	вулиця Онуфрієва
Онча вулиця	вулиця Онча
Операторів вулиця	вулиця Операторів
Опшар вулиця	вулиця Опшар
Орача вулиця	вулиця Орача
Орбіта вулиця	вулиця Орбіта
Орджоникідзе вулиця	вулиця Орджоникідзе
Орджонікідзе вулиця	вулиця Орджонікідзе
Оришечка вулиця	вулиця Оришечка
Оришечко вулиця	вулиця Оришечко
Орищака вулиця	вулиця Орищака
Орлина вулиця	Орлина вулиця
Орлине гніздо вулиця	вулиця Орлине Гніздо
Орлівскька вулиця	Орлівскька вулиця
Орлятко вулиця	вулиця Орлятко
Орсоглаз вулиця	вулиця Орсоглаз
Осада Червона вулиця	вулиця Осада Червона
Освітня вулиця	Освітня вулиця
Освободітєлєй вулиця	вулиця Освободітєлєй
Оседача вулиця	вулиця Оседача
Оседля вулиця	вулиця Оседля
Оселя вулиця	вулиця Оселя
Осередок вулиця	вулиця Осередок
Осипових вулиця	вулиця Осипових
Осіння вулиця	Осіння вулиця
Осіня вулиця	Осіння вулиця
Основная вулиця	Основная вулиця
Осо вулиця	вулиця Осо
ОСО вулиця	вулиця ОСО
Осоавіахіма вулиця	вулиця Осоавіахіма
Осоавіахіму вулиця	вулиця Осоавіахіму
Осовиця вулиця	вулиця Осовиця
Острів вулиця	вулиця Острів
Островчик вулиця	вулиця Островчик
Остроградських вулиця	вулиця Остроградських
Острозьково вулиця	вулиця Острозьково
Осьмухина вулиця	вулиця Осьмухина
Осьмушин Яр вулиця	вулиця Осьмушин Яр
Отамана Григор’єва вулиця	вулиця Отамана Григорʼєва
Отамана Сітка вулиця	вулиця Отамана Сітка
Отамана Шока вулиця	вулиця Отамана Шока
Откіс вулиця	вулиця Откіс
Отрадная вулиця	Отрадная вулиця
Отрок вулиця	вулиця Отрок
Оттінгера вулиця	вулиця Оттінгера
Отто Гротеваля вулиця	вулиця Отто Гротеваля
Отця Бабина вулиця	вулиця Отця Бабина
Охотьничья вулиця	Охотьничья вулиця
Очеретянка вулиця	вулиця Очеретянка
П'ятигорця вулиця	вулиця Пʼятигорця
П'ятикопа вулиця	вулиця Пʼятикопа
П'ятниці вулиця	вулиця Пʼятниці
П’єра Береговуа вулиця	вулиця Пʼєра Береговуа
П’ятидесятиріччя Жовтня вулиця	вулиця 50-річчя Жовтня
П’ятидесятниць вулиця	вулиця Пʼятидесятниць
П’ятикопа вулиця	вулиця Пʼятикопа
П’ятирічок вулиця	вулиця Пʼятирічок
П’ятисотенниць вулиця	вулиця Пʼятисотенниць
П’ятихатка вулиця	вулиця Пʼятихатка
П’ятої сотні вулиця	вулиця Пʼятої Сотні
Павлюкевичів вулиця	вулиця Павлюкевичів
Паганіні вулиця	вулиця Паганіні
Пажіт вулиця	вулиця Пажіт
Пала Терека вулиця	вулиця Пала Терека
Паланка вулиця	вулиця Паланка
Паліїв Яр вулиця	вулиця Паліїв Яр
Паліїів вулиця	вулиця Паліїів
Пальміро Тольятті вулиця	вулиця Пальміро Тольятті
Пам'яті вулиця	вулиця Памʼяті
Пам’ яті вулиця	вулиця Памʼяті
Пам’яті вулиця	вулиця Памʼяті
Пам’яті Героїв вулиця	вулиця Памʼяті Героїв
Пам’ять Героїв вулиця	вулиця Памʼять Героїв
Панкєєва вулиця	вулиця Панкєєва
Пантазьєва вулиця	вулиця Пантазьєва
Панцерника Потьомкін вулиця	вулиця Панцерника «Потьомкін»
Панянка вулиця	вулиця Панянка
Паоло Фонтані вулиця	вулиця Паоло Фонтані
Папандреу Андреуса вулиця	вулиця Папандреу Андреуса
Папірня вулиця	вулиця Папірня
Паращівця І. вулиця	вулиця І. Паращівця
Паризької комуні вулиця	вулиця Паризької Комуни
Парня вулиця	вулиця Парня
Паровоза вулиця	вулиця Паровоза
Партизан вулиця	вулиця Партизан
Партолих вулиця	вулиця Партолих
Парусовка вулиця	вулиця Парусовка
Парфановичів вулиця	вулиця Парфановичів
Парфентьєва вулиця	вулиця Парфентьєва
Пасіка вулиця	вулиця Пасіка
Пасіонарії вулиця	вулиця Пасіонарії
Пассіонарії вулиця	вулиця Пассіонарії
Пастівник вулиця	вулиця Пастівник
Пастуша вулиця	вулиця Пастуша
Патакі вулиця	вулиця Патакі
Патрієва вулиця	вулиця Патрієва
Патріотів вулиця	вулиця Патріотів
Пахарів Хутір вулиця	вулиця Пахарів Хутір
Пахолі вулиця	вулиця Пахолі
Пацаєва вулиця	вулиця Пацаєва
Пашенної вулиця	вулиця Пашенної
Паши Ангеліної вулиця	вулиця Паши Ангеліної
Паши Ангеліной вулиця	вулиця Паши Ангеліной
Пашинських вулиця	вулиця Пашинських
Пащенкових вулиця	вулиця Пащенкових
Пащиця вулиця	вулиця Пащиця
Пеєвої вулиця	вулиця Пеєвої
Пенежка вулиця	вулиця Пенежка
Пенсіонерів вулиця	вулиця Пенсіонерів
Перевіз вулиця	вулиця Перевіз
Перегорода вулиця	вулиця Перегорода
Передмістя вулиця	вулиця Передмістя
Перекоп вулиця	вулиця Перекоп
Перелета вулиця	вулиця Перелета
Перелісок вулиця	вулиця Перелісок
Перемога вулиця	вулиця Перемога
Перені вулиця	вулиця Перені
Перепечка вулиця	вулиця Перепечка
Перервана вулиця	Перервана вулиця
Пересвіта вулиця	вулиця Пересвіта
Переселення вулиця	вулиця Переселення
Перескок вулиця	вулиця Перескок
Перехід вулиця	вулиця Перехід
Перехрестя вулиця	вулиця Перехрестя
Перля вулиця	вулиця Перля
Перфильєва вулиця	вулиця Перфильєва
Перше Травня вулиця	вулиця 1 Травня
Перших коммунарів вулиця	вулиця Перших Коммунарів
Перших Космонавтів вулиця	вулиця Перших Космонавтів
Першовідкривачів вулиця	вулиця Першовідкривачів
Першотравненва вулиця	вулиця Першотравненва
Песляка вулиця	вулиця Песляка
Петефі вулиця	вулиця Петефі
Печаті вулиця	вулиця Печаті
Печенєг вулиця	вулиця Печенєг
Печера вулиця	вулиця Печера
Печиборща вулиця	вулиця Печиборща
Пешехонових вулиця	вулиця Пешехонових
Пештере вулиця	вулиця Пештере
Питомник вулиця	вулиця Питомник
Пишканя вулиця	вулиця Пишканя
Південенергобуду вулиця	вулиця Південенергобуду
Півколо вулиця	вулиця Півколо
Пігорєва вулиця	вулиця Пігорєва
Під Голоском вулиця	вулиця Під Голоском
Під Горою вулиця	вулиця Під Горою
Під Дубом вулиця	вулиця Під Дубом
Під Марковим Верхом вулиця	вулиця Під Марковим Верхом
Під Митою вулиця	вулиця Під Митою
Під Осовою вулиця	вулиця Під Осовою
Під Тисою вулиця	вулиця Під Тисою
Під Шимінкою вулиця	вулиця Під Шимінкою
Підберег вулиця	вулиця Підберег
Підбір вулиця	вулиця Підбір
Підборці вулиця	вулиця Підборці
Підваговець вулиця	вулиця Підваговець
Підвалля вулиця	вулиця Підвалля
Підвисока вулиця	Підвисока вулиця
Підгай вулиця	вулиця Підгай
Підгір'я вулиця	вулиця Підгірʼя
Підгір’я вулиця	вулиця Підгірʼя
Підгірка вулиця	вулиця Підгірка
Підгірських вулиця	вулиця Підгірських
Підгола вулиця	вулиця Підгола
Підгора вулиця	вулиця Підгора
Підгородня вулиця	Підгородня вулиця
Підгребінь вулиця	вулиця Підгребінь
Підділ вулиця	вулиця Підділ
Піддуб вулиця	вулиця Піддуб
Піддубина вулиця	Піддубина вулиця
Підзамок вулиця	вулиця Підзамок
Підзамче вулиця	вулиця Підзамче
Підкичера вулиця	вулиця Підкичера
Підкопая вулиця	вулиця Підкопая
Підлипа вулиця	вулиця Підлипа
Підлипка вулиця	вулиця Підлипка
Підліс вулиця	вулиця Підліс
Підлісок вулиця	вулиця Підлісок
Підлісом вулиця	вулиця Підлісом
Підлісся вулиця	вулиця Підлісся
Підмагура вулиця	вулиця Підмагура
Підмарика вулиця	вулиця Підмарика
Підметена вулиця	Підметена вулиця
Підмістя вулиця	вулиця Підмістя
Підмосковка вулиця	вулиця Підмосковка
Підпоповець вулиця	вулиця Підпоповець
Підреть вулиця	вулиця Підреть
Підріг вулиця	вулиця Підріг
Підріжжя вулиця	вулиця Підріжжя
Підстанція вулиця	вулиця Підстанція
Підстінка вулиця	вулиця Підстінка
Підстінок вулиця	вулиця Підстінок
Підстригача вулиця	вулиця Підстригача
Підтикана вулиця	Підтикана вулиця
Підцерква вулиця	вулиця Підцерква
Підцурків вулиця	вулиця Підцурків
Підчос вулиця	вулиця Підчос
Підшефна вулиця	Підшефна вулиця
Піззамче вулиця	вулиця Піззамче
Пікассо вулиця	вулиця Пікассо
Пілієва вулиця	вулиця Пілієва
Пілот вулиця	вулиця Пілот
Пілотів вулиця	вулиця Пілотів
Пінтя вулиця	вулиця Пінтя
Піонерів вулиця	вулиця Піонерів
Пісні вулиця	вулиця Пісні
Пісок вулиця	вулиця Пісок
Пісчана вулиця	Пісчана вулиця
Піша вулиця	Піша вулиця
Пішеля вулиця	вулиця Пішеля
Піщана вулиця	Піщана вулиця
Піщанка вулиця	вулиця Піщанка
Плав’юка вулиця	вулиця Плавʼюка
Плависта вулиця	Плависта вулиця
Плаксіївка вулиця	вулиця Плаксіївка
Пламеницьких вулиця	вулиця Пламеницьких
План вулиця	вулиця План
Пласту вулиця	вулиця Пласту
Пластунів вулиця	вулиця Пластунів
Плахоті вулиця	вулиця Плахоті
Плебанія вулиця	вулиця Плебанія
Плевана вулиця	вулиця Плевана
Плесо вулиця	вулиця Плесо
Плетінка вулиця	вулиця Плетінка
Плетянка вулиця	вулиця Плетянка
Плещєєва вулиця	вулиця Плещєєва
Плєсо вулиця	вулиця Плєсо
Плєщєєва вулиця	вулиця Плєщєєва
Плитниця вулиця	вулиця Плитниця
Плієва вулиця	вулиця Плієва
Плотинія вулиця	вулиця Плотинія
Плотиче вулиця	вулиця Плотиче
Площа Миру вулиця	вулиця Площа Миру
Площа Ринок вулиця	вулиця Площа Ринок
Плугатаря вулиця	вулиця Плугатаря
ПМК вулиця	вулиця ПМК
Побратимів вулиця	вулиця Побратимів
Побук вулиця	вулиця Побук
Повстання вулиця	вулиця Повстання
Повстянка вулиця	вулиця Повстянка
Погадаєва вулиця	вулиця Погадаєва
Погар вулиця	вулиця Погар
Погибка вулиця	вулиця Погибка
Погоріла вулиця	Погоріла вулиця
Погулянка вулиця	вулиця Погулянка
Подворанці вулиця	вулиця Подворанці
Поділ вулиця	вулиця Поділ
Поділля вулиця	вулиця Поділля
Подлесная вулиця	Подлесная вулиця
Поезії вулиця	вулиця Поезії
Покиньборода вулиця	вулиця Покиньборода
Покотило вулиця	вулиця Покотило
Поле вулиця	вулиця Поле
Полевая вулиця	Польова вулиця
Полеглих воїнів вулиця	вулиця Полеглих Воїнів
Полеглих Героїв вулиця	вулиця Полеглих Героїв
Полеглих за Революцію вулиця	вулиця Полеглих за Революцію
Полеглих Комунарів вулиця	вулиця Полеглих Комунарів
Полежаєва вулиця	вулиця Полежаєва
Полєжаєва вулиця	вулиця Полєжаєва
Полєтаєва вулиця	вулиця Полєтаєва
Полєток вулиця	вулиця Полєток
Полідовичів вулиця	вулиця Полідовичів
Полісся вулиця	вулиця Полісся
Політаєва вулиця	вулиця Політаєва
Політвідділ вулиця	вулиця Політвідділ
Політкаторжан вулиця	вулиця Політкаторжан
Полковника вулиця	вулиця Полковника
Полковника Гегечкорі вулиця	вулиця Полковника Гегечкорі
Полковника Тупіцина вулиця	вулиця Полковника Тупіцина
Полкової Сотні вулиця	вулиця Полкової Сотні
Полку Азов вулиця	вулиця Полку «Азов»
Пологая вулиця	Пологая вулиця
Поломиста вулиця	Поломиста вулиця
Полонина вулиця	вулиця Полонина
Полотнюків вулиця	вулиця Полотнюків
Полтава вулиця	вулиця Полтава
Полтарацьких вулиця	вулиця Полтарацьких
Польва вулиця	вулиця Польва
Польов вулиця	вулиця Польов
Польща вулиця	вулиця Польща
Помаранчевої революції вулиця	вулиця Помаранчевої Революції
Помаранчевої Революції вулиця	вулиця Помаранчевої Революції
Попереччина вулиця	вулиця Попереччина
Попіля вулиця	вулиця Попіля
Попопа вулиця	вулиця Попопа
Попругі вулиця	вулиця Попругі
Попугаєва вулиця	вулиця Попугаєва
Поріднених Міст вулиця	вулиця Поріднених Міст
Порт вулиця	вулиця Порт
Порт-Елеватор вулиця	вулиця Порт-Елеватор
Порумбеску вулиця	вулиця Порумбеску
Посітка вулиця	вулиця Посітка
Послушняка вулиця	вулиця Послушняка
Посполита вулиця	Посполита вулиця
Постишєва вулиця	вулиця Постишєва
Постоя вулиця	вулиця Постоя
Постріж вулиця	вулиця Постріж
Посьолок завода вулиця	вулиця Посьолок Завода
Поташня вулиця	вулиця Поташня
Потеряєва вулиця	вулиця Потеряєва
Потік вулиця	вулиця Потік
Потік Ірва вулиця	вулиця Потік Ірва
Потічок вулиця	вулиця Потічок
Потушняка вулиця	вулиця Потушняка
Похила вулиця	Похила вулиця
Почаївськеа вулиця	Почаївська вулиця
Почапці вулиця	вулиця Почапці
Почепин вулиця	вулиця Почепин
Поштарка вулиця	вулиця Поштарка
Пошукайла вулиця	вулиця Пошукайла
Праведниці Шулежко вулиця	вулиця Праведниці Шулежко
Правий Гай вулиця	вулиця Правий Гай
Прадуна вулиця	вулиця Прадуна
Прасолів вулиця	вулиця Прасолів
Праці вулиця	вулиця Праці
Працюючих вулиця	вулиця Працюючих
Пресайзена вулиця	вулиця Пресайзена
ПРЗ вулиця	вулиця ПРЗ
Прибера вулиця	вулиця Прибера
Прибій вулиця	вулиця Прибій
Пригорода вулиця	вулиця Пригорода
Пригородня вулиця	Пригородня вулиця
Прийма вулиця	вулиця Прийма
Приліпина вулиця	вулиця Приліпина
Примирення вулиця	вулиця Примирення
Принада вулиця	вулиця Принада
Присадибра вулиця	Присадибна вулиця
Присайзена вулиця	вулиця Присайзена
Пристань вулиця	вулиця Пристань
Пристін вулиця	вулиця Пристін
Приточиловка вулиця	вулиця Приточиловка
Прихозел вулиця	вулиця Прихозел
Причіл вулиця	вулиця Причіл
Прогрес вулиця	вулиця Прогрес
Прогресу вулиця	вулиця Прогресу
Продленная вулиця	Продленная вулиця
Продовольча вулиця	Продовольча вулиця
Прозора вулиця	Прозора вулиця
Проїжджа вулиця	Проїжджа вулиця
Проїзжа вулиця	Проїзжа вулиця
Прокоп'юка вулиця	вулиця Прокопʼюка
Прокоф’єва вулиця	вулиця Прокофʼєва
Пролісків вулиця	вулиця Пролісків
Пролісок вулиця	вулиця Пролісок
Промбуду вулиця	вулиця Промбуду
Промениста вулиця	Промениста вулиця
Промзона вулиця	вулиця Промзона
Промисло вулиця	вулиця Промисло
Промінь вулиця	вулиця Промінь
Промкооперації вулиця	вулиця Промкооперації
Пропускна вулиця	Пропускна вулиця
Проста вулиця	Проста вулиця
Простора вулиця	Простора вулиця
Протасів Яр вулиця	вулиця Протасів Яр
Професорів Богославських вулиця	вулиця Професорів Богославських
Профінтерну вулиця	вулиця Профінтерну
Профсоюзная вулиця	Профсоюзная вулиця
Профспілок вулиця	вулиця Профспілок
Прохладная вулиця	Прохладная вулиця
Прохоровщина вулиця	вулиця Прохоровщина
Прошака вулиця	вулиця Прошака
Прошина вулиця	вулиця Прошина
Прут вулиця	вулиця Прут
Прутня вулиця	вулиця Прутня
Пряма вулиця	Пряма вулиця
Пстрака вулиця	вулиця Пстрака
Пташина вулиця	Пташина вулиця
Птіцина вулиця	вулиця Птіцина
Пустеля вулиця?	вулиця Пустеля?
Пустовгара вулиця	вулиця Пустовгара
Путейка вулиця	вулиця Путейка
Путєва вулиця	Путєва вулиця
Путь Соціалізму вулиця	вулиця Путь Соціалізму
Пуччіні вулиця	вулиця Пуччіні
Пушкина вулиця	вулиця Пушкина
Пшеницина вулиця	вулиця Пшеницина
Пшеничка вулиця	вулиця Пшеничка
Рабоча вулиця	Рабоча вулиця
Рад вулиця	вулиця Рад
Радванка вулиця	вулиця Радванка
Радів вулиця	вулиця Радів
Радіо вулиця	вулиця Радіо
Радість вулиця	вулиця Радість
Радіус вулиця	вулиця Радіус
Раднаркому вулиця	вулиця Раднаркому
Радянських Космонавтів вулиця	вулиця Радянських Космонавтів
Раків Кут вулиця	вулиця Раків Кут
Раківщина вулиця	вулиця Раківщина
Ракоці вулиця	вулиця Ракоці
Рамішвіллі вулиця	вулиця Рамішвіллі
Рапія вулиця	вулиця Рапія
Рассвєт вулиця	вулиця Рассвєт
Растреллі вулиця	вулиця Растреллі
Рафайловець вулиця	вулиця Рафайловець
Рафтопулло вулиця	вулиця Рафтопулло
Раціоналізаторів вулиця	вулиця Раціоналізаторів
Ревазо Циклаурі вулиця	вулиця Ревазо Циклаурі
Ревейса вулиця	вулиця Ревейса
Ревен яр вулиця	вулиця Ревен Яр
Революції вулиця	вулиця Революції
Революціонерів Воробйових вулиця	вулиця Революціонерів Воробйових
Революціонерів вулиця	вулиця Революціонерів
Ревпуті вулиця	вулиця Ревпуті
Редько вулиця	вулиця Редько
Рейваха вулиця	вулиця Рейваха
Рейка вулиця	вулиця Рейка
Реконструкції вулиця	вулиця Реконструкції
Релєєва вулиця	вулиця Релєєва
Рельєфна вулиця	вулиця Рельєфна
Рено вулиця	вулиця Рено
Реца вулиця	вулиця Реца
Решетєя вулиця	вулиця Решетєя
Рєзника вулиця	вулиця Рєзника
Рєпніних вулиця	вулиця Рєпніних
Рибалко вулиця	вулиця Рибалко
Рибалок вулиця	вулиця Рибалок
Рибача вулиця	Рибача вулиця
Рибинка вулиця	вулиця Рибинка
Рибинських вулиця	вулиця Рибинських
Риворотько вулиця	вулиця Риворотько
Риклюса вулиця	вулиця Риклюса
Рилеєва вулиця	вулиця Рилеєва
Римика вулиця	вулиця Римика
Ринок вулиця	вулиця Ринок
Рислянда вулиця	вулиця Рислянда
Рит вулиця	вулиця Рит
Рихлика вулиця	вулиця Рихлика
Ричка вулиця	вулиця Ричка
Рівних прав і можливостей вулиця	вулиця Рівних Прав і Можливостей
Ріка вулиця	вулиця Ріка
Рілеєва вулиця	вулиця Рілеєва
Ріхмана вулиця	вулиця Ріхмана
Річка вулиця	вулиця Річка
Робесп’єра вулиця	вулиця Робеспʼєра
Робітниче селище вулиця	вулиця Робітниче Селище
Робоча вулиця	Робоча вулиця
Робочий вулиця	вулиця Робочий
Ровжаш вулиця	вулиця Ровжаш
Ровінь вулиця	вулиця Ровінь
Рогізно вулиця	вулиця Рогізно
Роговиця вулиця	вулиця Роговиця
Родзянко вулиця	вулиця Родзянко
Родина вулиця	вулиця Родина
Родини Алчевських вулиця	вулиця Родини Алчевських
Родини Барвінських вулиця	вулиця Родини Барвінських
Родини Білинських вулиця	вулиця Родини Білинських
Родини Бобринських вулиця	вулиця Родини Бобринських
Родини Бунґе вулиця	вулиця Родини Бунґе
Родини Глаголєвих вулиця	вулиця Родини Глаголєвих
Родини Ґеретів вулиця	вулиця Родини Ґеретів
Родини Кістяківських вулиця	вулиця Родини Кістяківських
Родини Костюків вулиця	вулиця Родини Костюків
Родини Кривоносів вулиця	вулиця Родини Кривоносів
Родини Крістерів вулиця	вулиця Родини Крістерів
Родини Крушельницьких вулиця	вулиця Родини Крушельницьких
Родини Кульчинських вулиця	вулиця Родини Кульчинських
Родини Линтварьових вулиця	вулиця Родини Линтварьових
Родини Матушевських вулиця	вулиця Родини Матушевських
Родини Мисечків вулиця	вулиця Родини Мисечків
Родини Окуневських вулиця	вулиця Родини Окуневських
Родини Рощинських вулиця	вулиця Родини Рощинських
Родини Рудинських вулиця	вулиця Родини Рудинських
Родини Старухів вулиця	вулиця Родини Старухів
Родини Сущинських вулиця	вулиця Родини Сущинських
Родини Тобілевичів вулиця	вулиця Родини Тобілевичів
Родини Трегубових вулиця	вулиця Родини Трегубових
Родини Храпливих вулиця	вулиця Родини Храпливих
Родини Цегельських вулиця	вулиця Родини Цегельських
Родини Шумовських вулиця	вулиця Родини Шумовських
Родини Юрчаків вулиця	вулиця Родини Юрчаків
Родини Юхнелів вулиця	вулиця Родини Юхнелів
Родини Янових вулиця	вулиця Родини Янових
Рожаночка вулиця	вулиця Рожаночка
Рожок вулиця	вулиця Рожок
Рожошкерт вулиця	вулиця Рожошкерт
Роз вулиця	вулиця Роз
Розвилиста вулиця	Розвилиста вулиця
Розділена вулиця	Розділена вулиця
Розенталь вулиця	вулиця Розенталь
Розкіш вулиця	вулиця Розкіш
Розкової вулиця	вулиця Розкової
Розливка вулиця	вулиця Розливка
Розлога вулиця	Розлога вулиця
Розтока Тисовець вулиця	вулиця Розтока Тисовець
Розточчя вулиця	вулиця Розточчя
Розумовських вулиця	вулиця Розумовських
Розчіл вулиця	вулиця Розчіл
Роївка вулиця	вулиця Роївка
Ройко вулиця	вулиця Ройко
Рокита вулиця	вулиця Рокита
Романківа вулиця	вулиця Романківа
Ромашків вулиця	вулиця Ромашків
Ромашко вулиця	вулиця Ромашко
Ромашок вулиця	вулиця Ромашок
Ромейка вулиця	вулиця Ромейка
Роменця вулиця	вулиця Роменця
Ропша вулиця	вулиця Ропша
Рос вулиця	вулиця Рос
Росинка вулиця	вулиця Росинка
Росиста вулиця	Росиста вулиця
Россі вулиця	вулиця Россі
Россіні вулиця	вулиця Россіні
Россоха вулиця	вулиця Россоха
Ростов вулиця	вулиця Ростов
Ростока вулиця	вулиця Ростока
Роттаг вулиця	вулиця Роттаг
Рубаника вулиця	вулиця Рубаника
Рубінгера вулиця	вулиця Рубінгера
Рудавець вулиця	вулиця Рудавець
Рудакі вулиця	вулиця Рудакі
Рудзутака вулиця	вулиця Рудзутака
Рудик вулиця	вулиця Рудик
Рудишина вулиця	вулиця Рудишина
Рудка вулиця	вулиця Рудка
Руднєєва вулиця	вулиця Руднєєва
Рудннєва вулиця	вулиця Рудннєва
Рудня вулиця	вулиця Рудня
Рудокопів вулиця	вулиця Рудокопів
Рудочка вулиця	вулиця Рудочка
Рудь вулиця	вулиця Рудь
Ружина вулиця	вулиця Ружина
Рулових вулиця	вулиця Рулових
Румара вулиця	вулиця Румара
Руня вулиця	вулиця Руня
Рурисько вулиця	вулиця Рурисько
Русових вулиця	вулиця Русових
Руставелі вулиця	вулиця Руставелі
Руставі вулиця	вулиця Руставі
Рутка вулиця	вулиця Рутка
Руфа вулиця	вулиця Руфа
Ручай вулиця	вулиця Ручай
Сабадшаг вулиця	вулиця Сабадшаг
Сабанєєв міст вулиця	вулиця Сабанєєв Міст
Сагайдачних вулиця	вулиця Сагайдачних
Садиба вулиця	вулиця Садиба
Садівництва вулиця	вулиця Садівництва
Садко вулиця	вулиця Садко
Садоводів-Хортиця вулиця	вулиця Садоводів-Хортиця
Садока Баронча вулиця	вулиця Садока Баронча
Садстанції вулиця	вулиця Садстанції
Сайко вулиця	вулиця Сайко
Сакена вулиця	вулиця Сакена
Сакко вулиця	вулиця Сакко
Сакко і Ванцетті вулиця	вулиця Сакко і Ванцетті
Самеда Вургуна вулиця	вулиця Самеда Вургуна
Саммера вулиця	вулиця Саммера
Самокіша вулиця	вулиця Самокіша
Самоткань вулиця	вулиця Самоткань
Санюка вулиця	вулиця Санюка
Саперів вулиця	вулиця Саперів
Саперне Поле вулиця	вулиця Саперне Поле
Сапіго вулиця	вулиця Сапіго
Сарапіних вулиця	вулиця Сарапіних
Сафрюка вулиця	вулиця Сафрюка
Сбежнєва вулиця	вулиця Сбежнєва
Свередюка вулиця	вулиця Свередюка
Світанку вулиця	вулиця Світанку
Світання вулиця	вулиця Світання
Світанок вулиця	вулиця Світанок
Світла вулиця	Світла вулиця
Світло Жовтня вулиця	вулиця Світло Жовтня
Світло Шахтаря вулиця	вулиця Світло Шахтаря
Свтіла вулиця	Світла вулиця
Связістов вулиця	вулиця Связістов
Святої Трійці вулиця	вулиця Святої Трійці
Северинка вулиця	вулиця Северинка
Севлевхедь вулиця	вулиця Севлевхедь
Сейделя вулиця	вулиця Сейделя
Селезінків вулиця	вулиця Селезінків
Селекціонерів вулиця	вулиця Селекціонерів
Селиця вулиця	вулиця Селиця
Селище Нове вулиця	вулиця Селище Нове
Селищна вулиця	вулиця Селищна
Село вулиця	вулиця Село
Сельських вулиця	вулиця Сельських
Сембратовичів вулиця	вулиця Сембратовичів
Семедія вулиця	вулиця Семедія
Семейка вулиця	вулиця Семейка
Семеноївка вулиця	вулиця Семеноївка
Семенюк вулиця	вулиця Семенюк
Семенюків Кут вулиця	вулиця Семенюків Кут
Семиградової вулиця	вулиця Семиградової
Семихатка вулиця	вулиця Семихатка
Сент Іштван Кіраль вулиця	вулиця Сент Іштван Кіраль
Сентмігалі вулиця	вулиця Сентмігалі
Сентфелд вулиця	вулиця Сентфелд
Сергея Лазо вулиця	вулиця Сергея Лазо
Сергіїва вулиця	вулиця Сергіїва
Серго вулиця	вулиця Серго
Серго Орджонікідзе вулиця	вулиця Серго Орджонікідзе
Сердечнюка вулиця	вулиця Сердечнюка
Середній Гай вулиця	вулиця Середній Гай
Середній Десяток вулиця	вулиця Середній Десяток
Середня вулиця	вулиця Середня
Серет вулиця	вулиця Серет
Серп і Молот вулиця	вулиця Серп і Молот
Сеспеля вулиця	вулиця Сеспеля
Сечені вулиця	вулиця Сечені
Сєвєрная вулиця	Сєвєрная вулиця
Сєднєва вулиця	вулиця Сєднєва
Сиваша вулиця	вулиця Сиваша
Сивулька вулиця	вулиця Сивулька
Сидоришина вулиця	вулиця Сидоришина
Сидоряка вулиця	вулиця Сидоряка
Сикалка вулиця	вулиця Сикалка
Силакових вулиця	вулиця Силакових
Силкіних вулиця	вулиця Силкіних
Синовця вулиця	вулиця Синовця
Синько вулиця	вулиця Синько
Синя вулиця	Синя вулиця
Сиренєва вулиця	вулиця Сиренєва
Сировця вулиця	вулиця Сировця
Сіверка вулиця	вулиця Сіверка
Сіверса вулиця	вулиця Сіверса
Сіґет вулиця	вулиця Сіґет
Сіді Таль вулиця	вулиця Сіді Таль
Сілаєва вулиця	вулиця Сілаєва
Сілваї вулиця	вулиця Сілваї
Сільваші вулиця	вулиця Сільваші
Сільвая вулиця	вулиця Сільвая
Сільгосп Технікум вулиця	вулиця Сільгосп Технікум
Сільце вулиця	вулиця Сільце
Сім'ї Розумовських вулиця	вулиця Сімʼї Розумовських
Сім'ї Сосніних вулиця	вулиця Сімʼї Сосніних
Сім’ї Дяківських вулиця	вулиця Сімʼї Дяківських
Сім’ї Ідзиковських вулиця	вулиця Сімʼї Ідзиковських
Сім’ї Кістяківських вулиця	вулиця Сімʼї Кістяківських
Сім’ї Колессів вулиця	вулиця Сімʼї Колессів
Сім’ї Красовських вулиця	вулиця Сімʼї Красовських
Сім’ї Прахових вулиця	вулиця Сімʼї Прахових
Сім’ї Розумовських вулиця	вулиця Сімʼї Розумовських
Сім’ї Сосніних вулиця	вулиця Сімʼї Сосніних
Сім’ї Хохлових вулиця	вулиця Сімʼї Хохлових
Сім’ї Шкарівських вулиця	вулиця Сімʼї Шкарівських
Сім’ї Шовкоплясів вулиця	вулиця Сімʼї Шовкоплясів
Сімʼї Бродських вулиця	вулиця Сімʼї Бродських
Сімʼї Житецьких вулиця	вулиця Сімʼї Житецьких
Сінічина вулиця	вулиця Сінічина
Сінько вулиця	вулиця Сінько
Сіра вулиця	Сіра вулиця
Сіренєва вулиця	вулиця Сіренєва
Сірко вулиця	вулиця Сірко
Сірожупанної Дивізії вулиця	вулиця Сірожупанної Дивізії
Сіропупа вулиця	вулиця Сіропупа
Січі вулиця	вулиця Січі
Скалевата вулиця	вулиця Скалевата
Скаліка вулиця	вулиця Скаліка
Сквер вулиця	вулиця Сквер
Скеляста вулиця	Скеляста вулиця
Скітник вулиця	вулиця Скітник
Скобелка вулиця	вулиця Скобелка
Скоблі вулиця	вулиця Скоблі
Скоропадських вулиця	вулиця Скоропадських
Скотаря вулиця	вулиця Скотаря
Скринько вулиця	вулиця Скринько
Скубана вулиця	вулиця Скубана
Слабенюка вулиця	вулиця Слабенюка
Слідопитів вулиця	вулиця Слідопитів
Сліпа вулиця	Сліпа вулиця
Слобідка вулиця	вулиця Слобідка
Слобода вулиця	вулиця Слобода
Слободянука вулиця	вулиця Слободянука
Слупачика вулиця	вулиця Слупачика
Слуха вулиця	вулиця Слуха
Смерічка вулиця	вулиця Смерічка
Сміла вулиця	Сміла вулиця
Сміливих вулиця	вулиця Сміливих
Смолокур вулиця	вулиця Смолокур
Смолярня вулиця	вулиця Смолярня
Снайпера вулиця	вулиця Снайпера
Снігурі вулиця	вулиця Снігурі
Снігурових вулиця	вулиця Снігурових
Собесяка вулиця	вулиця Собесяка
Соболина вулиця	вулиця Соболина
Соборнв вулиця	Соборна вулиця
Собрана вулиця	Собрана вулиця
Совєтов вулиця	вулиця Совєтов
Совхозная вулиця	Совхозная вулиця
Совхутір вулиця	вулиця Совхутір
Соколина вулиця	Соколина вулиця
Соколовських вулиця	вулиця Соколовських
Солобаєва вулиця	вулиця Солобаєва
Солов'їна вулиця	Соловʼїна вулиця
Солов‘їна вулиця	Соловʼїна вулиця
Солов’ їна вулиця	Соловʼїна вулиця
Солов’їна вулиця	Соловʼїна вулиця
Солов`їна вулиця	Соловʼїна вулиця
Соловійка вулиця	вулиця Соловійка 
Соловїна вулиця	Соловʼїна вулиця
Соловйових вулиця	вулиця Соловйових
Соловчиння вулиця	вулиця Соловчиння
Соловʼїна вулиця	Соловʼїна вулиця
Солоджука вулиця	вулиця Солоджука
Солодка вулиця	Солодка вулиця
Солом’янка вулиця	вулиця Соломʼянка
Солонці вулиця	вулиця Солонці
Сонця вулиця	вулиця Сонця
Сонячня вулиця	Сонячня вулиця
Сорокаріччя Жовтня вулиця	вулиця Сорокаріччя Жовтня
Сороханка вулиця	вулиця Сороханка
Сороча вулиця	Сороча вулиця
Сосніних вулиця	вулиця Сосніних
Сосонка вулиця	вулиця Сосонка
Сотні Спартана вулиця	вулиця Сотні Спартана
Сохора вулиця	вулиця Сохора
Соцгородок вулиця	вулиця Соцгородок
Соцмістечко вулиця	вулиця Соцмістечко
Соцпраці вулиця	вулиця Соцпраці
Союзу Українок вулиця	вулиця Союзу Українок
Спадиста вулиця	Спадиста вулиця
Спартак вулиця	вулиця Спартак
Спартана вулиця	вулиця Спартана
Спащина вулиця	вулиця Спащина
Спєшнєва вулиця	вулиця Спєшнєва
Співоча вулиця	Співоча вулиця
Співуча вулиця	Співуча вулиця
Спогадів вулиця	вулиця Спогадів
Сподівань вулиця	вулиця Сподівань
Спортмайдан вулиця	вулиця Спортмайдан
Спортсменів вулиця	вулиця Спортсменів
Спорту вулиця	вулиця Спорту
Спрейса вулиця	вулиця Спрейса
Спренжина вулиця	вулиця Спренжина
Спринька вулиця	вулиця Спринька
Спуск вулиця	вулиця Спуск
Спускна вулиця	Спускна вулиця
Сріблиста вулиця	Сріблиста вулиця
Сріблянка вулиця	вулиця Сріблянка
Срібляста вулиця	Срібляста вулиця
Став вулиця	вулиця Став
Став’янка вулиця	вулиця Ставʼянка
Ставище вулиця	вулиця Ставище
Стадіона вулиця	вулиця Стадіона
Сталеварів вулиця	вулиця Сталеварів
Станційне Селище вулиця	вулиця Станційне Селище
Станція Личаків вулиця	вулиця Станція Личаків
Старе Місто вулиця	вулиця Старе Місто
Старе Село вулиця	вулиця Старе Село
Стари Поділ вулиця	вулиця Стари Поділ
Старий Вал вулиця	вулиця Старий Вал
Старий вокзал вулиця	вулиця Старий Вокзал
Старий Куток вулиця	вулиця Старий Куток
Старий Поділ вулиця	вулиця Старий Поділ
Старий Ринок вулиця	вулиця Старий Ринок
Старий шлях вулиця	вулиця Старий Шлях
Старий Шлях вулиця	вулиця Старий Шлях
Старинці вулиця	вулиця Старинці
Старицьких вулиця	вулиця Старицьких
Стародавня вулиця	Стародавня вулиця
Старожилів вулиця	вулиця Старожилів
Старої Цегельні вулиця	вулиця Старої Цегельні
Старой село вулиця	вулиця Старой Село
Старокозармена вулиця	Старокозармена вулиця
Старокоротка вулиця	Старокоротка вулиця
Старосілля вулиця	вулиця Старосілля
Старчеуса вулиця	вулиця Старчеуса
Стасової вулиця	вулиця Стасової
Сташко вулиця	вулиця Сташко
Стеблиста вулиця	Стеблиста вулиця
Стеньгача вулиця	вулиця Стеньгача
Степанянця вулиця	вулиця Степанянця
Стефаніка вулиця	вулиця Стефаніка
Стефановичів вулиця	вулиця Стефановичів
Стефенсона вулиця	вулиця Стефенсона
Стефініних вулиця	вулиця Стефініних
Стєпная вулиця	Стєпная вулиця
Стила вулиця	вулиця Стила
Стінка вулиця	вулиця Стінка
Стожка вулиця	вулиця Стожка
Столбуна вулиця	вулиця Столбуна
Сторожниця вулиця	вулиця Сторожниця
Сторона вулиця	вулиця Сторона
Стратилата вулиця	вулиця Стратилата
Стратілана вулиця	вулиця Стратілана
Страчених вулиця	вулиця Страчених
Стрий вулиця	вулиця Стрий
Стрілка вулиця	вулиця Стрілка
Стрімка вулиця	Стрімка вулиця
Строитєля вулиця	вулиця Строитєля
Строїтелів вулиця	вулиця Строїтелів
Стройнюка вулиця	вулиця Стройнюка
Строколіса вулиця	вулиця Строколіса
Строна вулиця	вулиця Строна
Стронка вулиця	вулиця Стронка
Струве вулиця	вулиця Струве
Струглі вулиця	вулиця Струглі
Струмок вулиця	вулиця Струмок
Студена вулиця	Студена вулиця
Студенок вулиця	вулиця Студенок
Студенства вулиця	вулиця Студенства
Студентів вулиця	вулиця Студентів
Суанбаєва вулиця	вулиця Суанбаєва
Суботня вулиця	Суботня вулиця
Сугой вулиця	вулиця Сугой
Судейка вулиця	вулиця Судейка
Сумовиця вулиця	вулиця Сумовиця
Сумсько-Київських Дивізій вулиця	вулиця Сумсько-Київських Дивізій
Супутник вулиця	вулиця Супутник
Супутника вулиця	вулиця Супутника
Сурмичі вулиця	вулиця Сурмичі
Суровцевої вулиця	вулиця Суровцевої
Сусідня вулиця	Сусідня вулиця
Сутець вулиця	вулиця Сутець
Суха Воля вулиця	вулиця Суха Воля
Суха вулиця	Суха вулиця
Сухарєва вулиця	вулиця Сухарєва
Сухе-Батора вулиця	вулиця Сухе-Батора
Сухий Ізюмець вулиця	вулиця Сухий Ізюмець
Сухий Острів вулиця	вулиця Сухий Острів
Сухий Яр вулиця	вулиця Сухий Яр
Суховоля вулиця	вулиця Суховоля
Сухопілля вулиця	вулиця Сухопілля
Східно-Дальня вулиця	Східно-Дальня вулиця
Сябро вулиця	вулиця Сябро
Сяйво вулиця	вулиця Сяйво
Табла вулиця	вулиця Табла
Табукашвілі вулиця	вулиця Табукашвілі
Тадань вулиця	вулиця Тадань
Тадоровець вулиця	вулиця Тадоровець
Тайня вулиця	вулиця Тайня
Тайтек Потік вулиця	вулиця Тайтек Потік
Талалихина вулиця	вулиця Талалихина
Талічкадомб вулиця	вулиця Талічкадомб
Тамашина вулиця	вулиця Тамашина
Тампере вулиця	вулиця Тампере
Танєєва вулиця	вулиця Танєєва
Танкопія вулиця	вулиця Танкопія
Таньа вулиця	вулиця Таньа
Тарасів Шлях вулиця	вулиця Тарасів Шлях
Тарле вулиця	вулиця Тарле
Тарлє вулиця	вулиця Тарлє
Тарнавка вулиця	вулиця Тарнавка
Тарниця вулиця	вулиця Тарниця
Тарновських вулиця	вулиця Тарновських
Татарів Яр вулиця	вулиця Татарів Яр
Татарка вулиця	вулиця Татарка
Татарця вулиця	вулиця Татарця
Тацея вулиця	вулиця Тацея
Творимір вулиця	вулиця Творимір
Творча вулиця	Творча вулиця
Тевелєва вулиця	вулиця Тевелєва
Телев’яка вулиця	вулиця Телевʼяка
Телеграфна вулиця	Телеграфна вулиця
Теметев вулиця	вулиця Теметев
Темето вулиця	вулиця Темето
Темира вулиця	вулиця Темира
Темника вулиця	вулиця Темника
Темницьких вулиця	вулиця Темницьких
Темплом вулиця	вулиця Темплом
Тениста вулиця	Тениста вулиця
Тепла вулиця	Тепла вулиця
Терека вулиця	вулиця Терека
Терекшової вулиця	вулиця Терекшової
Терєшкової вулиця	вулиця Терешкової
Тернавіотів вулиця	вулиця Тернавіотів
Тернавка вулиця	вулиця Тернавка
Тернів вулиця	вулиця Тернів
Терпеливця вулиця	вулиця Терпеливця
Тєніста вулиця	Тєніста вулиця
Тєрєшкової вулиця	вулиця Терешкової
Тимирязєва вулиця	вулиця Тимирязєва
Тинка вулиця	вулиця Тинка
Тиса вулиця	вулиця Тиса
Тиха вулиця	Тиха вулиця
Тихе Життя вулиця	вулиця Тихе Життя
Тихий Кут вулиця	вулиця Тихий Кут
Тишика вулиця	вулиця Тишика
Тищика вулиця	вулиця Тищика
Тімірязєва вулиця	вулиця Тімірязєва
Тініста вулиця	Тініста вулиця
Тіноді вулиця	вулиця Тіноді
Ткачів вулиця	вулиця Ткачів
То-вар вулиця	вулиця То-вар
Тобілевічів вулиця	вулиця Тобілевічів
Товмацьке відділення вулиця	вулиця Товмацьке Відділення
Товсег вулиця	вулиця Товсег
Токаревських вулиця	вулиця Токаревських
Толбухина вулиця	вулиця Толбухина
Толді вулиця	вулиця Толді
Толочина вулиця	вулиця Толочина
Тольмаца вулиця	вулиця Тольмаца
Тольятті вулиця	вулиця Тольятті
Тонконіг вулиця	вулиця Тонконіг
Тонкочеєва вулиця	вулиця Тонкочеєва
Тонкошнура вулиця	вулиця Тонкошнура
Тополєва вулиця	вулиця Тополєва
Тополина вулиця	Тополина вулиця
Тополина Вулиця	Тополина вулиця
Топчиєва вулиця	вулиця Топчиєва
Торговиця вулиця	вулиця Торговиця
Трависта вулиця	Трависта вулиця
Трандафірілор вулиця	вулиця Трандафірілор
Транспортне шосе вулиця	вулиця Транспортне Шосе
Трачів вулиця	вулиця Трачів
Траян вулиця	вулиця Траян
Трембовецької вулиця	вулиця Трембовецької
Тригубенкових вулиця	вулиця Тригубенкових
Тридуба вулиця	вулиця Тридуба
Трінклера вулиця	вулиця Трінклера
Тростянець вулиця	вулиця Тростянець
Тростянка вулиця	вулиця Тростянка
Трохименкове вулиця	вулиця Трохименкове
Троянд вулиця	вулиця Троянд
Троянда вулиця	вулиця Троянда
Трубіцина вулиця	вулиця Трубіцина
Трублаїні вулиця	вулиця Трублаїні
Труда вулиця	вулиця Труда
Трударів вулиця	вулиця Трударів
Трудових резервів вулиця	вулиця Трудових Резервів
Трудових Резервів вулиця	вулиця Трудових Резервів
Трудової Алеї вулиця	вулиця Трудової Алеї
Труженіков вулиця	вулиця Труженіков
Трутка вулиця	вулиця Трутка
Труфанка вулиця	вулиця Труфанка
Труховської-Ванеєвої вулиця	вулиця Труховської-Ванеєвої
Трьох Космонавтів вулиця	вулиця Трьох Космонавтів
Туєва вулиця	вулиця Туєва
Тулянка вулиця	вулиця Тулянка
Тупа вулиця	Тупа вулиця
Тупик вулиця	вулиця Тупик
Тур’є Горішнє вулиця	вулиця Турʼє Горішнє
Тургєнєва вулиця	вулиця Тургєнєва
Туриха вулиця	вулиця Туриха
Турковичі вулиця	вулиця Турковичі
Турової вулиця	вулиця Турової
Туровца вулиця	вулиця Туровца
Турція вулиця	вулиця Турція
Тюменцева-Хвилі вулиця	вулиця Тюменцева-Хвилі
Ударник вулиця	вулиця Ударник
Ударника вулиця	вулиця Ударника
Узвіз вулиця	вулиця Узвіз
Уй вулиця	вулиця Уй
Уйварі вулиця	вулиця Уйварі
Уйшор вулиця	вулиця Уйшор
Українка вулиця	вулиця Українка
Українських воїнів вулиця	вулиця Українських Воїнів
Українських Героїв вулиця	вулиця Українських Героїв
Українських Захисниць вулиця	вулиця Українських Захисниць
Українських Космонавтів вулиця	вулиця Українських Космонавтів
Українських партизан вулиця	вулиця Українських Партизан
Українських Перемог вулиця	вулиця Українських Перемог
Українських соколів вулиця	вулиця Українських Соколів
Улан-Батора вулиця	вулиця Улан-Батора
Уличнянка вулиця	вулиця Уличнянка
Ульбріхта вулиця	вулиця Ульбріхта
Ульянових вулиця	вулиця Ульянових
Умивальня вулиця	вулиця Умивальня
Умникової вулиця	вулиця Умникової
УНР вулиця	вулиця УНР
Уншліхта вулиця	вулиця Уншліхта
Унявко вулиця	вулиця Унявко
УПА вулиця	вулиця УПА
Упіта вулиця	вулиця Упіта
Урбайліса вулиця	вулиця Урбайліса
Урочиста вулиця	Урочиста вулиця
Урочище За Заволом вулиця	вулиця Урочище За Заволом
Урочище іподром вулиця	вулиця Урочище Іподром
Урочище Святе вулиця	вулиця Урочище Святе
Урочище ферма вулиця	вулиця Урочище Ферма
Успенських вулиця	вулиця Успенських
Устияновичів вулиця	вулиця Устияновичів
учбове містечко ХНАУ вулиця	вулиця Учбове Містечко ХНАУ
Училищна вулиця	Училищна вулиця
Уютная вулиця	Уютная вулиця
Фаберже вулиця	вулиця Фаберже
Фабриціуса вулиця	вулиця Фабриціуса
Фабріціуса вулиця	вулиця Фабріціуса
Фадеєва вулиця	вулиця Фадеєва
Февут вулиця	вулиця Февут
Федорці вулиця	вулиця Федорці
Федько вулиця	вулиця Федько
Феєш вулиця	вулиця Феєш
Фелвег вулиця	вулиця Фелвег
Фелшо Мікефалва вулиця	вулиця Фелшо Мікефалва
Фені Мотильової вулиця	вулиця Фені Мотильової
Феньвеш вулиця	вулиця Феньвеш
Ферсмана вулиця	вулиця Ферсмана
Филона Джалалія вулиця	вулиця Филона Джалалія
Фігнера вулиця	вулиця Фігнера
Фігура вулиця	вулиця Фігура
Фікселя вулиця	вулиця Фікселя
Філіпських вулиця	вулиця Філіпських
Фінляндія вулиця	вулиця Фінляндія
Фіньов вулиця	вулиця Фіньов
Фісака вулиця	вулиця Фісака
Флоренції вулиця	вулиця Флоренції
Фогодо вулиця	вулиця Фогодо
Фогороші вулиця	вулиця Фогороші
Фоміних вулиця	вулиця Фоміних
Фонтене-су-Буа вулиця	вулиця Фонтене-су-Буа
Форраш вулиця	вулиця Форраш
Фотієвої вулиця	вулиця Фотієвої
Франко вулиця	вулиця Франко
Фрітаун вулиця	вулиця Фрітаун
Фролич вулиця	вулиця Фролич
Фруктових садів вулиця	вулиця Фруктових Садів
Фрунзе вулиця	вулиця Фрунзе
Фуко вулиця	вулиця Фуко
Фуріка вулиця	вулиця Фуріка
Фучіка вулиця	вулиця Фучіка
Фюзеш вулиця	вулиця Фюзеш
Фюрде вулиця	вулиця Фюрде
Хабаря вулиця	вулиця Хабаря
Хаврука вулиця	вулиця Хаврука
Халаменюка вулиця	вулиця Халаменюка
Халтурина вулиця	вулиця Халтурина
Хамбіра вулиця	вулиця Хамбіра
Хамковиця вулиця	вулиця Хамковиця
Хані вулиця	вулиця Хані
Харазії вулиця	вулиця Харазії
Харківських Дивізій вулиця	вулиця Харківських Дивізій
Харківця вулиця	вулиця Харківця
Харлампієва вулиця	вулиця Харлампієва
Харпака вулиця	вулиця Харпака
Хаткіної вулиця	вулиця Хаткіної
Хатрі вулиця	вулиця Хатрі
Хатхаз вулиця	вулиця Хатхаз
Хащ вулиця	вулиця Хащ
Хвилі Олентиря вулиця	вулиця Хвилі Олентиря
Хвиляста вулиця	Хвиляста вулиця
Хвої вулиця	вулиця Хвої
Хедь вулиця	вулиця Хедь
Химка вулиця	вулиця Химка
Химушина вулиця	вулиця Химушина
Хирів вулиця	вулиця Хирів
Хичія вулиця	вулиця Хичія
Хіміків вулиця	вулиця Хіміків
Хітєєва вулиця	вулиця Хітєєва
Хлібороб вулиця	вулиця Хлібороб
Хлібороба вулиця	вулиця Хлібороба
Хліборобів вулиця	вулиця Хліборобів
Хлопуші вулиця	вулиця Хлопуші
Хмелинець вулиця	вулиця Хмелинець
Хмельницьке шосе вулиця	вулиця Хмельницьке Шосе
Хміль вулиця	вулиця Хміль
Ходарєва вулиця	вулиця Ходарєва
Холмиста вулиця	Холмиста вулиця
Хоптяра вулиця	вулиця Хоптяра
Хоробрих вулиця	вулиця Хоробрих
Хорової Капели Боян вулиця	вулиця Хорової Капели Боян
Хохтів вулиця	вулиця Хохтів
Хохтіф вулиця	вулиця Хохтіф
Храпая вулиця	вулиця Храпая
Хрещата вулиця	Хрещата вулиця
Хрещатик вулиця	вулиця Хрещатик
Хризантем вулиця	вулиця Хризантем
Христина вулиця	вулиця Христина
Христо Ботєва вулиця	вулиця Христо Ботєва
Христо-Ботіво вулиця	вулиця Христо-Ботіво
ХТЗ вулиця	вулиця ХТЗ
Хутір вулиця	вулиця Хутір
хутір Горгулі вулиця	вулиця Хутір Горгулі
Хутір Комінтерн вулиця	вулиця Хутір Комінтерн
хутір Мідне вулиця	вулиця Хутір Мідне
Хутір Під Лісом вулиця	вулиця Хутір Під Лісом
Хутір Тарнава вулиця	вулиця Хутір Тарнава
Хутір Тернава вулиця	вулиця Хутір Тернава
Хутір Транспорт вулиця	вулиця Хутір Транспорт
Хуторище вулиця	вулиця Хуторище
Хуторок вулиця	вулиця Хуторок
Хущовка вулиця	вулиця Хущовка
ХХ Партз’їзда вулиця	вулиця ХХ Партзʼїзду
ХХІ Партз'їзду вулиця	вулиця ХХІ Партзʼїзду
Цадика вулиця	вулиця Цадика
Царицина вулиця	вулиця Царицина
Цвітаєва вулиця	вулиця Цвітаєва
Цвяньковець вулиця	вулиця Цвяньковець
Цеглянка вулиця	вулиця Цеглянка
Целіш вулиця	вулиця Целіш
Цендрівських вулиця	вулиця Цендрівських
Центр вулиця	вулиця Центр
Центральня вулиця	Центральня вулиця
Ценцарівщина вулиця	вулиця Ценцарівщина
Цепреуза вулиця	вулиця Цепреуза
Церетелі вулиця	вулиця Церетелі
Цертія вулиця	вулиця Цертія
Цеткін вулиця	вулиця Цеткін
Цибулько вулиця	вулиця Цибулько
Цимбалиста вулиця	Цимбалиста вулиця
Цимбалів Яр вулиця	вулиця Цимбалів Яр
ЦНС вулиця	вулиця ЦНС
ЦТР вулиця	вулиця ЦТР
Цукрозавод вулиця	вулиця Цукрозавод
Цукрозаводу вулиця	вулиця Цукрозаводу
Цулукидзе вулиця	вулиця Цулукидзе
Чадунелі вулиця	вулиця Чадунелі
Чайка вулиця	вулиця Чайка
Чайкіної вулиця	вулиця Чайкіної
Чайкіной вулиця	вулиця Чайкіной
Чалаплюка вулиця	вулиця Чалаплюка
Чалдаєва вулиця	вулиця Чалдаєва
Чанчибадзе вулиця	вулиця Чанчибадзе
Чапаєвка вулиця	вулиця Чапаєвка
Чапраєва вулиця	вулиця Чапраєва
Частника вулиця	вулиця Частника
Чебанця вулиця	вулиця Чебанця
Чекалових вулиця	вулиця Чекалових
Чекаля вулиця	вулиця Чекаля
Чекіста вулиця	вулиця Чекіста
Чекістів-Гайно вулиця	вулиця Чекістів-Гайно
Челебі Джихана вулиця	вулиця Челебі Джихана
Челпана вулиця	вулиця Челпана
Челюскина вулиця	вулиця Челюскина
Челюскинцев вулиця	вулиця Челюскинцев
Челюскінцев вулиця	вулиця Челюскінцев
Чемпіонів вулиця	вулиця Чемпіонів
Ченцових вулиця	вулиця Ченцових
Чепаш вулиця	вулиця Чепаш
Червениця вулиця	вулиця Червениця
Червона Алея вулиця	вулиця Червона Алея
Червона вулиця	Червона вулиця
Червона гірка вулиця	вулиця Червона Гірка
Червона Гірка вулиця	вулиця Червона Гірка
Червона гора вулиця	вулиця Червона Гора
Червона Гребля вулиця	вулиця Червона Гребля
Червона долина вулиця	вулиця Червона Долина
Червона Зірка вулиця	вулиця Червона Зірка
Червона Зоря вулиця	вулиця Червона Зоря
Червона Рута вулиця	вулиця Червона Рута
Червона Січ вулиця	вулиця Червона Січ
Червона Слобода вулиця	вулиця Червона Слобода
Червоне Селище вулиця	вулиця Червоне Селище
Червоних Зорь вулиця	вулиця Червоних Зорь
Червоних Командирів вулиця	вулиця Червоних Командирів
Червоних Курсантів вулиця	вулиця Червоних Курсантів
Червоних партизан вулиця	вулиця Червоних Партизан
Червоних Партизан вулиця	вулиця Червоних Партизан
Червоних Пілотів вулиця	вулиця Червоних Пілотів
Червоних Робітниць вулиця	вулиця Червоних Робітниць
Червоних Слідопитів вулиця	вулиця Червоних Слідопитів
Червоних Старшин вулиця	вулиця Червоних Старшин
Червоних Троянд вулиця	вулиця Червоних Троянд
Червонія вулиця	вулиця Червонія
Червонокозача вулиця	Червонокозача вулиця
Червоноселищна вулиця	Червоноселищна вулиця
Череднюка вулиця	вулиця Череднюка
Черемоша вулиця	вулиця Черемоша
Черепвивдь вулиця	вулиця Черепвивдь
Черлінка вулиця	вулиця Черлінка
Чернеча вулиця	Чернеча вулиця
Чернещина вулиця	вулиця Чернещина
Черницина вулиця	вулиця Черницина
Черничко вулиця	вулиця Черничко
Чернігівсьна вулиця	Чернігівська вулиця
Чернопятка вулиця	вулиця Чернопятка
Чертежик вулиця	вулиця Чертежик
Чертіж вулиця	вулиця Чертіж
Чесака вулиця	вулиця Чесака
Чечеловка вулиця	вулиця Чечеловка
Чибінєєва вулиця	вулиця Чибінєєва
Чигор вулиця	вулиця Чигор
Чижевських вулиця	вулиця Чижевських
Чикериса вулиця	вулиця Чикериса
Чирганка вулиця	вулиця Чирганка
Чиста вулиця	Чиста вулиця
Чистопілля вулиця	вулиця Чистопілля
Читачів вулиця	вулиця Читачів
Чичиклія вулиця	вулиця Чичиклія
Чігосуг вулиця	вулиця Чігосуг
Чікош Керт вулиця	вулиця Чікош Керт
Чіпі вулиця	вулиця Чіпі
Чкалову вулиця	вулиця Чкалову
Чоботаря вулиця	вулиця Чоботаря
Чоботька вулиця	вулиця Чоботька
Чолнокі вулиця	вулиця Чолнокі
Чонкаш вулиця	вулиця Чонкаш
Чорнобаївка вулиця	вулиця Чорнобаївка
Чорновіла вулиця	вулиця Чорновіла
Чорноп’ятка вулиця	вулиця Чорнопʼятка
Чороновола вулиця	вулиця Чороновола
Чорторийських вулиця	вулиця Чорторийських
Чпаєва вулиця	вулиця Чпаєва
Чрновола вулиця	вулиця Чрновола
Чубінідзе вулиця	вулиця Чубінідзе
Чубчика вулиця	вулиця Чубчика
Чугаєва вулиця	вулиця Чугаєва
Чугайстра вулиця	вулиця Чугайстра
Чуляка вулиця	вулиця Чуляка
Чумацтва вулиця	вулиця Чумацтва
Чупрея вулиця	вулиця Чупрея
Чурай вулиця	вулиця Чурай
Чутовка вулиця	вулиця Чутовка
Чхаїдзе вулиця	вулиця Чхаїдзе
Шаврина вулиця	вулиця Шаврина
Шагая вулиця	вулиця Шагая
Шайба вулиця	вулиця Шайба
Шакала вулиця	вулиця Шакала
Шаму Цабана вулиця	вулиця Шаму Цабана
Шанковських вулиця	вулиця Шанковських
Шанцера вулиця	вулиця Шанцера
Шапка вулиця	вулиця Шапка
Шарабана вулиця	вулиця Шарабана
Шарі Федак вулиця	вулиця Шарі Федак
Шаркуна вулиця	вулиця Шаркуна
Шахна вулиця	вулиця Шахна
Шахово вулиця	вулиця Шахово
Шахтарів вулиця	вулиця Шахтарів
Шахтарів Донбасу вулиця	вулиця Шахтарів Донбасу
Шахтаря вулиця	вулиця Шахтаря
Шахтостроитєлєй вулиця	вулиця Шахтостроитєлєй
Шваленберга вулиця	вулиця Шваленберга
Шевчена вулиця	вулиця Шевчена
Шелепаєва вулиця	вулиця Шелепаєва
Шенгелія вулиця	вулиця Шенгелія
Шептицьких вулиця	вулиця Шептицьких
Шерегія вулиця	вулиця Шерегія
Шереметка вулиця	вулиця Шереметка
Шеші вулиця	вулиця Шеші
Шиблеї вулиця	вулиця Шиблеї
Шилінгера вулиця	вулиця Шилінгера
Ширван-Заде вулиця	вулиця Ширван-Заде
Широка вулиця	Широка вулиця
Широка площа вулиця	вулиця Широка Площа
Широке вулиця	вулиця Широке
Шитів Потік вулиця	вулиця Шитів Потік
Шімзерів вулиця	вулиця Шімзерів
Шімона Голлоші вулиця	вулиця Шімона Голлоші
Шімона Меньгерта вулиця	вулиця Шімона Меньгерта
Шкрібляків вулиця	вулиця Шкрібляків
Шкуматових вулиця	вулиця Шкуматових
Шкурко вулиця	вулиця Шкурко
Шлюз вулиця	вулиця Шлюз
Шлямара вулиця	вулиця Шлямара
Шлях вулиця	вулиця Шлях
Шлях до Комунізму вулиця	вулиця Шлях до Комунізму
Шляхотчина Долина вулиця	вулиця Шляхотчина Долина
Шляхта вулиця	вулиця Шляхта
Шмiдта вулиця	вулиця Шмідта
Шнеєрсона вулиця	вулиця Шнеєрсона
Шовгениха вулиця	вулиця Шовгениха
Шовковиць вулиця	вулиця Шовковиць
Шовкостанція вулиця	вулиця Шовкостанція
Шорса вулиця	вулиця Шорса
Шосселя вулиця	вулиця Шосселя
Шостопарк вулиця	вулиця Шостопарк
Шпіндяка вулиця	вулиця Шпіндяка
Шпудейка вулиця	вулиця Шпудейка
Штефаника вулиця	вулиця Штефаника
Штронд вулиця	вулиця Штронд
Шугар вулиця	вулиця Шугар
Шуліко вулиця	вулиця Шуліко
Шульгіних вулиця	вулиця Шульгіних
Шумейко вулиця	вулиця Шумейко
Шумлявщина вулиця	вулиця Шумлявщина
Шумлянських вулиця	вулиця Шумлянських
Шунделевих вулиця	вулиця Шунделевих
Шутуство вулиця	вулиця Шутуство
Шутько вулиця	вулиця Шутько
Шухевичів вулиця	вулиця Шухевичів
Щастя вулиця	вулиця Щастя
Щебетунів вулиця	вулиця Щебетунів
Щедра вулиця	Щедра вулиця
Щербініних вулиця	вулиця Щербініних
Щєрбака вулиця	вулиця Щєрбака
Щимель вулиця	вулиця Щимель
Южина вулиця	вулиця Южина
Юзикевичів вулиця	вулиця Юзикевичів
Юність вулиця	вулиця Юність
Юннатів вулиця	вулиця Юннатів
Юона вулиця	вулиця Юона
Юр’єва вулиця	вулиця Юрʼєва
Юрдига вулиця	вулиця Юрдига
Юрдика вулиця	вулиця Юрдика
Юрковиця вулиця	вулиця Юрковиця
Юрчинських вулиця	вулиця Юрчинських
Юстиції вулиця	вулиця Юстиції
Юхимука вулиця	вулиця Юхимука
Яблонєвая вулиця	Яблонєвая вулиця
Яблочкіної вулиця	вулиця Яблочкіної
Яблуново вулиця	вулиця Яблуново
Яворів вулиця	вулиця Яворів
Яківчика вулиця	вулиця Яківчика
Якіра вулиця	вулиця Якіра
Ялинка вулиця	вулиця Ялинка
Яловець вулиця	вулиця Яловець
Яндюків вулиця	вулиця Яндюків
Яноніса вулиця	вулиця Яноніса
Яр вулиця	вулиця Яр
Яржина вулиця	вулиця Яржина
Ярі вулиця	вулиця Ярі
Ярмошука вулиця	вулиця Ярмошука
Ярмуша вулиця	вулиця Ярмуша
Яровиця вулиця	вулиця Яровиця
Ярославів Вал вулиця	вулиця Ярославів Вал
Ярошка вулиця	вулиця Ярошка
Яршиця вулиця	вулиця Яршиця
Ясеничче вулиця	вулиця Ясеничче
Ясенів вулиця	вулиця Ясенів
Яскрава вулиця	Яскрава вулиця
Ятрань вулиця	вулиця Ятрань
Яцьківа вулиця	вулиця Яцьківа
Bohuna вулиця	вулиця Богуна
Cвітла вулиця	Світла вулиця
Cемена Гризла вулиця	вулиця Семена Гризла
I Лиман вулиця	вулиця I Лиман
II Лиман вулиця	вулиця II Лиман
III Інтернаціоналу вулиця	вулиця III Інтернаціоналу
III Лиман вулиця	вулиця III Лиман
Kам'яниста вулиця	Камʼяниста вулиця
Kocмонавтів вулиця	вулиця Космонавтів
VI з’їзд Рад вулиця	вулиця VI Зʼїзду Рад
VII З’їзду Рад вулиця	вулиця VII Зʼїзду Рад
VIII з’їзду Рад вулиця	вулиця VIII Зʼїзду Рад
XIX Партз’їзду вулиця	вулиця XIX Партзʼїзду
XX Партз’їзду вулиця	вулиця XX Партзʼїзду
XXI З’їзду КПРС вулиця	вулиця XXI Зʼїзду КПРС
XXII з’їзду КПРС вулиця	вулиця XXII Зʼїзду КПРС
XXII Партз’їзду вулиця	вулиця XXII Партзʼїзду
XXIII Партз'їзду вулиця	вулиця XXIII Партзʼїзду
XXIV з’їзду КПРС вулиця	вулиця XXIV Зʼїзду КПРС
XXIV Партз’їзду вулиця	вулиця XXIV Партзʼїзду
XXV з'їзду КПРС вулиця	вулиця XXV Зʼїзду КПРС
XXV партз’їзду вулиця	вулиця XXV Партзʼїзду
XXVII Партз’їзду вулиця	вулиця XXVII Партзʼїзду