Авангардна вулиця	Авангардна вулиця
Авангардний провулок	Авангардний провулок
Автострадна вулиця	Автострадна вулиця
Автострадний провулок	Автострадний провулок
Акордна вулиця	Акордна вулиця
Антарктидна вулиця	Антарктидна вулиця
Барикадна вулиця	Барикадна вулиця
Барикадний провулок	Барикадний провулок
Безводна вулиця	Безводна вулиця
Бригадна вулиця	Бригадна вулиця
Бригадний в’їзд	Бригадний вʼїзд
Бригадний двір вулиця	вулиця Бригадний Двір
Бригадний провулок	Бригадний провулок
Бригадний проїзд	Бригадний проїзд
В'їздна вулиця	Вʼїздна вулиця
Видна вулиця	Видна вулиця
Виїздна вулиця	Виїздна вулиця
Винахідна вулиця	Винахідна вулиця
Виноградна вулиця	Виноградна вулиця
Виноградна долина	Виноградна долина
Виноградна улиця	Виноградна улиця
Виноградний провулок	Виноградний провулок
Виноградний проїзд	Виноградний проїзд
Відвідний провулок	Відвідний провулок
Відрадна вулиця	Відрадна вулиця
Відрадний провулок	Відрадний провулок
Відрадний проспект	Відрадний проспект
Віноградна вулиця	Віноградна вулиця
Водна вулиця	Водна вулиця
Водний провулок	Водний провулок
Водобудний провулок	Водобудний провулок
Водоводна вулиця	Водоводна вулиця
Водопровідна вулиця	Водопровідна вулиця
Водопровідний провулок	Водопровідний провулок
Водоспадний провулок	Водоспадний провулок
Всенародна вулиця	Всенародна вулиця
Газопровідна вулиця	Газопровідна вулиця
Газопровідний провулок	Газопровідний провулок
Газопровідний тупик	Газопровідний тупик
Гвоздний провулок	Гвоздний провулок
Гірничорудна вулиця	Гірничорудна вулиця
Гірничорудний провулок	Гірничорудний провулок
Горнорудна вулиця	Горнорудна вулиця
Городна вулиця	Городна вулиця
Городний провулок	Городний провулок
Градний Узвіз вулиця	вулиця Градний Узвіз
Далекосхідна вулиця	Далекосхідна вулиця
Далекосхідний провулок	Далекосхідний провулок
Двохрядна вулиця	Двохрядна вулиця
Дерев'яий пішохідний місток	Деревʼяий пішохідний місток
Дніпрорудний провулок	Дніпрорудний провулок
Довгопрудна вулиця	Довгопрудна вулиця
Досвідний провулок	Досвідний провулок
Дослідна вулиця	Дослідна вулиця
Дослідна станція вулиця	вулиця Дослідна Станція
Дослідний провулок	Дослідний провулок
Еспланадна вулиця	Еспланадна вулиця
Естакадна вулиця	Естакадна вулиця
Естакадний в’їзд	Естакадний вʼїзд
Етюдна вулиця	Етюдна вулиця
Забрідний перевулок	Забрідний перевулок
Загородна вулиця	Загородна вулиця
Загородний провулок	Загородний провулок
Залізорудна вулиця	Залізорудна вулиця
Западна вулиця	Западна вулиця
Западний провулок	Западний провулок
Заповідна вулиця	Заповідна вулиця
Заповідний провулок	Заповідний провулок
Запрудна вулиця	Запрудна вулиця
Запрудний провулок	Запрудний провулок
Західна алея	Західна алея
Західна вулиця	Західна вулиця
Західний в'їзд	Західний вʼїзд
Західний Вентилятор вулиця	вулиця Західний Вентилятор
Західний міст	Західний міст
Західний провулок	Західний провулок
Західний проїзд	Західний проїзд
Західний Проїзд вулиця	вулиця Західний Проїзд
Західний проспект	Західний проспект
Західний Спуск	Західний спуск
Західний тупик	Західний тупик
Звьоздна вулиця	Звьоздна вулиця
Землевпорядна вулиця	Землевпорядна вулиця
Зорепадна вулиця	Зорепадна вулиця
Ізумрудна вулиця	Ізумрудна вулиця
Інвалідна вулиця	Інвалідна вулиця
Інвалідний провулок	Інвалідний провулок
Карбідна вулиця	Карбідна вулиця
Карборудна вулиця	Карборудна вулиця
Каскадна вулиця	Каскадна вулиця
Кислородна вулиця	Кислородна вулиця
Краєвидна вулиця	Краєвидна вулиця
Краєвидний провулок	Краєвидний провулок
Краснопрудний провулок	Краснопрудний провулок
Криворудна вулиця	Криворудна вулиця
Криворудний провулок	Криворудний провулок
Лагідна вулиця	Лагідна вулиця
Листопадна вулиця	Листопадна вулиця
Листопадний провулок	Листопадний провулок
Лісоводна вулиця	Лісоводна вулиця
Лісодослідна вулиця	Лісодослідна вулиця
Миловидна вулиця	Миловидна вулиця
Мідна вулиця	Мідна вулиця
Мідний провулок	Мідний провулок
Морехідна вулиця	Морехідна вулиця
Морехідний провулок	Морехідний провулок
Надпрудна вулиця	Надпрудна вулиця
Народна вулиця	Народна вулиця
Народна площа	Народна площа
Народний в’їзд	Народний вʼїзд
Народний провулок	Народний провулок
Нарядна вулиця	Нарядна вулиця
Нерудна вулиця	Нерудна вулиця
Нерудний провулок	Нерудний провулок
Нерудний тупик	Нерудний тупик
Новонародний провулок	Новонародний провулок
Новопрудна вулиця	Новопрудна вулиця
Новосхідна вулиця	Новосхідна вулиця
Новосхідний провулок	Новосхідний провулок
Об'їздна вулиця	Обʼїздна вулиця
Об'їздна дорога	Обʼїздна дорога
Об'їзна Західна вулиця	Обʼїзна Західна вулиця
Об'їзна Східна вулиця	Обʼїзна Східна вулиця
Об’ їздна вулиця	Обʼїздна вулиця
Об’їздна вулиця	Обʼїздна вулиця
Об’їздна друга вулиця	2-га Обʼїздна вулиця
Об’їздна перша вулиця	1-ша Обʼїздна вулиця
Об’їздна третя вулиця	3-тя Обʼїздна вулиця
Об’їздна четверта вулиця	4-та Обʼїздна вулиця
Об’їздний провулок	Обʼїздний провулок
Обвідна вулиця	Обвідна вулиця
Обїздна вулиця	Обʼїздна вулиця
Обхідна вулиця	Обхідна вулиця
Обхідний провулок	Обхідний провулок
Обʼїздна вулиця	Обʼїздна вулиця
Огородна вулиця	Огородна вулиця
Огородний провулок	Огородний провулок
Оградний провулок	Оградний провулок
Однорядна вулиця	Однорядна вулиця
Орендний провулок	Орендний провулок
Отрадна вулиця	Отрадна вулиця
Отрадний провулок	Отрадний провулок
Ощадна вулиця	Ощадна вулиця
Палісадна вулиця	Палісадна вулиця
Парадна вулиця	Парадна вулиця
Парадний провулок	Парадний провулок
Пароходна вулиця	Пароходна вулиця
Переїздна вулиця	Переїздна вулиця
Переїздний провулок	Переїздний провулок
Перехідна вулиця	Перехідна вулиця
Перехідний провулок	Перехідний провулок
Південно-Західна вулиця	Південно-Західна вулиця
Південно-Східна вулиця	Південно-Східна вулиця
Північно-Західна вулиця	Північно-Західна вулиця
Північно-Східна вулиця	Північно-Східна вулиця
Північно-Східний провулок	Північно-Східний провулок
Під’їздна вулиця	Підʼїздна вулиця
Підвиноградна вулиця	Підвиноградна вулиця
Пішохідний провулок	Пішохідний провулок
Пішоходний міст	Пішоходний міст
Плідна вулиця	Плідна вулиця
Плідний провулок	Плідний провулок
Погідна вулиця	Погідна вулиця
Породна вулиця	Породна вулиця
Пригородна вулиця	Пригородна вулиця
Пригородний провулок	Пригородний провулок
Приладний провулок	Приладний провулок
Природна вулиця	Природна вулиця
Проїздна вулиця	Проїздна вулиця
Проїздний провулок	Проїздний провулок
Прохідна вулиця	Прохідна вулиця
Прохідний провулок	Прохідний провулок
Прохідний Тупик вулиця	вулиця Прохідний Тупик
Прохладна вулиця	Прохладна вулиця
Прохолодна вулиця	Прохолодна вулиця
Прохолодний провулок	Прохолодний провулок
Прудна вулиця	Прудна вулиця
Радна вулиця	Радна вулиця
Рафінадна вулиця	Рафінадна вулиця
Рафінадний бульвар	Рафінадний бульвар
Рафінадний провулок	Рафінадний провулок
Рекордна вулиця	Рекордна вулиця
Рекордний провулок	Рекордний провулок
Рідна вулиця	Рідна вулиця
Рідний провулок	Рідний провулок
Роз'їздна вулиця	Розʼїздна вулиця
Роз’їздна вулиця	Розʼїздна вулиця
Розсадна вулиця	Розсадна вулиця
Рокадна вулиця	Рокадна вулиця
Рокадний провулок	Рокадний провулок
Рудна вулиця	Рудна вулиця
Рудний провулок	Рудний провулок
Свободна вулиця	Свободна вулиця
Свободний провулок	Свободний провулок
Снарядний провулок	Снарядний провулок
Старий Інвалідний хутір вулиця	вулиця Старий Інвалідний Хутір
Старий Інвалідний Хутір вулиця	вулиця Старий Інвалідний Хутір
Старообрядна вулиця	Старообрядна вулиця
Старопрудна вулиця	Старопрудна вулиця
Старопрудний провулок	Старопрудний провулок
Східна - I вулиця	1-ша Східна вулиця
Східна - II вулиця	2-га Східна вулиця
Східна алея	Східна алея
Східна вулиця	Східна вулиця
Східна Застава вулиця	вулиця Східна Застава
Східний в'їзд	Східний вʼїзд
східний кв	Східний квартал
Східний кв	Східний квартал
Східний кв.	Східний квартал
Східний квартал	Східний квартал
Східний мікрорайон	Східний мікрорайон
Східний міст	Східний міст
Східний провулок	Східний провулок
Східний проїзд	Східний проїзд
Східний проспект	Східний проспект
Теплохідна вулиця	Теплохідна вулиця
Торпедна вулиця	Торпедна вулиця
Торпедний провулок	Торпедний провулок
Трояндна вулиця	Трояндна вулиця
Фасадна вулиця	Фасадна вулиця
Холодна вулиця	Холодна вулиця
Холодний провулок	Холодний провулок
Холодний Яр вулиця	вулиця Холодний Яр
Хороводна вулиця	Хороводна вулиця
Чистопрудна вулиця	Чистопрудна вулиця
Шляхопровідна вулиця	Шляхопровідна вулиця
Шляхопровідний провулок	Шляхопровідний провулок
Шовкопрядна вулиця	Шовкопрядна вулиця
Ягідна вулиця	Ягідна вулиця
Ягідний провулок	Ягідний провулок
Ягідний проїзд	Ягідний проїзд