Абразивна вулиця	Абразивна вулиця
Адміністративна вулиця	Адміністративна вулиця
Адміністративний провулок	Адміністративний провулок
Активна вулиця	Активна вулиця
Велика Перспективна вулиця	Велика Перспективна вулиця
вулиця Кооперативна	Кооперативна вулиця
вулиця Спортивна	Спортивна вулиця
Декоративна вулиця	Декоративна вулиця
Декоративний провулок	Декоративний провулок
Жнивна вулиця	Жнивна вулиця
Заливна вулиця	Заливна вулиця
Заливний провулок	Заливний провулок
Запливна вулиця	Запливна вулиця
Ініціативна вулиця	Ініціативна вулиця
Ініціативний провулок	Ініціативний провулок
Кінноспортивна вулиця	Кінноспортивна вулиця
Колективна вулиця	Колективна вулиця
Колективний провулок	Колективний провулок
Конструктивна вулиця	Конструктивна вулиця
Коопеаративна вулиця	Коопеаративна вулиця
Кооперативна вулиця	Кооперативна вулиця
Кооперативна площа	Кооперативна площа
Кооперативная вулиця	Кооперативная вулиця
Кооперативний в'їзд	Кооперативний вʼїзд
Кооперативний в’їзд	Кооперативний вʼїзд
Кооперативний провулок	Кооперативний провулок
Локомотивна вулиця	Локомотивна вулиця
Локомотивний провулок	Локомотивний провулок
Мала Спортивна вулиця	Мала Спортивна вулиця
Масивна вулиця	Масивна вулиця
Меліоративна вулиця	Меліоративна вулиця
Меліоративний провулок	Меліоративний провулок
Наливна Станція вулиця	вулиця Наливна Станція
Новоналивна вулиця	Новоналивна вулиця
Обривний провулок	Обривний провулок
Перспективна вулиця	Перспективна вулиця
Перспективний провулок	Перспективний провулок
Пивний провулок	Пивний провулок
Підривний провулок	Підривний провулок
Позитивна вулиця	Позитивна вулиця
Прогресивна вулиця	Прогресивна вулиця
Прогресивна Вулиця	Прогресивна вулиця
Прогресивний провулок	Прогресивний провулок
Реактивна вулиця	Реактивна вулиця
Реактивний провулок	Реактивний провулок
Реконструктивна вулиця	Реконструктивна вулиця
Реконструктивний провулок	Реконструктивний провулок
Самопливний провулок	Самопливний провулок
Споритивний в'їзд	Споритивний вʼїзд
Спортивна вулиця	Спортивна вулиця
Спортивна Друга вулиця	2-га Спортивна вулиця
Спортивна Перша вулиця	1-ша Спортивна вулиця
Спортивна площа	Спортивна площа
Спортивна улиця	Спортивна вулиця
Спортивна-Хутір вулиця	вулиця Спортивна-Хутір
Спортивний бульвар	Спортивний бульвар
Спортивний в’їзд	Спортивний вʼїзд
Спортивний провулок	Спортивний провулок
Спортивний проїзд	Спортивний проїзд
Спртивна вулиця	Спортивна вулиця
Федеративна вулиця	Федеративна вулиця