Академіка Балея вулиця	вулиця Академіка Балея
Академіка Вула вулиця	вулиця Академіка Вула
Академіка Гамалея вулиця	вулиця Академіка Гамалея
Академіка Гранчака вулиця	вулиця Академіка Гранчака
Академіка Грішко вулиця	вулиця Академіка Грішко
Академіка Дородніцина вулиця	вулиця Академіка Дородніцина
Академіка Ерделі вулиця	вулиця Академіка Ерделі
Академіка Жебелєва вулиця	вулиця Академіка Жебелєва
Академіка Зязюна вулиця	вулиця Академіка Зязюна
Академіка Кочина вулиця	вулиця Академіка Кочина
Академіка Рево вулиця	вулиця Академіка Рево
Академіка Тамма вулиця	вулиця Академіка Тамма
Академіка Тарле вулиця	вулиця Академіка Тарле
Академіка Тімірязєва вулиця	вулиця Академіка Тімірязєва
Академіка Ферсмана вулиця	вулиця Академіка Ферсмана
Академіка Шпеника вулиця	вулиця Академіка Шпеника
Академіків Гродзинських вулиця	вулиця Академіків Гродзинських
Братів Ангурян вулиця	вулиця Братів Ангурян
Братів Арташ вулиця	вулиця Братів Арташ
Братів Баклай вулиця	вулиця Братів Баклай
Братів Батюшинських вулиця	вулиця Братів Батюшинських
Братів Бережницьких вулиця	вулиця Братів Бережницьких
Братів Бестужевих вулиця	вулиця Братів Бестужевих
Братів Білоусів вулиця	вулиця Братів Білоусів
Братів Близнюків вулиця	вулиця Братів Близнюків
Братів Божко вулиця	вулиця Братів Божко
Братів Бойко вулиця	вулиця Братів Бойко
Братів Брайщаків вулиця	вулиця Братів Брайщаків
Братів Бращайків вулиця	вулиця Братів Бращайків
Братів Бреславських вулиця	вулиця Братів Бреславських
Братів Вайнерів вулиця	вулиця Братів Вайнерів
Братів Вайчикових вулиця	вулиця Братів Вайчикових
Братів Вільшинських вулиця	вулиця Братів Вільшинських
Братів Волошиних вулиця	вулиця Братів Волошиних
Братів Гавришів вулиця	вулиця Братів Гавришів
Братів Галичів вулиця	вулиця Братів Галичів
Братів Гарамів вулиця	вулиця Братів Гарамів
Братів Героїв вулиця	вулиця Братів Героїв
Братів Гжицьких вулиця	вулиця Братів Гжицьких
Братів Гринівих вулиця	вулиця Братів Гринівих
Братів Гуріних вулиця	вулиця Братів Гуріних
Братів Ґжицьких вулиця	вулиця Братів Ґжицьких
Братів Ґоттліб вулиця	вулиця Братів Ґоттліб
Братів Дацько вулиця	вулиця Братів Дацько
Братів Диких вулиця	вулиця Братів Диких
Братів Довганюків вулиця	вулиця Братів Довганюків
Братів Дорофеєвих вулиця	вулиця Братів Дорофеєвих
Братів Драгунів вулиця	вулиця Братів Драгунів
Братів Дробілко вулиця	вулиця Братів Дробілко
Братів Дужих вулиця	вулиця Братів Дужих
Братів Жосан вулиця	вулиця Братів Жосан
Братів Заболотних вулиця	вулиця Братів Заболотних
Братів Заведюків вулиця	вулиця Братів Заведюків
Братів Зайцевих вулиця	вулиця Братів Зайцевих
Братів Западинських вулиця	вулиця Братів Западинських
Братів Зерових вулиця	вулиця Братів Зерових
Братів Зерових провулок	провулок Братів Зерових
Братів Зизаніїв вулиця	вулиця Братів Зизаніїв
Братів Зосим вулиця	вулиця Братів Зосим
Братів Йонів вулиця	вулиця Братів Йонів
Братів Каменських вулиця	вулиця Братів Каменських
Братів Катеренюків вулиця	вулиця Братів Катеренюків
Братів Кедюличів вулиця	вулиця Братів Кедюличів
Братів Кирчавих вулиця	вулиця Братів Кирчавих
Братів Кислюків вулиця	вулиця Братів Кислюків
Братів Кицилів вулиця	вулиця Братів Кицилів
Братів Климових вулиця	вулиця Братів Климових
Братів Клімових провулок	провулок Братів Клімових
Братів Ковеневих вулиця	вулиця Братів Ковеневих
Братів Ковлевих вулиця	вулиця Братів Ковлевих
Братів Кожакіних вулиця	вулиця Братів Кожакіних
Братів Козаків вулиця	вулиця Братів Козаків
Братів Колосових вулиця	вулиця Братів Колосових
Братів Корінних вулиця	вулиця Братів Корінних
Братів Котельнікових вулиця	вулиця Братів Котельнікових
Братів Котюх провулок	провулок Братів Котюх
Братів Кривоносів вулиця	вулиця Братів Кривоносів
Братів Кричевських вулиця	вулиця Братів Кричевських
Братів Курилюків вулиця	вулиця Братів Курилюків
Братів Леонів вулиця	вулиця Братів Леонів
Братів Лепких вулиця	вулиця Братів Лепких
Братів Мазікових вулиця	вулиця Братів Мазікових
Братів Майбородів провулок	провулок Братів Майбородів
Братів Маковських вулиця	вулиця Братів Маковських
Братів Малакових вулиця	вулиця Братів Малакових
Братів Махових вулиця	вулиця Братів Махових
Братів Микитюків вулиця	вулиця Братів Микитюків
Братів Мисулів вулиця	вулиця Братів Мисулів
Братів Михайлишиних вулиця	вулиця Братів Михайлишиних
Братів Михайлюків вулиця	вулиця Братів Михайлюків
Братів Міллер вулиця	вулиця Братів Міллер
Братів Міхєєвих вулиця	вулиця Братів Міхєєвих
Братів Міхновських вулиця	вулиця Братів Міхновських
Братів Міцкевичів провулок	провулок Братів Міцкевичів
Братів Мойсеєвих вулиця	вулиця Братів Мойсеєвих
Братів Морозевичів вулиця	вулиця Братів Морозевичів
Братів Муковозів вулиця	вулиця Братів Муковозів
Братів Неживих вулиця	вулиця Братів Неживих
Братів Незабитовських провулок	провулок Братів Незабитовських
Братів Новосадів вулиця	вулиця Братів Новосадів
Братів Обухів вулиця	вулиця Братів Обухів
Братів Окуневських вулиця	вулиця Братів Окуневських
Братів Олексієнків вулиця	вулиця Братів Олексієнків
Братів Осадчих вулиця	вулиця Братів Осадчих
Братів Осташко вулиця	вулиця Братів Осташко
Братів П’ятигорських вулиця	вулиця Братів Пʼятигорських
Братів Павлюків вулиця	вулиця Братів Павлюків
Братів Палкіних вулиця	вулиця Братів Палкіних
Братів Паукових вулиця	вулиця Братів Паукових
Братів Поджіо вулиця	вулиця Братів Поджіо
Братів Потабашних вулиця	вулиця Братів Потабашних
Братів Приймаків вулиця	вулиця Братів Приймаків
Братів Приходьків вулиця	вулиця Братів Приходьків
Братів Пришляків вулиця	вулиця Братів Пришляків
Братів Реваїв вулиця	вулиця Братів Реваїв
Братів Руснаків вулиця	вулиця Братів Руснаків
Братів Рябоконь вулиця	вулиця Братів Рябоконь
Братів Селянко вулиця	вулиця Братів Селянко
Братів Сердюк вулиця	вулиця Братів Сердюк
Братів Синицьких вулиця	вулиця Братів Синицьких
Братів Солоних вулиця	вулиця Братів Солоних
Братів Стицьковських вулиця	вулиця Братів Стицьковських
Братів Сумських вулиця	вулиця Братів Сумських
Братів Суріних вулиця	вулиця Братів Суріних
Братів Тобілевичів вулиця	вулиця Братів Тобілевичів
Братів Трофімових вулиця	вулиця Братів Трофімових
Братів Трофімових провулок	провулок Братів Трофімових
Братів Турчинів вулиця	вулиця Братів Турчинів
Братів Федорових вулиця	вулиця Братів Федорових
Братів Федусевичів вулиця	вулиця Братів Федусевичів
Братів Фільчинських вулиця	вулиця Братів Фільчинських
Братів Фуфрянських вулиця	вулиця Братів Фуфрянських
Братів Халімон вулиця	вулиця Братів Халімон
Братів Хижніх вулиця	вулиця Братів Хижніх
Братів Хоменків	Братів Хоменків
Братів Цендрівських вулиця	вулиця Братів Цендрівських
Братів Цибульських провулок	провулок Братів Цибульських
Братів Чмілів вулиця	вулиця Братів Чмілів
Братів Чмілів провулок	провулок Братів Чмілів
Братів Чучупаків вулиця	вулиця Братів Чучупаків
Братів Шайлоків вулиця	вулиця Братів Шайлоків
Братів Шеметів вулиця	вулиця Братів Шеметів
Братів Шеметів провулок	провулок Братів Шеметів
Братів Шерегіів вулиця	вулиця Братів Шерегіїв
Братів Шерегіїв вулиця	вулиця Братів Шерегіїв
Братів Шиянів вулиця	вулиця Братів Шиянів
Братів Шкамбар вулиця	вулиця Братів Шкамбар
Братів Щеглів вулиця	вулиця Братів Щеглів
Братів Щербань вулиця	вулиця Братів Щербань
Братів Щербатюків вулиця	вулиця Братів Щербатюків
Братів Яворівих вулиця	вулиця Братів Яворівих
Братів Яцунових вулиця	вулиця Братів Яцунових
Братiв Майбородiв вулиця	вулиця Братів Майбородів
вулиця Братів Бригінських	вулиця Братів Бригінських
вулиця Братів Ткаченків	вулиця Братів Ткаченків
Пономарів братів вулиця	вулиця Братів Пономарів
провулок Братів Ткаченків	провулок Братів Ткаченків
Сестер Василіанок провулок	провулок Сестер Василіанок
Сестер Гозадінових провулок	провулок Сестер Гозадінових
Сестер Гоменюк провулок	провулок Сестер Гоменюк
Сестер Куянових вулиця	вулиця Сестер Куянових
Сестер Сломницьких вулиця	вулиця Сестер Сломницьких