Авіаторів Касяненків вулиця	Авіаторів Касяненків вулиця
Брата і сестри Ткаченків вулиця	Брата і сестри Ткаченків вулиця
Братів Бойчуків вулиця	Братів Бойчуків вулиця
Братів Грощенків вулиця	Братів Грощенків вулиця
Братів Давиденків вулиця	Братів Давиденків вулиця
Братів Дяченків вулиця	Братів Дяченків вулиця
Братів Ємченків вулиця	Братів Ємченків вулиця
Братів Кириченків вулиця	Братів Кириченків вулиця
Братів Козленків вулиця	Братів Козленків вулиця
Братів Коломійченків вулиця	Братів Коломійченків вулиця
Братів Конончуків вулиця	Братів Конончуків вулиця
Братів Котенків вулиця	Братів Котенків вулиця
Братів Котенків провулок	Братів Котенків провулок
Братів Кузьменків вулиця	Братів Кузьменків вулиця
Братів Кучеренків вулиця	Братів Кучеренків вулиця
Братів Кучеренків провулок	Братів Кучеренків провулок
Братів Левчуків вулиця	Братів Левчуків вулиця
Братів Липовенків вулиця	Братів Липовенків вулиця
Братів Лисенків вулиця	Братів Лисенків вулиця
Братів Моренків вулиця	Братів Моренків вулиця
Братів Павленків вулиця	Братів Павленків вулиця
Братів Пнівчуків вулиця	Братів Пнівчуків вулиця
Братів Радченків вулиця	Братів Радченків вулиця
Братів Савченків вулиця	Братів Савченків вулиця
Братів Сидоренків вулиця	Братів Сидоренків вулиця
Братів Тимошенків вулиця	Братів Тимошенків вулиця
Братів Ткаченків вулиця	Братів Ткаченків вулиця
Братів Шевченків вулиця	Братів Шевченків вулиця
Братів Якимчуків вулиця	Братів Якимчуків вулиця
Братів Яхненків провулок	Братів Яхненків провулок
Братів Ященків вулиця	Братів Ященків вулиця
Бровченків вулиця	Бровченків вулиця
Гайдуків вулиця	Гайдуків вулиця
Голубенків вулиця	Голубенків вулиця
Гончаренків вулиця	Гончаренків вулиця
Грінчуків вулиця	Грінчуків вулиця
Денисенків провулок	Денисенків провулок
Дорошенків вулиця	Дорошенків вулиця
Дорошенків провулок	Дорошенків провулок
Дуденків вулиця	Дуденків вулиця
Карпенків вулиця	Карпенків вулиця
Кирийчуків вулиця	Кирийчуків вулиця
Лещуків вулиця	Лещуків вулиця
Марчуків вулиця	Марчуків вулиця
Михальченків вулиця	Михальченків вулиця
Нестеренків вулиця	Нестеренків вулиця
Осипенків вулиця	Осипенків вулиця
Охріменків вулиця	Охріменків вулиця
Павлущенків провулок	Павлущенків провулок
Піщенків вулиця	Піщенків вулиця
Покальчуків вулиця	Покальчуків вулиця
Проскаченків вулиця	Проскаченків вулиця
Рибченків вулиця	Рибченків вулиця
Родини Гамченків вулиця	Родини Гамченків вулиця
Родини Онищенків вулиця	Родини Онищенків вулиця
Родини Онищенків провулок	Родини Онищенків провулок
Родини Семиренків провулок	Родини Семиренків провулок
Родини Симиренків вулиця	Родини Симиренків вулиця
Родини Ханенків вулиця	Родини Ханенків вулиця
Родини Харченків вулиця	Родини Харченків вулиця
Савченків провулок	Савченків провулок
Самосенків вулиця	Самосенків вулиця
Симиренків вулиця	Симиренків вулиця
Симиренків провулок	Симиренків провулок
Сім'ї Клименків вулиця	Сімʼї Клименків вулиця
Сім'ї Сидоренків вулиця	Сімʼї Сидоренків вулиця
Сім’ї Кульженків вулиця	Сімʼї Кульженків вулиця
Сім’ї Стешенків вулиця	Сімʼї Стешенків вулиця
Сім’ї Ханенків вулиця	Сімʼї Ханенків вулиця
Терещенків вулиця	Терещенків вулиця
Шевченків шлях вулиця	Шевченків шлях вулиця
Шевчуків вулиця	Шевчуків вулиця
Юрченків вулиця	Юрченків вулиця
Яремчуків вулиця	Яремчуків вулиця