Аврушенка вулиця	Аврушенка вулиця
Адаменко вулиця	Адаменко вулиця
Анголенка вулиця	Анголенка вулиця
Аненка вулиця	Аненка вулиця
Анненка вулиця	Анненка вулиця
Архітектора Паученка вулиця	Архітектора Паученка вулиця
Бабаченка вулиця	Бабаченка вулиця
Бабенко вулиця	Бабенко вулиця
Багненка вулиця	Багненка вулиця
Баленко вулиця	Баленко вулиця
Банченка вулиця	Банченка вулиця
Безнощенка вулиця	Безнощенка вулиця
Бєлорєченка вулиця	Бєлорєченка вулиця
Бишенка провулок	Бишенка провулок
Білоченка вулиця	Білоченка вулиця
Блізніченка вулиця	Блізніченка вулиця
Боженко вулиця	Боженко вулиця
Боженко провулок	Боженко провулок
Братів Більченко вулиця	Братів Більченко вулиця
Братів Гавриленко вулиця	Братів Гавриленко вулиця
Братів Довбенко вулиця	Братів Довбенко вулиця
Братів Соколенко вулиця	Братів Соколенко вулиця
Братів Ярошенко вулиця	Братів Ярошенко вулиця
Бугайченка вулиця	Бугайченка вулиця
Бугрименка вулиця	Бугрименка вулиця
Бугрименка проїзд	Бугрименка проїзд
Буруденка вулиця	Буруденка вулиця
В'язовченка вулиця	Вʼязовченка вулиця
В'язовченка провулок	Вʼязовченка провулок
В’ячеслава Хурсенка вулиця	Вʼячеслава Хурсенка вулиця
Веденка вулиця	Веденка вулиця
Веденко вулиця	Веденко вулиця
Велика Виженка вулиця	Велика Виженка вулиця
Вернигоренка вулиця	Вернигоренка вулиця
Вернигоренко вулиця	Вернигоренко вулиця
Винахідниці Ющенко вулиця	Винахідниці Ющенко вулиця
Винокуренка вулиця	Винокуренка вулиця
Висовненка вулиця	Висовненка вулиця
Височенка вулиця	Височенка вулиця
Височиненка вулиця	Височиненка вулиця
Вініченко вулиця	Вініченко вулиця
Волковенка вулиця	Волковенка вулиця
Воровченка вулиця	Воровченка вулиця
Вощенка вулиця	Вощенка вулиця
Гавриленко вулиця	Гавриленко вулиця
Гайденко вулиця	Гайденко вулиця
Гамченка проїзд	Гамченка проїзд
Гарбузенка вулиця	Гарбузенка вулиця
Герася Соколенко вулиця	Герася Соколенко вулиця
Глуменка вулиця	Глуменка вулиця
Гніліченка вулиця	Гніліченка вулиця
Головченко вулиця	Головченко вулиця
Гомоненка вулиця	Гомоненка вулиця
Гончаренко вулиця	Гончаренко вулиця
Горбенко вулиця	Горбенко вулиця
Горпищенко тупик	Горпищенко тупик
Грибенка вулиця	Грибенка вулиця
Грибиниченка вулиця	Грибиниченка вулиця
Грибініченка площа	Грибініченка площа
Грибініченко площа	Грибініченко площа
Гриценко вулиця	Гриценко вулиця
Грищенко вулиця	Грищенко вулиця
Грузиненка вулиця	Грузиненка вулиця
Гуманенка вулиця	Гуманенка вулиця
Гусенка вулиця	Гусенка вулиця
Гутніченка вулиця	Гутніченка вулиця
Гутченка вулиця	Гутченка вулиця
Гутченка провулок	Гутченка провулок
Гутченко вулиця	Гутченко вулиця
Гутченко провулок	Гутченко провулок
Давиденко вулиця	Давиденко вулиця
Данченко вулиця	Данченко вулиця
Дебенка вулиця	Дебенка вулиця
Декаленка вулиця	Декаленка вулиця
Демещенка вулиця	Демещенка вулиця
Деміденка вулиця	Деміденка вулиця
Демченко вулиця	Демченко вулиця
Денисенко вулиця	Денисенко вулиця
Дениченко вулиця	Дениченко вулиця
Дерезенка вулиця	Дерезенка вулиця
Діденко вулиця	Діденко вулиця
Добробоженка вулиця	Добробоженка вулиця
Довденка вулиця	Довденка вулиця
Дорошенко вулиця	Дорошенко вулиця
Дябченка вулиця	Дябченка вулиця
Еременко квартал	Еременко квартал
Є.Ткаченко вулиця	Є.Ткаченко вулиця
Єременко вулиця	Єременко вулиця
Єрмощенка вулиця	Єрмощенка вулиця
Єрощенка вулиця	Єрощенка вулиця
Єсауленка вулиця	Єсауленка вулиця
Жаданенка провулок	Жаданенка провулок
Женченка вулиця	Женченка вулиця
Житниченка вулиця	Житниченка вулиця
Забченко вулиця	Забченко вулиця
Заклепенка провулок	Заклепенка провулок
Закутенка вулиця	Закутенка вулиця
Запорожченко квартал	Запорожченко квартал
Зінченко братів провулок	Зінченко братів провулок
Зінченко вулиця	Зінченко вулиця
Ильченка вулиця	Ильченка вулиця
І.Аліщенка вулиця	І.Аліщенка вулиця
Ігнатченко вулиця	Ігнатченко вулиця
Ільченко вулиця	Ільченко вулиця
імені Бабенко вулиця	імені Бабенко вулиця
Іхненка вулиця	Іхненка вулиця
Кадученка вулиця	Кадученка вулиця
Каліниченка вулиця	Каліниченка вулиця
Карнаушенко вулиця	Карнаушенко вулиця
Квіленка вулиця	Квіленка вулиця
Кетченко вулиця	Кетченко вулиця
Китченка вулиця	Китченка вулиця
Кібенка вулиця	Кібенка вулиця
Кібенко вулиця	Кібенко вулиця
Кіченка вулиця	Кіченка вулиця
Кіченко вулиця	Кіченко вулиця
Клави Байраченко вулиця	Клави Байраченко вулиця
Клименко вулиця	Клименко вулиця
Кожущенко провулок	Кожущенко провулок
Козаченко вулиця	Козаченко вулиця
Командарма Костенко вулиця	Командарма Костенко вулиця
Кондренка вулиця	Кондренка вулиця
Короленко вулиця	Короленко вулиця
Короленко провулок	Короленко провулок
Коротченко вулиця	Коротченко вулиця
Косенко вулиця	Косенко вулиця
Костенко вулиця	Костенко вулиця
Костенко провулок	Костенко провулок
Кравченко вулиця	Кравченко вулиця
Кривенко вулиця	Кривенко вулиця
Крикуненко вулиця	Крикуненко вулиця
Кувітченко вулиця	Кувітченко вулиця
Кувітченко провулок	Кувітченко провулок
Кундіренка вулиця	Кундіренка вулиця
Курченко вулиця	Курченко вулиця
Кутурженка вулиця	Кутурженка вулиця
Лабутенка вулиця	Лабутенка вулиця
Лавроненка вулиця	Лавроненка вулиця
Лантушенка вулиця	Лантушенка вулиця
Левченко вулиця	Левченко вулиця
Левченко квартал	Левченко квартал
Леженка вулиця	Леженка вулиця
Лелеченка вулиця	Лелеченка вулиця
Ленченка вулиця	Ленченка вулиця
Ленченко вулиця	Ленченко вулиця
Лємєщенка вулиця	Лємєщенка вулиця
Линченка вулиця	Линченка вулиця
Липовенка вулиця	Липовенка вулиця
Лисенко вулиця	Лисенко вулиця
Лівенка вулиця	Лівенка вулиця
Лізенка вулиця	Лізенка вулиця
Ліненко вулиця	Ліненко вулиця
Ліченка вулиця	Ліченка вулиця
Логвиненко вулиця	Логвиненко вулиця
Логовенка вулиця	Логовенка вулиця
Лук’яненка вулиця	Лукʼяненка вулиця
Лук’яненка провулок	Лукʼяненка провулок
Луняченко провулок	Луняченко провулок
Луфаренка вулиця	Луфаренка вулиця
Луференка вулиця	Луференка вулиця
Макаренко вулиця	Макаренко вулиця
Мала Виженка вулиця	Мала Виженка вулиця
Маличенка вулиця	Маличенка вулиця
Мануйленко вулиця	Мануйленко вулиця
Мар’яненко провулок	Марʼяненко провулок
МаріЇ Приймаченко вулиця	МаріЇ Приймаченко вулиця
Марунченко вулиця	Марунченко вулиця
Марченко вулиця	Марченко вулиця
Матвіенка вулиця	Матвіенка вулиця
Матюшенко вулиця	Матюшенко вулиця
Мащенко вулиця	Мащенко вулиця
Мельченка вулиця	Мельченка вулиця
Микільченка вулиця	Микільченка вулиця
Мирющенко вулиця	Мирющенко вулиця
Михайліченко вулиця	Михайліченко вулиця
Міненко вулиця	Міненко вулиця
Мірошниченко вулиця	Мірошниченко вулиця
Мірющенка вулиця	Мірющенка вулиця
Міхи Козимиренка провулок	Міхи Козимиренка провулок
Міщенко вулиця	Міщенко вулиця
Мнішенко вулиця	Мнішенко вулиця
Могильченка вулиця	Могильченка вулиця
Мольченко вулиця	Мольченко вулиця
Монченка вулиця	Монченка вулиця
Моргуненка вулиця	Моргуненка вулиця
Москаленко вулиця	Москаленко вулиця
Мотрушенка вулиця	Мотрушенка вулиця
Назаренко вулиця	Назаренко вулиця
Ніколенко вулиця	Ніколенко вулиця
Ногтенка вулиця	Ногтенка вулиця
Обушенка вулиця	Обушенка вулиця
Оверченко вулиця	Оверченко вулиця
Одноорченка вулиця	Одноорченка вулиця
Ожоженка вулиця	Ожоженка вулиця
Окатенка вулиця	Окатенка вулиця
Околотенко вулиця	Околотенко вулиця
Оксанченка провулок	Оксанченка провулок
Онищенко вулиця	Онищенко вулиця
Опанасенко вулиця	Опанасенко вулиця
Осипенко вулиця	Осипенко вулиця
Осипенко провулок	Осипенко провулок
Осипенко проїзд	Осипенко проїзд
Осіпенко вулиця	Осіпенко вулиця
Осіпенко провулок	Осіпенко провулок
Остапенко вулиця	Остапенко вулиця
П’ятенка вулиця	Пʼятенка вулиця
Палажченка вулиця	Палажченка вулиця
Панченко вулиця	Панченко вулиця
Пархоменко вулиця	Пархоменко вулиця
Пархоменко провулок	Пархоменко провулок
Пархоменкa вулиця	Пархоменка вулиця
Пасiченка вулиця	Пасіченка вулиця
Педенко вулиця	Педенко вулиця
Петрусенко вулиця	Петрусенко вулиця
Петрусенко провулок	Петрусенко провулок
Петрусенко тупик	Петрусенко тупик
Пиженка вулиця	Пиженка вулиця
Пипенка вулиця	Пипенка вулиця
Пипенка провулок	Пипенка провулок
Писаренко вулиця	Писаренко вулиця
Піюренка вулиця	Піюренка вулиця
Плетенка вулиця	Плетенка вулиця
Плисенка вулиця	Плисенка вулиця
Пойденка вулиця	Пойденка вулиця
Полковника Оксенченка вулиця	Полковника Оксенченка вулиця
Половченка вулиця	Половченка вулиця
Похільченка вулиця	Похільченка вулиця
Правденко провулок	Правденко провулок
Присенка вулиця	Присенка вулиця
Прищепенка вулиця	Прищепенка вулиця
Промогайбенка вулиця	Промогайбенка вулиця
Прохоренко вулиця	Прохоренко вулиця
Проценко вулиця	Проценко вулиця
Ральченка вулиця	Ральченка вулиця
Ральченко вулиця	Ральченко вулиця
Ройченка вулиця	Ройченка вулиця
Романенко вулиця	Романенко вулиця
Ромащенко вулиця	Ромащенко вулиця
Руденко вулиця	Руденко вулиця
Рудниченка вулиця	Рудниченка вулиця
Рудніченко вулиця	Рудніченко вулиця
Савоненка провулок	Савоненка провулок
Савченко вулиця	Савченко вулиця
Садовиченка вулиця	Садовиченка вулиця
Садовниченка вулиця	Садовниченка вулиця
Самійленко вулиця	Самійленко вулиця
Сапоненко вулиця	Сапоненко вулиця
Сапроненка вулиця	Сапроненка вулиця
Свічкаренка вулиця	Свічкаренка вулиця
Свічкаренко вулиця	Свічкаренко вулиця
Семеренко вулиця	Семеренко вулиця
Семиренка вулиця	Семиренка вулиця
Семиренко вулиця	Семиренко вулиця
Сербіненка вулиця	Сербіненка вулиця
Сергіенко вулиця	Сергіенко вулиця
Сивокобиленка вулиця	Сивокобиленка вулиця
Сидоркенка провулок	Сидоркенка провулок
Сипаренка вулиця	Сипаренка вулиця
Смутченка вулиця	Смутченка вулиця
Солов’яненка вулиця	Соловʼяненка вулиця
Строменка вулиця	Строменка вулиця
Сурдуленко вулиця	Сурдуленко вулиця
Таісії Буряченко вулиця	Таісії Буряченко вулиця
Таранущенка вулиця	Таранущенка вулиця
Тарасенко вулиця	Тарасенко вулиця
Терніченко вулиця	Терніченко вулиця
Тесленко вулиця	Тесленко вулиця
Тимошенко вулиця	Тимошенко вулиця
Тимошенко провулок	Тимошенко провулок
Титенко вулиця	Титенко вулиця
Тищенко вулиця	Тищенко вулиця
Тімченко вулиця	Тімченко вулиця
Тітенко вулиця	Тітенко вулиця
Ткаленко квартал	Ткаленко квартал
Ткаченко вулиця	Ткаченко вулиця
Ткаченко площа	Ткаченко площа
Ткаченко-Петренко вулиця	Ткаченко-Петренко вулиця
Тоболенка вулиця	Тоболенка вулиця
Товстенко вулиця	Товстенко вулиця
Торопченка вулиця	Торопченка вулиця
Трофіменко вулиця	Трофіменко вулиця
Трофіменко провулок	Трофіменко провулок
Трубченка вулиця	Трубченка вулиця
Усенко вулиця	Усенко вулиця
Усенко провулок	Усенко провулок
Устенко вулиця	Устенко вулиця
Федоренко вулиця	Федоренко вулиця
Федющенка вулиця	Федющенка вулиця
Фроленка вулиця	Фроленка вулиця
Фуженка вулиця	Фуженка вулиця
Харченко вулиця	Харченко вулиця
Ходченка вулиця	Ходченка вулиця
Хомченко вулиця	Хомченко вулиця
Цокуренка вулиця	Цокуренка вулиця
Чапленка алея	Чапленка алея
Чекаленко вулиця	Чекаленко вулиця
Чернопащенка вулиця	Чернопащенка вулиця
Чехмистренко вулиця	Чехмистренко вулиця
Чмиренка вулиця	Чмиренка вулиця
Чухаленко вулиця	Чухаленко вулиця
Шаренка вулиця	Шаренка вулиця
Шевсченка вулиця	Шевсченка вулиця
Шевченко вул	Шевченко вул
Шевченко вулиця	Шевченко вулиця
Шевченко квартал	Шевченко квартал
Шевченко провулок	Шевченко провулок
Шепотиленка вулиця	Шепотиленка вулиця
Шеченка вулиця	Шеченка вулиця
Шеченко вулиця	Шеченко вулиця
Шкапенка вулиця	Шкапенка вулиця
Штеменка вулиця	Штеменка вулиця
Щаденка в’їзд	Щаденка вʼїзд
Щаденка вулиця	Щаденка вулиця
Щаденка провулок	Щаденка провулок
Щаденко вулиця	Щаденко вулиця
Эрошенка вулиця	Эрошенка вулиця
Явдокименка вулиця	Явдокименка вулиця
Якименко вулиця	Якименко вулиця
Яковенко вулиця	Яковенко вулиця
Яременко вулиця	Яременко вулиця
Ярмошенка вулиця	Ярмошенка вулиця
Ярошенко вулиця	Ярошенко вулиця
Яцуненка вулиця	Яцуненка вулиця
Яцуненко вулиця	Яцуненко вулиця
Боєнка вулиця	Боєнка вулиця
Вакацієнка вулиця	Вакацієнка вулиця
Генерала Корнiєнко вулиця	Генерала Корнієнко вулиця
Гордієнко вулиця	Гордієнко вулиця
Гордієнко провулок	Гордієнко провулок
Зуєнко провулок	Зуєнко провулок
Китаєнка вулиця	Китаєнка вулиця
Кіпєнка вулиця	Кіпєнка вулиця
Матієнко вулиця	Матієнко вулиця
Огієнко вулиця	Огієнко вулиця
Онопрієнко вулиця	Онопрієнко вулиця
Онупрієнка вулиця	Онупрієнка вулиця
Сергієнко вулиця	Сергієнко вулиця
Сергієнко провулок	Сергієнко провулок
Старієнка вулиця	Старієнка вулиця
Шалаєнко вулиця	Шалаєнко вулиця
Шкрептиєнка вулиця	Шкрептиєнка вулиця