Автогаражна вулиця	Автогаражна вулиця
Автодорожна вулиця	Автодорожна вулиця
Автодорожний провулок	Автодорожний провулок
Автострадна набережна	Автострадна набережна
Бережна вулиця	Бережна вулиця
Бережна вулицяё	Бережна вулиця
Бережний провулок	Бережний провулок
Білобережна вулиця	Білобережна вулиця
Бічна Молодіжна	Бічна Молодіжна
Бічна Молодіжна вулиця	Бічна Молодіжна вулиця
болотяна але можна	болотяна але можна
Больша Набережна вулиця	Больша Набережна вулиця
Ботанічна набережна	Ботанічна набережна
Бумажний провулок	Бумажний провулок
Вантажна вулиця	Вантажна вулиця
Вантажний парк	Вантажний парк
Вантажний провулок	Вантажний провулок
Велика набережна вулиця	Велика набережна вулиця
Велика Набережна вулиця	Велика Набережна вулиця
Велика Окружна вулиця	Велика Окружна вулиця
Верхня набережна вулиця	Верхня набережна вулиця
Відважна вулиця	Відважна вулиця
Віражна вулиця	Віражна вулиця
Вітрика(Набережна) вулиця	Вітрика(Набережна) вулиця
Вокзально-Набережна вулиця	Вокзально-Набережна вулиця
вулиця Молодіжна	вулиця Молодіжна
Вулиця Молодіжна	Вулиця Молодіжна
вулиця Набережна	вулиця Набережна
Гаражна вулиця	Гаражна вулиця
Гаражний провулок	Гаражний провулок
Гаражний проїзд	Гаражний проїзд
Героїв Чорнобиля набережна	Героїв Чорнобиля набережна
Гімназійна набережна	Гімназійна набережна
Дивовижна вулиця	Дивовижна вулиця
Доріжна вулиця	Доріжна вулиця
Дорожна вулиця	Дорожна вулиця
Дорожний в’їзд	Дорожний вʼїзд
Дорожний провулок	Дорожний провулок
Дренажний провулок	Дренажний провулок
Друга Молодіжна вулиця	Друга Молодіжна вулиця
Дружна вулиця	Дружна вулиця
Дружная(Царское село)	Дружная(Царское село)
Дружний провулок	Дружний провулок
Дружний проїзд	Дружний проїзд
Екіпажна вулиця	Екіпажна вулиця
Екіпажний провулок	Екіпажний провулок
Енергетиків набережна	Енергетиків набережна
Железнодоріжна вулиця	Железнодоріжна вулиця
Железнодорожна вулиця	Железнодорожна вулиця
Железнодорожная вулиця	Железнодорожная вулиця
Железнодорожний провулок	Железнодорожний провулок
Желєзнодоріжна вулиця	Желєзнодоріжна вулиця
Желєзнодорожна вулиця	Желєзнодорожна вулиця
Желізнодорожна вулиця	Желізнодорожна вулиця
Жемчужна вулиця	Жемчужна вулиця
Жемчужний провулок	Жемчужний провулок
Забережна вулиця	Забережна вулиця
Забережний провулок	Забережний провулок
заброшено(нужна прочистка)	заброшено(нужна прочистка)
Завіжна вулиця	Завіжна вулиця
Загаражна вулиця	Загаражна вулиця
Задорожна вулиця	Задорожна вулиця
Задорожний провулок	Задорожний провулок
Залізнодорожна вулиця	Залізнодорожна вулиця
Залужна вулиця	Залужна вулиця
Залужний провулок	Залужний провулок
Заможна вулиця	Заможна вулиця
Заможний провулок	Заможний провулок
Заовражна вулиця	Заовражна вулиця
Західно-Окружна вулиця	Західно-Окружна вулиця
Західно-Окружна дорога	Західно-Окружна дорога
Здоров’я набережна	Здоровʼя набережна
Зелена набережна	Зелена набережна
Кирова Леаобережная	Кирова Леаобережная
Книжна вулиця	Книжна вулиця
Книжний провулок	Книжний провулок
Княжна вулиця	Княжна вулиця
Кожна вулиця	Кожна вулиця
Колодяжна вулиця	Колодяжна вулиця
Колодяжний провулок	Колодяжний провулок
Котеджна вулиця	Котеджна вулиця
Лейтенанта Дніпрова набережна	Лейтенанта Дніпрова набережна
Лижна вулиця	Лижна вулиця
Лижний провулок	Лижний провулок
Лівобережна вулиця	Лівобережна вулиця
Лівобережний міст	Лівобережний міст
Лівобережний провулок	Лівобережний провулок
Лівобережний проїзд	Лівобережний проїзд
Лужна вулиця	Лужна вулиця
Лiвобережна вулиця	Лівобережна вулиця
магістраль набережна	магістраль набережна
Мала Набережна вулиця	Мала Набережна вулиця
Манежна вулиця	Манежна вулиця
Манежний провулок	Манежний провулок
Манежний проспект	Манежний проспект
Мережна вулиця	Мережна вулиця
Міжнародна вулиця	Міжнародна вулиця
Міжнародний провулок	Міжнародний провулок
Міражна вулиця	Міражна вулиця
Молодіжна  вулиця	Молодіжна  вулиця
Молодіжна А вулиця	Молодіжна А вулиця
Молодіжна алея	Молодіжна алея
Молодіжна вулииця	Молодіжна вулииця
Молодіжна вулиця	Молодіжна вулиця
Молоді́жна вулиця	Молоді́жна вулиця
Молодіжна иулиця	Молодіжна иулиця
Молодіжна Нова вулиця	Молодіжна Нова вулиця
Молодіжна площа	Молодіжна площа
Молодіжнам вулиця	Молодіжнам вулиця
Молодіжний бульвар	Молодіжний бульвар
Молодіжний в'їзд	Молодіжний вʼїзд
Молодіжний вулиця	Молодіжний вулиця
Молодіжний квартал	Молодіжний квартал
Молодіжний квартал вулиця	Молодіжний квартал вулиця
Молодіжний мікрорайон	Молодіжний мікрорайон
Молодіжний провулок	Молодіжний провулок
Молодіжний проїзд	Молодіжний проїзд
Молодіжний проспект	Молодіжний проспект
Молодіжний тупик	Молодіжний тупик
Молодьожная вулиця	Молодьожная вулиця
Молодiжна вулиця	Молодіжна вулиця
Молодiжний провулок	Молодіжний провулок
Молождіжна вулиця	Молождіжна вулиця
Моложіжна вулиця	Моложіжна вулиця
Мололдіжна вулиця	Мололдіжна вулиця
Монтажна вулиця	Монтажна вулиця
Монтажний провулок	Монтажний провулок
Мосяжна вулиця	Мосяжна вулиця
Набарежна вулиця	Набарежна вулиця
Набережна бічна вулиця	Набережна бічна вулиця
Набережна вулиця	Набережна вулиця
Набережна вулицzя	Набережна вулиця
Набережна Грунь вулиця	Набережна Грунь вулиця
Набережна друга вулиця	Набережна друга вулиця
Набережна набережна	Набережна набережна
Набережна площа	Набережна площа
Набережна Псла вулиця	Набережна Псла вулиця
Набережна р. Псел вулиця	Набережна р. Псел вулиця
Набережна р. Сумка вулиця	Набережна р. Сумка вулиця
Набережна Ротерхема вулиця	Набережна Ротерхема вулиця
Набережна Рохертема вулиця	Набережна Рохертема вулиця
Набережна Стрия вулиця	Набережна Стрия вулиця
Набережна третя вулиця	Набережна третя вулиця
Набережна-бічна вулиця	Набережна-бічна вулиця
Набережний в'їзд	Набережний вʼїзд
Набережний в’їзд	Набережний вʼїзд
Набережний міст	Набережний міст
Набережний провулок	Набережний провулок
Набережний проїзд	Набережний проїзд
Набережний тупик	Набережний тупик
Наберіжна вулиця	Наберіжна вулиця
Набкережна вулиця	Набкережна вулиця
Набрержна вулиця	Набрержна вулиця
Надбережна вулиця	Надбережна вулиця
Надбужна вулиця	Надбужна вулиця
Надовражний провулок	Надовражний провулок
Наріжна вулиця	Наріжна вулиця
Незалежна вулиця	Незалежна вулиця
Незалежна Україна вулиця	Незалежна Україна вулиця
Незалежний провулок	Незалежний провулок
Незалежності набережна	Незалежності набережна
Незаможна вулиця	Незаможна вулиця
Нижний квартал	Нижний квартал
Нижня набережна вулиця	Нижня набережна вулиця
Нижня Набережна вулиця	Нижня Набережна вулиця
Ніжна вулиця	Ніжна вулиця
Новомолодіжна вулиця	Новомолодіжна вулиця
Новонабережна вулиця	Новонабережна вулиця
Овражна вулиця	Овражна вулиця
Овражний провулок	Овражний провулок
Окружна вулиця	Окружна вулиця
Окружна дорога	Окружна дорога
Окружний провулок	Окружний провулок
Острівна Набережна вулиця	Острівна Набережна вулиця
Остріжний узвіз	Остріжний узвіз
Паркова набережна	Паркова набережна
Пейзажна алея	Пейзажна алея
Пейзажна вулиця	Пейзажна вулиця
Пейзажна площа	Пейзажна площа
Пейзажний провулок	Пейзажний провулок
Переможна вулиця	Переможна вулиця
Переможний провулок	Переможний провулок
Першотравнева Набережна вулиця	Першотравнева Набережна вулиця
Підбужна вулиця	Підбужна вулиця
Підлужна вулиця	Підлужна вулиця
Підсніжна вулиця	Підсніжна вулиця
Підсніжний провулок	Підсніжний провулок
Піщана набережна	Піщана набережна
Пляжна алея	Пляжна алея
Пляжна вулиця	Пляжна вулиця
Пляжний в’їзд	Пляжний вʼїзд
Пляжний провулок	Пляжний провулок
Побережна вулиця	Побережна вулиця
Побережний провулок	Побережний провулок
Побужна вулиця	Побужна вулиця
Подорожна вулиця	Подорожна вулиця
Пожежна вулиця	Пожежна вулиця
Пожежний провулок	Пожежний провулок
Пожежний проїзд	Пожежний проїзд
Пожежний узвіз	Пожежний узвіз
Правобережна вулиця	Правобережна вулиця
Правобережна площа	Правобережна площа
правобережний ДХ	правобережний ДХ
Правобережний провулок	Правобережний провулок
Православна набережна	Православна набережна
Престижна вулиця	Престижна вулиця
Престижний провулок	Престижний провулок
При низькому рівні води можна перейти по гілках	При низькому рівні води можна перейти по гілках
Прибережна автомагістраль	Прибережна автомагістраль
Прибережна вулиця	Прибережна вулиця
Прибережний провулок	Прибережний провулок
Прибережний тупик	Прибережний тупик
Прибрежна вулиця	Прибрежна вулиця
Придоріжна вулиця	Придоріжна вулиця
Придорожна вулиця	Придорожна вулиця
Прилужна вулиця	Прилужна вулиця
Приовражна вулиця	Приовражна вулиця
Приовражний провулок	Приовражний провулок
Прияружна вулиця	Прияружна вулиця
Прияружний провулок	Прияружний провулок
провулок Набережна	провулок Набережна
Проміжна вулиця	Проміжна вулиця
Проміжний провулок	Проміжний провулок
Радужна вулиця	Радужна вулиця
Радужний в’їзд	Радужний вʼїзд
Радужний провулок	Радужний провулок
Райдужна вулиця	Райдужна вулиця
Райдужний масив	Райдужний масив
Райдужний мост	Райдужний мост
Райдужний провулок	Райдужний провулок
Райдужний проїзд	Райдужний проїзд
Рапно-Набережна вулиця	Рапно-Набережна вулиця
Рапно-Набережний провулок	Рапно-Набережний провулок
растворяется в лесу (ложная)	растворяется в лесу (ложная)
Розбіжна вулиця	Розбіжна вулиця
Рубіжна вулиця	Рубіжна вулиця
Рубіжний провулок	Рубіжний провулок
Садово-Набережна вулиця	Садово-Набережна вулиця
Сміжна вулиця	Сміжна вулиця
Сніжна вулиця	Сніжна вулиця
Сніжний провулок	Сніжний провулок
Спостережна станція вулиця	Спостережна станція вулиця
Спуск Набережний	Спуск Набережний
Старомонтажна вулиця	Старомонтажна вулиця
Суміжна вулиця	Суміжна вулиця
Суміжний провулок	Суміжний провулок
Такелажний провулок	Такелажний провулок
Тампонажна вулиця	Тампонажна вулиця
Тиражна вулиця	Тиражна вулиця
Товарно-Вантажний провулок	Товарно-Вантажний провулок
Торецько-набережна вулиця	Торецько-набережна вулиця
Трикотажна вулиця	Трикотажна вулиця
Трикотажний провулок	Трикотажний провулок
Фюзеляжна вулиця	Фюзеляжна вулиця
Червономанежна вулиця	Червономанежна вулиця
Червономанєжна вулиця	Червономанєжна вулиця
Червономанєжний провулок	Червономанєжний провулок
Червононабережна вулиця	Червононабережна вулиця
Южна вулиця	Южна вулиця
Южний мікрорайон	Южний мікрорайон
Южний провулок	Южний провулок
Яружна вулиця	Яружна вулиця
Яружний провулок	Яружний провулок