Абхазька вулиця	Абхазька вулиця
Абхазький провулок	Абхазький провулок
Арцизька вулиця	Арцизька вулиця
Батозька вулиця	Батозька вулиця
Белзька вулиця	Белзька вулиця
Білобузька вулиця	Білобузька вулиця
Біловезька вулиця	Біловезька вулиця
Біловізька вулиця	Біловізька вулиця
Бугазька вулиця	Бугазька вулиця
Бузький бульвар	Бузький бульвар
Бузький провулок	Бузький провулок
Бузький узвіз	Бузький узвіз
Варязький провулок	Варязький провулок
Великолазька вулиця	Великолазька вулиця
Великолузька вулиця	Великолузька вулиця
Виборзька вулиця	Виборзька вулиця
Виборзький провулок	Виборзький провулок
Вище-Празька вулиця	Вище-Празька вулиця
Вище-Празький провулок	Вище-Празький провулок
Водолазька вулиця	Водолазька вулиця
Волзька вулиця	Волзька вулиця
Волзький в’їзд	Волзький вʼїзд
Волзький провулок	Волзький провулок
Воронезька вулиця	Воронезька вулиця
Воронезький провулок	Воронезький провулок
Вузька вулиця	Вузька вулиця
Вузький провулок	Вузький провулок
Генуезька вулиця	Генуезька вулиця
Градизький провулок	Градизький провулок
Грузька вулиця	Грузька вулиця
Дайбозька вулиця	Дайбозька вулиця
Дніпробузька вулиця	Дніпробузька вулиця
Дроговизька вулиця	Дроговизька вулиця
Житньоторзька вулиця	Житньоторзька вулиця
Забузька вулиця	Забузька вулиця
Залузька вулиця	Залузька вулиця
Залузький провулок	Залузький провулок
Запорізька вулиця	Запорізька вулиця
Запорізька площа	Запорізька площа
Запорізький вʼїзд	Запорізький вʼїзд
Запорізький провулок	Запорізький провулок
Запорізький проспект	Запорізький проспект
Запорозький провулок	Запорозький провулок
Запорiзький провулок	Запорізький провулок
Збаразька вулиця	Збаразька вулиця
Збаразький провулок	Збаразький провулок
Златопразький провулок	Златопразький провулок
Кавказька вулиця	Кавказька вулиця
Кавказька Площа вулиця	Кавказька Площа вулиця
Кавказький провулок	Кавказький провулок
Кавказький тупик	Кавказький тупик
Калузька вулиця	Калузька вулиця
Калузький провулок	Калузький провулок
Канізька вулиця	Канізька вулиця
Киргизька вулиця	Киргизька вулиця
Киргизький проїзд	Киргизький проїзд
Князька вулиця	Князька вулиця
Ков'язька вулиця	Ковʼязька вулиця
Ков’язька вулиця	Ковʼязька вулиця
Ков’язький в’їзд	Ков’язький вʼїзд
Козазька вулиця	Козазька вулиця
Кременчузька вулиця	Кременчузька вулиця
Криволужзький провулок	Криволужзький провулок
Криворізька вулиця	Криворізька вулиця
Криворізький провулок	Криворізький провулок
Криворізький проспект	Криворізький проспект
Ксьонзька вулиця	Ксьонзька вулиця
Курязька вулиця	Курязька вулиця
Ладозька вулиця	Ладозька вулиця
Ладозький провулок	Ладозький провулок
Лебязька вулиця	Лебязька вулиця
Лейпцизька вулиця	Лейпцизька вулиця
Липіврізька вулиця	Липіврізька вулиця
Липіврізький провулок	Липіврізький провулок
Лодзька вулиця	Лодзька вулиця
Лузька вулиця	Лузька вулиця
Магдебургзька вулиця	Магдебургзька вулиця
Магдебурзька вулиця	Магдебурзька вулиця
Магдебурзький провулок	Магдебурзький провулок
Марморозька вулиця	Марморозька вулиця
Марморозький провулок	Марморозький провулок
Молозька вулиця	Молозька вулиця
Надбузька вулиця	Надбузька вулиця
Неморозька вулиця	Неморозька вулиця
Низька вулиця	Низька вулиця
Низький Замок вулиця	Низький Замок вулиця
Низький провулок	Низький провулок
Ніредьгазька вулиця	Ніредьгазька вулиця
Новобузька вулиця	Новобузька вулиця
Новозапорізька вулиця	Новозапорізька вулиця
Новокриворізька вулиця	Новокриворізька вулиця
Новопразька вулиця	Новопразька вулиця
Онезька вулиця	Онезька вулиця
Онезький провулок	Онезький провулок
Оренбурзька вулиця	Оренбурзька вулиця
Острізька вулиця	Острізька вулиця
Острогозька вулиця	Острогозька вулиця
Острозька вулиця	Острозька вулиця
Острозький провулок	Острозький провулок
Паризька вулиця	Паризька вулиця
Паризький провулок	Паризький провулок
Печенізька вулиця	Печенізька вулиця
Північнокавказька вулиця	Північнокавказька вулиця
Північнокавказький в’їзд	Північнокавказький вʼїзд
Підлузький провулок	Підлузький провулок
Празька вулиця	Празька вулиця
Прибузька вулиця	Прибузька вулиця
Прибузький провулок	Прибузький провулок
Приволзька вулиця	Приволзька вулиця
Приволзький провулок	Приволзький провулок
Прилузька вулиця	Прилузька вулиця
Ризька вулиця	Ризька вулиця
Ризький квартал	Ризький квартал
Ризький провулок	Ризький провулок
Ризький проїзд	Ризький проїзд
Ризький тупик	Ризький тупик
Свитязька вулиця	Свитязька вулиця
Світязька вулиця	Світязька вулиця
Сезька вулиця	Сезька вулиця
Селизька вулиця	Селизька вулиця
Симеїзька вулиця	Симеїзька вулиця
Сілезька вулиця	Сілезька вулиця
Смизький провулок	Смизький провулок
Старотаганрозька вулиця	Старотаганрозька вулиця
Старотаразька вулиця	Старотаразька вулиця
Старотаразький провулок	Старотаразький провулок
Струзька вулиця	Струзька вулиця
Таганрозька вулиця	Таганрозька вулиця
Таганрозький проїзд	Таганрозький проїзд
Торезька вулиця	Торезька вулиця
Трубізька вулиця	Трубізька вулиця
Трубiзька вулиця	Трубізька вулиця
Узький провулок	Узький провулок
Уненізька вулиця	Уненізька вулиця
Устилузька вулиця	Устилузька вулиця
Французька вулиця	Французька вулиця
Французький бульвар	Французький бульвар
Французький бульвар вулиця	Французький бульвар вулиця
Харцизька вулиця	Харцизька вулиця
Харцизький іподром	Харцизький іподром
Хорозька вулиця	Хорозька вулиця
Чорнолізька вулиця	Чорнолізька вулиця
Шенвізька вулиця	Шенвізька вулиця
Ялпузька вулиця	Ялпузька вулиця