---Захисників України провулок	провулок Захисників України
Авіабудівників вулиця	Авіабудівників вулиця
Авіабудівників провулок	Авіабудівників провулок
Автоагрегатчиків вулиця	Автоагрегатчиків вулиця
Автобудівельників проїзд	Автобудівельників проїзд
Авторемонтників вулиця	Авторемонтників вулиця
Автотранспортників вулиця	Автотранспортників вулиця
Академіків Линників вулиця	Академіків Линників вулиця
Алея пам’яті полеглих захисників України	Алея памʼяті полеглих захисників України
Атомників вулиця	Атомників вулиця
Більшовиків вулиця	Більшовиків вулиця
Бобровників вулиця	Бобровників вулиця
Братів Василиків вулиця	Братів Василиків вулиця
Братів Лисиків вулиця	Братів Лисиків вулиця
Братів Мельників вулиця	Братів Мельників вулиця
Братів Сварників вулиця	Братів Сварників вулиця
Братів Стадників вулиця	Братів Стадників вулиця
Братів Тютюнників вулиця	Братів Тютюнників вулиця
Будівельників бульвар	Будівельників бульвар
Будівельників в'їзд	Будівельників вʼїзд
Будівельників вулиця	Будівельників вулиця
Будівельників квартал	Будівельників квартал
Будівельників мікрорайон	Будівельників мікрорайон
Будівельників провулок	Будівельників провулок
Будівельників проспект	Будівельників проспект
Будівельників шосе	Будівельників шосе
Будівників вулиця	Будівників вулиця
Будіівельників вулиця	Будівельників вулиця
Будывельників вулиця	Будывельників вулиця
Будiвельникiв вулиця	Будівельників вулиця
Буревісників вулиця	Буревісників вулиця
Буревісників провулок	Буревісників провулок
Буровиків вулиця	Буровиків вулиця
Верстатників провулок	Верстатників провулок
Верстатобудівників вулиця	Верстатобудівників вулиця
Верстатобудівників провулок	Верстатобудівників провулок
Винахідників Бикових провулок	Винахідників Бикових провулок
Винахідників вулиця	Винахідників вулиця
Винахідників провулок	Винахідників провулок
Військових будівельників вулиця	Військових будівельників вулиця
Військових Залізничників вулиця	Військових Залізничників вулиця
Водників вулиця	Водників вулиця
Водників провулок	Водників провулок
Водоочисників вулиця	Водоочисників вулиця
Вугільників вулиця	Вугільників вулиця
Вуглерозвідників вулиця	Вуглерозвідників вулиця
Газовиків вулиця	Газовиків вулиця
Газовиків провулок	Газовиків провулок
Газовиків проїзд	Газовиків проїзд
Гвардійців мінометників вулиця	Гвардійців мінометників вулиця
Гвардійців-Залізничників вулиця	Гвардійців-Залізничників вулиця
Геофізиків вулиця	Геофізиків вулиця
Геофізиків провулок	Геофізиків провулок
Героїв десантників вулиця	Героїв десантників вулиця
Героїв Десантників вулиця	Героїв Десантників вулиця
Героїв десантників провулок	Героїв десантників провулок
Героїв Захисників вулиця	Героїв Захисників вулиця
Героїв Плахотників вулиця	Героїв Плахотників вулиця
Героїв Прикордонників вулиця	Героїв Прикордонників вулиця
Героїв розвідників вулиця	Героїв розвідників вулиця
Героїв Рятувальників вулиця	Героїв Рятувальників вулиця
Героїв-підпільників вулиця	Героїв-підпільників вулиця
Героїв-підпільників проспект	Героїв-підпільників проспект
Героїв-пожежників вулиця	Героїв-пожежників вулиця
Героїв-Пожежників вулиця	Героїв-Пожежників вулиця
Героїв-прикордонників вулиця	Героїв-прикордонників вулиця
Героїв-прикордонників провулок	Героїв-прикордонників провулок
Героїв-Рятівників вулиця	Героїв-Рятівників вулиця
Героїв-Рятівників узвіз	Героїв-Рятівників узвіз
Героїв-рятувальників вулиця	Героїв-рятувальників вулиця
Героїв-Рятувальників вулиця	Героїв-Рятувальників вулиця
Гідробудівників вулиця	Гідробудівників вулиця
Гірників вулиця	Гірників вулиця
Гірників провулок	Гірників провулок
Гірників проспект	Гірників проспект
Гірськолижників узвіз	Гірськолижників узвіз
Гумовиків вулиця	Гумовиків вулиця
Деревообробників вулиця	Деревообробників вулиця
Десантників вулиця	Десантників вулиця
Десантників площа	Десантників площа
Десантників провулок	Десантників провулок
Доломітників вулиця	Доломітників вулиця
Доменщиків вулиця	Доменщиків вулиця
Доменщиків провулок	Доменщиків провулок
Домнобудівників площа	Домнобудівників площа
Дорожників в’їзд	Дорожників вʼїзд
Дорожників вулиця	Дорожників вулиця
Дружинників вулиця	Дружинників вулиця
Електриків вулиця	Електриків вулиця
Електриків провулок	Електриків провулок
Електрозварників вулиця	Електрозварників вулиця
Електромашинобудівників вулиця	Електромашинобудівників вулиця
Електромашинобудiвникiв вулиця	Електромашинобудівників вулиця
Енергетиків бульвар	Енергетиків бульвар
Енергетиків вулиця	Енергетиків вулиця
Енергетиків провулок	Енергетиків провулок
Енергетиків проспект	Енергетиків проспект
Енергетикiв вулиця	Енергетиків вулиця
Енергобудівельників вулиця	Енергобудівельників вулиця
Енергобудівельників проїзд	Енергобудівельників проїзд
Енергобудівників вулиця	Енергобудівників вулиця
Забійників вулиця	Забійників вулиця
Забійників провулок	Забійників провулок
Забійників проспект	Забійників проспект
Забудовників вулиця	Забудовників вулиця
Залізничників вулиця	Залізничників вулиця
Залізничників площа	Залізничників площа
Залізничників провулок	Залізничників провулок
Залізничників проспект	Залізничників проспект
Захисників Азовсталі проїзд	Захисників Азовсталі проїзд
Захисників вулиця	Захисників вулиця
Захисників Зміїного вулиця	Захисників Зміїного вулиця
Захисників Маріуполя вулиця	Захисників Маріуполя вулиця
Захисників Миколаєва вулиця	Захисників Миколаєва вулиця
Захисників неба вулиця	Захисників неба вулиця
Захисників провулок	Захисників провулок
Захисників України майдан	Захисників України майдан
Землевпорядників проїзд	Землевпорядників проїзд
Зенітників вулиця	Зенітників вулиця
Кабельщиків вулиця	Кабельщиків вулиця
Кварцитників вулиця	Кварцитників вулиця
Керамиків вулиця	Керамиків вулиця
Київських Будівельників вулиця	Київських Будівельників вулиця
Комсомольців-підпільників вулиця	Комсомольців-підпільників вулиця
Комунальників вулиця	Комунальників вулиця
Кріпильників вулиця	Кріпильників вулиця
Ливарників вулиця	Ливарників вулиця
Листопрокатників вулиця	Листопрокатників вулиця
Литейників вулиця	Литейників вулиця
Лірників вулиця	Лірників вулиця
Луговиків вулиця	Луговиків вулиця
Льотчиків Визволителів вулиця	Льотчиків Визволителів вулиця
Льотчиків вулиця	Льотчиків вулиця
Льотчиків провулок	Льотчиків провулок
Машинобудівельників вулиця	Машинобудівельників вулиця
Машинобудівників бульвар	Машинобудівників бульвар
Машинобудівників вулиця	Машинобудівників вулиця
Машинобудівників площа	Машинобудівників площа
Машинобудівників провулок	Машинобудівників провулок
Машинобудівників проспект	Машинобудівників проспект
Мебльовиків провулок	Мебльовиків провулок
Медиків вулиця	Медиків вулиця
Метробудівників вулиця	Метробудівників вулиця
Миколаївських Десантників вулиця	Миколаївських Десантників вулиця
Мірошників вулиця	Мірошників вулиця
Містобудівельників вулиця	Містобудівельників вулиця
Модельщиків вулиця	Модельщиків вулиця
Монтажників вулиця	Монтажників вулиця
Монтажників провулок	Монтажників провулок
Морських десантників вулиця	Морських десантників вулиця
Морських Десантників вулиця	Морських Десантників вулиця
Моряків-десантників вулиця	Моряків-десантників вулиця
Мостобудівельників вулиця	Мостобудівельників вулиця
Мостобудівників в’їзд	Мостобудівників вʼїзд
Мостобудівників вулиця	Мостобудівників вулиця
Моторобудівників вулиця	Моторобудівників вулиця
Моторобудівників проспект	Моторобудівників проспект
Наваловідбійників вулиця	Наваловідбійників вулиця
Народних Дружинників вулиця	Народних Дружинників вулиця
Наставників вулиця	Наставників вулиця
Наукових Працівників вулиця	Наукових Працівників вулиця
Нафтовиків вулиця	Нафтовиків вулиця
Нафтовиків провулок	Нафтовиків провулок
Неокласиків вулиця	Неокласиків вулиця
Овочівників вулиця	Овочівників вулиця
Паперовиків вулиця	Паперовиків вулиця
Паровозників вулиця	Паровозників вулиця
Паровозників провулок	Паровозників провулок
Партизанів-Підпільників вулиця	Партизанів-Підпільників вулиця
Передовиків вулиця	Передовиків вулиця
Перших Будівельників вулиця	Перших Будівельників вулиця
Першобудівників вулиця	Першобудівників вулиця
Письменників вулиця	Письменників вулиця
Підводників вулиця	Підводників вулиця
Підпільників ОУН вулиця	Підпільників ОУН вулиця
Побутовиків вулиця	Побутовиків вулиця
Пожежників вулиця	Пожежників вулиця
Політехників вулиця	Політехників вулиця
Праведників світу вулиця	Праведників світу вулиця
Праведників Світу вулиця	Праведників Світу вулиця
Праведників Світу провулок	Праведників Світу провулок
Прикордонників алея	Прикордонників алея
Прикордонників вулиця	Прикордонників вулиця
Прикордонників провулок	Прикордонників провулок
Приладобудівників в’їзд	Приладобудівників вʼїзд
Приладобудівників вулиця	Приладобудівників вулиця
Приладобудівників провулок	Приладобудівників провулок
Проектувальників проїзд	Проектувальників проїзд
Прокатників вулиця	Прокатників вулиця
Прохідників вулиця	Прохідників вулиця
Радянських Прикордонників вулиця	Радянських Прикордонників вулиця
Ракетників вулиця	Ракетників вулиця
Ракетників провулок	Ракетників провулок
Ракетобудівників вулиця	Ракетобудівників вулиця
Резинщиків вулиця	Резинщиків вулиця
Ремонтників вулиця	Ремонтників вулиця
Ровесникiв вулиця	Ровесників вулиця
Розвідників вулиця	Розвідників вулиця
Романтиків вулиця	Романтиків вулиця
Рятівників провулок	Рятівників провулок
Рятувальників вулиця	Рятувальників вулиця
Сільських Будівельників вулиця	Сільських Будівельників вулиця
Сірожупанників вулиця	Сірожупанників вулиця
Солянників вулиця	Солянників вулиця
Соратників вулиця	Соратників вулиця
Стадників вулиця	Стадників вулиця
Старих Більшовиків вулиця	Старих Більшовиків вулиця
Суднобудівників площа	Суднобудівників площа
Суднобудівників провулок	Суднобудівників провулок
Судноремонтників вулиця	Судноремонтників вулиця
Супутників вулиця	Супутників вулиця
Супутників провулок	Супутників провулок
Тваринників вулиця	Тваринників вулиця
Тваринників провулок	Тваринників провулок
Текстильників вулиця	Текстильників вулиця
Текстильників провулок	Текстильників провулок
Текстильників проспект	Текстильників проспект
Теплоенергетиків вулиця	Теплоенергетиків вулиця
Торф’ яників вулиця	Торфʼ яників вулиця
Тракторобудівельників вулиця	Тракторобудівельників вулиця
Тракторобудівельників проспект	Тракторобудівельників проспект
Тракторобудівників проспект	Тракторобудівників проспект
Транспортників вулиця	Транспортників вулиця
Транспортників провулок	Транспортників провулок
Транспортних Будівельників вулиця	Транспортних Будівельників вулиця
Трансформаторників вулиця	Трансформаторників вулиця
Трикотажників провулок	Трикотажників провулок
Трубників проспект	Трубників проспект
Трудівників вулиця	Трудівників вулиця
Тютюнників вулиця	Тютюнників вулиця
Ударників вулиця	Ударників вулиця
Українських Прикордонників вулиця	Українських Прикордонників вулиця
Учасників АТО вулиця	Учасників АТО вулиця
Фронтовиків бульвар	Фронтовиків бульвар
Фузиків провулок	Фузиків провулок
Харчовиків вулиця	Харчовиків вулиця
Харчовиків провулок	Харчовиків провулок
Художників вулиця	Художників вулиця
Цементників вулиця	Цементників вулиця
Цементників проспект	Цементників проспект
Цілинників вулиця	Цілинників вулиця
Цукровиків вулиця	Цукровиків вулиця
Цукровиків провулок	Цукровиків провулок
Червоних Майовщиків вулиця	Червоних Майовщиків вулиця
Червонодеревників вулиця	Червонодеревників вулиця
Шахтобудівельників бульвар	Шахтобудівельників бульвар
Шахтобудівельників проспект	Шахтобудівельників проспект
Шахтобудівників вулиця	Шахтобудівників вулиця
Шахтобудівників провулок	Шахтобудівників провулок
Шахтобудівників проспект	Шахтобудівників проспект
Шахтобудівникiв вулиця	Шахтобудівників вулиця
Шахтобудівникiв провулок	Шахтобудівників провулок
Шахтопрохідників вулиця	Шахтопрохідників вулиця
Шістдесятників вулиця	Шістдесятників вулиця
Шкіряників вулиця	Шкіряників вулиця
Шляховиків вулиця	Шляховиків вулиця
Шляховиків провулок	Шляховиків провулок
Шовківників вулиця	Шовківників вулиця