Авєріна вулиця	Авєріна вулиця
Азбукіна вулиця	Азбукіна вулиця
Азіна вулиця	Азіна вулиця
Академіка Бєлянкіна вулиця	Академіка Бєлянкіна вулиця
Академіка Весніна вулиця	Академіка Весніна вулиця
Академіка Вєркіна вулиця	Академіка Вєркіна вулиця
Академіка Крип’якевича вулиця	Академіка Крипʼякевича вулиця
Академіка Лисіна вулиця	Академіка Лисіна вулиця
Академіка Лисіна провулок	Академіка Лисіна провулок
Алгазіна вулиця	Алгазіна вулиця
Алехновича вулиця	Алехновича вулиця
Аношкіна проспект	Аношкіна проспект
Антіна Могильницького вулиця	Антіна Могильницького вулиця
Антіпіна вулиця	Антіпіна вулиця
Анюткіна вулиця	Анюткіна вулиця
Арзамакіна вулиця	Арзамакіна вулиця
Архиповича провулок	Архиповича провулок
Архітектора Нємкіна провулок	Архітектора Нємкіна провулок
Асташкіна вулиця	Асташкіна вулиця
Асташкіна провулок	Асташкіна провулок
Бабаріна вулиця	Бабаріна вулиця
Бабкевича вулиця	Бабкевича вулиця
Бадигіна вулиця	Бадигіна вулиця
Бадигіна провулок	Бадигіна провулок
Баєевича вулиця	Баєевича вулиця
Баклагіна вулиця	Баклагіна вулиця
Барболіна вулиця	Барболіна вулиця
Бардіна вулиця	Бардіна вулиця
Бахуріна вулиця	Бахуріна вулиця
Белавіна вулиця	Белавіна вулиця
Бенедиктовича вулиця	Бенедиктовича вулиця
Берзаріна вулиця	Берзаріна вулиця
Билкіна вулиця	Билкіна вулиця
Білівіна вулиця	Білівіна вулиця
Білютіна вулиця	Білютіна вулиця
Біна Суховільскої вулиця	Біна Суховільскої вулиця
Блажевича вулиця	Блажевича вулиця
Блюменталь-Тамаріна вулиця	Блюменталь-Тамаріна вулиця
Бобикевича вулиця	Бобикевича вулиця
Богушевича вулиця	Богушевича вулиця
Боролича вулиця	Боролича вулиця
Бороховича вулиця	Бороховича вулиця
Ботвіна вулиця	Ботвіна вулиця
Ботвіна вулицяё	Ботвіна вулицяё
Бочковича вулиця	Бочковича вулиця
Бочковича провулок	Бочковича провулок
Бредихіна вулиця	Бредихіна вулиця
Брусиловича вулиця	Брусиловича вулиця
Брускіна вулиця	Брускіна вулиця
Буваліна провулок	Буваліна провулок
Будівнича вулиця	Будівнича вулиця
Будкевича вулиця	Будкевича вулиця
Буздаліна вулиця	Буздаліна вулиця
Буковича вулиця	Буковича вулиця
Буреніна вулиця	Буреніна вулиця
Бутиріна вулиця	Бутиріна вулиця
Буховича вулиця	Буховича вулиця
Буховича провулок	Буховича провулок
В’ячеслава Тютіна провулок	Вʼячеслава Тютіна провулок
Варанкіна провулок	Варанкіна провулок
Васяніна вулиця	Васяніна вулиця
Ватуніна вулиця	Ватуніна вулиця
Ватутiна вулиця	Ватутіна вулиця
Вашкевича вулиця	Вашкевича вулиця
Веденіна вулиця	Веденіна вулиця
Величковича вулиця	Величковича вулиця
Велігіна вулиця	Велігіна вулиця
Венгриновича вулиця	Венгриновича вулиця
Веригіна вулиця	Веригіна вулиця
Весніна вулиця	Весніна вулиця
Весніна провулок	Весніна провулок
Весніна узвіз	Весніна узвіз
Вєрещагіна вулиця	Вєрещагіна вулиця
Видавнича вулиця	Видавнича вулиця
Виробнича вулиця	Виробнича вулиця
Висовіна вулиця	Висовіна вулиця
Високовича вулиця	Високовича вулиця
Віхніна вулиця	Віхніна вулиця
Водолазкіна вулиця	Водолазкіна вулиця
Водолазкіна вулиця 	Водолазкіна вулиця 
Войцеховича вулиця	Войцеховича вулиця
Волосевича вулиця	Волосевича вулиця
Вороніхіна вулиця	Вороніхіна вулиця
Вороніхіна провулок	Вороніхіна провулок
Вострухіна вулиця	Вострухіна вулиця
Вукаловича вулиця	Вукаловича вулиця
Гавсевича вулиця	Гавсевича вулиця
Гагагіна вулиця	Гагагіна вулиця
гагаріна вулиця	гагаріна вулиця
гАГАРІНА вулиця	гАГАРІНА вулиця
Гагарiна вулиця	Гагаріна вулиця
Газіна вулиця	Газіна вулиця
Галочкіна вулиця	Галочкіна вулиця
Галушкіна вулиця	Галушкіна вулиця
Гамазіна вулиця	Гамазіна вулиця
Гардіна вулиця	Гардіна вулиця
Гарфункіна вулиця	Гарфункіна вулиця
Гафановича вулиця	Гафановича вулиця
Генерала Гудовича вулиця	Генерала Гудовича вулиця
Генерала Ляскіна вулиця	Генерала Ляскіна вулиця
Генерала Пилькевича вулиця	Генерала Пилькевича вулиця
Генерала Пилькевича провулок	Генерала Пилькевича провулок
Генерала Швигіна вулиця	Генерала Швигіна вулиця
Генерала Шовколовича вулиця	Генерала Шовколовича вулиця
Генкіна вулиця	Генкіна вулиця
Гербича вулиця	Гербича вулиця
Гількевича вулиця	Гількевича вулиця
Гірнича вулиця	Гірнича вулиця
Глобіна провулок	Глобіна провулок
Гнєдича вулиця	Гнєдича вулиця
Гнєдича провулок	Гнєдича провулок
Голубіна вулиця	Голубіна вулиця
Городнича вулиця	Городнича вулиця
Гороновича вулиця	Гороновича вулиця
Гороновича провулок	Гороновича провулок
Горюшкіна вулиця	Горюшкіна вулиця
Горячкіна вулиця	Горячкіна вулиця
Горячкіна провулок	Горячкіна провулок
Гребьонкіна провулок	Гребьонкіна провулок
Гречихіна вулиця	Гречихіна вулиця
Гринішкіна вулиця	Гринішкіна вулиця
Гринкевича Полковника вулиця	Гринкевича Полковника вулиця
Гринкевича проспект	Гринкевича проспект
Гринцевича вулиця	Гринцевича вулиця
Грициніна вулиця	Грициніна вулиця
Грузевича провулок	Грузевича провулок
Губайдуліна вулиця	Губайдуліна вулиця
Гулькіна вулиця	Гулькіна вулиця
Дамʼянича вулиця	Дамʼянича вулиця
Даневича вулиця	Даневича вулиця
Данкевича вулиця	Данкевича вулиця
Дарвiна провулок	Дарвіна провулок
Дахновича вулиця	Дахновича вулиця
Демьохіна вулиця	Демьохіна вулиця
Дерябіна вулиця	Дерябіна вулиця
Дисевича вулиця	Дисевича вулиця
Дівича вулиця	Дівича вулиця
Дівовича вулиця	Дівовича вулиця
Доброславіна вулиця	Доброславіна вулиця
Довговича вулиця	Довговича вулиця
Дрогобича вулиця	Дрогобича вулиця
Дрьоміна вулиця	Дрьоміна вулиця
Дубиніна вулиця	Дубиніна вулиця
Дуднича вулиця	Дуднича вулиця
Душкіна вулиця	Душкіна вулиця
Дюміна вулиця	Дюміна вулиця
Дюмiна вулиця	Дюміна вулиця
Єгоровича вулиця	Єгоровича вулиця
Єлагіна вулиця	Єлагіна вулиця
Єлькіна вулиця	Єлькіна вулиця
Єрахіна вулиця	Єрахіна вулиця
Єсєніна вулиця	Єсєніна вулиця
Єсєніна провулок	Єсєніна провулок
Єчіна вулиця	Єчіна вулиця
Жатковича вулиця	Жатковича вулиця
Желяніна вулиця	Желяніна вулиця
Жигаріна вулиця	Жигаріна вулиця
Жилуновича вулиця	Жилуновича вулиця
Заварзіна вулиця	Заварзіна вулиця
Заваріхіна вулиця	Заваріхіна вулиця
Завенягіна вулиця	Завенягіна вулиця
Загаєвича вулиця	Загаєвича вулиця
Загоскіна вулиця	Загоскіна вулиця
Загоськіна вулиця	Загоськіна вулиця
Залізнича вулиця	Залізнича вулиця
Замарайкіна вулиця	Замарайкіна вулиця
Звягіна вулиця	Звягіна вулиця
Зигіна вулиця	Зигіна вулиця
Зигіна провулок	Зигіна провулок
Золіна вулиця	Золіна вулиця
Золіна провулок	Золіна провулок
Зубриліна вулиця	Зубриліна вулиця
Зубриліна провулок	Зубриліна провулок
Зубриліна проїзд	Зубриліна проїзд
Ильича проспект	Ильича проспект
Ілярія Бриковича вулиця	Ілярія Бриковича вулиця
Іоаникія Базиловича вулиця	Іоаникія Базиловича вулиця
Іоаникія Базиловича провулок	Іоаникія Базиловича провулок
Іоанікія Базиловича вулиця	Іоанікія Базиловича вулиця
Іови Кондзелевича вулиця	Іови Кондзелевича вулиця
Іоніна вулиця	Іоніна вулиця
Калабердіна вулиця	Калабердіна вулиця
Калiнiна вулиця	Калініна вулиця
Камозіна вулиця	Камозіна вулиця
Каржавіна вулиця	Каржавіна вулиця
Карнаухіна вулиця	Карнаухіна вулиця
Каспіровича вулиця	Каспіровича вулиця
Кассіна вулиця	Кассіна вулиця
Кашевича вулиця	Кашевича вулиця
Кедріна вулиця	Кедріна вулиця
Кирилкіна вулиця	Кирилкіна вулиця
Кібальчича вулиця	Кібальчича вулиця
Кілініна вулиця	Кілініна вулиця
Кіріна провулок	Кіріна провулок
Кірюхіна вулиця	Кірюхіна вулиця
Князькіна вулиця	Князькіна вулиця
Ковшевича вулиця	Ковшевича вулиця
Кожем’якіна вулиця	Кожемʼякіна вулиця
Кокоріна вулиця	Кокоріна вулиця
Кокотіна вулиця	Кокотіна вулиця
Кокушкіна вулиця	Кокушкіна вулиця
Колодіна вулиця	Колодіна вулиця
Кольчугіна вулиця	Кольчугіна вулиця
Командира Юніна вулиця	Командира Юніна вулиця
Кондзелевича вулиця	Кондзелевича вулиця
Кондрашкіна вулиця	Кондрашкіна вулиця
Конкіна вулиця	Конкіна вулиця
Константиновича вулиця	Константиновича вулиця
Конякіна вулиця	Конякіна вулиця
Копенкіна вулиця	Копенкіна вулиця
Копьонкіна вулиця	Копьонкіна вулиця
Короткевича вулиця	Короткевича вулиця
Коршуновича вулиця	Коршуновича вулиця
Корятовича вулиця	Корятовича вулиця
Корятовича площа	Корятовича площа
Корятовича провулок	Корятовича провулок
Костроміна вулиця	Костроміна вулиця
Костюріна вулиця	Костюріна вулиця
Котіна вулиця	Котіна вулиця
Кочагіна провулок	Кочагіна провулок
Кочебіна вулиця	Кочебіна вулиця
Крамнича вулиця	Крамнича вулиця
Красноперича вулиця	Красноперича вулиця
Красiна вулиця	Красіна вулиця
Кременіна вулиця	Кременіна вулиця
Кривошеіна вулиця	Кривошеіна вулиця
Крип’якевича вулиця	Крипʼякевича вулиця
Крючонкіна вулиця	Крючонкіна вулиця
Крючонкіна провулок	Крючонкіна провулок
Крючонкіна проїзд	Крючонкіна проїзд
Кубишкіна вулиця	Кубишкіна вулиця
Кулибіна вулиця	Кулибіна вулиця
Курловича вулиця	Курловича вулиця
Кутліна вулиця	Кутліна вулиця
Лабаторіна вулиця	Лабаторіна вулиця
Лавочкіна вулиця	Лавочкіна вулиця
Лазутіна вулиця	Лазутіна вулиця
Латіна провулок	Латіна провулок
Леженіна вулиця	Леженіна вулиця
Леженіна провулок	Леженіна провулок
Ленiна вулиця	Леніна вулиця
Лікаря Тарашкевича вулиця	Лікаря Тарашкевича вулиця
Ліпіна вулиця	Ліпіна вулиця
Ліснича вулиця	Ліснича вулиця
Лозановича вулиця	Лозановича вулиця
Лохтіна вулиця	Лохтіна вулиця
Лук’яновича вулиця	Лукʼяновича вулиця
Лутігіна вулиця	Лутігіна вулиця
Лутугіна вулиця	Лутугіна вулиця
Любавіна вулиця	Любавіна вулиця
Любовича вулиця	Любовича вулиця
Ляскіна вулиця	Ляскіна вулиця
Мазіна вулиця	Мазіна вулиця
Максиміхіна вулиця	Максиміхіна вулиця
Макушкіна вулиця	Макушкіна вулиця
Малашевича вулиця	Малашевича вулиця
Малигіна вулиця	Малигіна вулиця
Малишкіна вулиця	Малишкіна вулиця
Мальовнича вулиця	Мальовнича вулиця
Маневича провулок	Маневича провулок
Мануліна вулиця	Мануліна вулиця
Манькевича вулиця	Манькевича вулиця
Марченича вулиця	Марченича вулиця
Маршала Пересипкіна вулиця	Маршала Пересипкіна вулиця
Матьокіна вулиця	Матьокіна вулиця
Машкевича вулиця	Машкевича вулиця
Межевича вулиця	Межевича вулиця
Мелешкіна вулиця	Мелешкіна вулиця
Мисіна вулиця	Мисіна вулиця
Мисiна вулиця	Мисіна вулиця
Митькіна вулиця	Митькіна вулиця
Мілегіна вулиця	Мілегіна вулиця
Місевича вулиця	Місевича вулиця
Мішечкіна вулиця	Мішечкіна вулиця
Молокіна вулиця	Молокіна вулиця
Моріна вулиця	Моріна вулиця
Москвітіна вулиця	Москвітіна вулиця
Мякотіна вулиця	Мякотіна вулиця
Мялкіна вулиця	Мялкіна вулиця
Мiчурiна вулиця	Мічуріна вулиця
Надеждіна вулиця	Надеждіна вулиця
Надьожкіна вулиця	Надьожкіна вулиця
Найдіна вулиця	Найдіна вулиця
Намьоткіна вулиця	Намьоткіна вулиця
Насвітевича вулиця	Насвітевича вулиця
Недєліна вулиця	Недєліна вулиця
Недєліна Маршала вулиця	Недєліна Маршала вулиця
Недосєкіна вулиця	Недосєкіна вулиця
Неманихіна вулиця	Неманихіна вулиця
Неретіна вулиця	Неретіна вулиця
Неретіна провулок	Неретіна провулок
Нероновича вулиця	Нероновича вулиця
Неушкіна вулиця	Неушкіна вулиця
Нємкіна вулиця	Нємкіна вулиця
Нікініна провулок	Нікініна провулок
Новобудівнича вулиця	Новобудівнича вулиця
Ногіна вулиця	Ногіна вулиця
Ногіна провулок	Ногіна провулок
Носіна провулок	Носіна провулок
Оксенича вулиця	Оксенича вулиця
Оленіна вулиця	Оленіна вулиця
Опаріна провулок	Опаріна провулок
Ополонича вулиця	Ополонича вулиця
Остріяніна вулиця	Остріяніна вулиця
Оськіна вулиця	Оськіна вулиця
Осьмухіна вулиця	Осьмухіна вулиця
Осьмьоркіна вулиця	Осьмьоркіна вулиця
Отамана Мордалевича вулиця	Отамана Мордалевича вулиця
Охотнича вулиця	Охотнича вулиця
П’ятьоркіна вулиця	Пʼятьоркіна вулиця
Павлусевича вулиця	Павлусевича вулиця
Папаніна вулиця	Папаніна вулиця
Папаніна провулок	Папаніна провулок
Пересипкіна вулиця	Пересипкіна вулиця
Петліна вулиця	Петліна вулиця
Петруковича вулиця	Петруковича вулиця
Петькіна вулиця	Петькіна вулиця
Пишкіна вулиця	Пишкіна вулиця
Підгіна вулиця	Підгіна вулиця
Піддівича вулиця	Піддівича вулиця
Пілягіна вулиця	Пілягіна вулиця
Пічугіна вулиця	Пічугіна вулиця
Платухіна вулиця	Платухіна вулиця
Поворіна вулиця	Поворіна вулиця
Поворіна провулок	Поворіна провулок
Поднєвича вулиця	Поднєвича вулиця
Полбіна вулиця	Полбіна вулиця
Полбіна провулок	Полбіна провулок
Полідовича вулиця	Полідовича вулиця
Поліна вулиця	Поліна вулиця
Полосухіна вулиця	Полосухіна вулиця
Полосухіна провулок	Полосухіна провулок
Полухіна вулиця	Полухіна вулиця
Понєдєліна вулиця	Понєдєліна вулиця
Поповкіна вулиця	Поповкіна вулиця
Поручника Кедюлича вулиця	Поручника Кедюлича вулиця
Потаніна вулиця	Потаніна вулиця
Потехіна вулиця	Потехіна вулиця
Похилевича вулиця	Похилевича вулиця
Пришвіна вулиця	Пришвіна вулиця
Прішвіна вулиця	Прішвіна вулиця
Професора Зиблікевича вулиця	Професора Зиблікевича вулиця
Професора Скідіна вулиця	Професора Скідіна вулиця
Птахіна вулиця	Птахіна вулиця
Птухіна вулиця	Птухіна вулиця
Пудовкіна вулиця	Пудовкіна вулиця
Пуріна вулиця	Пуріна вулиця
Путіліна вулиця	Путіліна вулиця
Пухтаєвича вул.	Пухтаєвича вул.
Пушкiна вулиця	Пушкіна вулиця
Пушкiна провулок	Пушкіна провулок
Ракітіна вулиця	Ракітіна вулиця
Ракітіна провулок	Ракітіна провулок
Рахівнича вулиця	Рахівнича вулиця
Рахматуліна вулиця	Рахматуліна вулиця
Ревіна провулок	Ревіна провулок
Ревякіна вулиця	Ревякіна вулиця
Реміснича вулиця	Реміснича вулиця
Репіна вулиця	Репіна вулиця
Репіна провулок	Репіна провулок
Репiна вулиця	Репіна вулиця
Рецкевича вулиця	Рецкевича вулиця
Рєдіна вулиця	Рєдіна вулиця
Рєпкіна вулиця	Рєпкіна вулиця
Ринчича Базара вулиця	Ринчича Базара вулиця
Рільнича вулиця	Рільнича вулиця
Робітнича вулиця	Робітнича вулиця
Робітнича Вулиця	Робітнича Вулиця
Робітнича зупинка вулиця	Робітнича зупинка вулиця
Ровдича вулиця	Ровдича вулиця
Ромашкіна вулиця	Ромашкіна вулиця
Рукіна вулиця	Рукіна вулиця
Русановича вулиця	Русановича вулиця
Русановича провулок	Русановича провулок
Рутковича вулиця	Рутковича вулиця
Рюміна вулиця	Рюміна вулиця
Рябіна вулиця	Рябіна вулиця
Рябушкіна вулиця	Рябушкіна вулиця
Сабліна вулиця	Сабліна вулиця
Савкіна вулиця	Савкіна вулиця
Садівнича вулиця	Садівнича вулиця
Сайкіна вулиця	Сайкіна вулиця
Салманіна вулиця	Салманіна вулиця
Самишкіна провулок	Самишкіна провулок
Самусевича вулиця	Самусевича вулиця
Сапегіна вулиця	Сапегіна вулиця
Сапєгіна вулиця	Сапєгіна вулиця
Сапіна вулиця	Сапіна вулиця
Саполовича вулиця	Саполовича вулиця
Сахаліна вулиця	Сахаліна вулиця
Свірьопкіна вулиця	Свірьопкіна вулиця
Севергіна вулиця	Севергіна вулиця
Сейфуліна вулиця	Сейфуліна вулиця
Селявкіна вулиця	Селявкіна вулиця
Серафімовича вулиця	Серафімовича вулиця
Серафімовича провулок	Серафімовича провулок
Серебрича вулиця	Серебрича вулиця
Сєрафімовича вулиця	Сєрафімовича вулиця
Сєрьогіна вулиця	Сєрьогіна вулиця
Сєчкіна вулиця	Сєчкіна вулиця
Сивухіна вулиця	Сивухіна вулиця
Синявіна вулиця	Синявіна вулиця
Сисолятіна вулиця	Сисолятіна вулиця
Сікіріна вулиця	Сікіріна вулиця
Скурідіна дача	Скурідіна дача
Славутича вулиця	Славутича вулиця
Слатіна вулиця	Слатіна вулиця
Смекалкіна вулиця	Смекалкіна вулиця
Смирнихіна провулок	Смирнихіна провулок
Смоліна вулиця	Смоліна вулиця
Солодухіна вулиця	Солодухіна вулиця
Сопіна вулиця	Сопіна вулиця
Сопіна провулок	Сопіна провулок
Станкіна вулиця	Станкіна вулиця
Станюкєвича вулиця	Станюкєвича вулиця
Стеніна вулиця	Стеніна вулиця
Струпіна провулок	Струпіна провулок
Стубелевича вулиця	Стубелевича вулиця
Ступіна вулиця	Ступіна вулиця
Сушкіна вулиця	Сушкіна вулиця
Талалихіна вулиця	Талалихіна вулиця
Талаліхіна вулиця	Талаліхіна вулиця
Талаліхіна провулок	Талаліхіна провулок
Тараскіна вулиця	Тараскіна вулиця
Тарутіна вулиця	Тарутіна вулиця
Тєрьошкіна вулиця	Тєрьошкіна вулиця
Тиріна вулиця	Тиріна вулиця
Тирса Венгриновича вулиця	Тирса Венгриновича вулиця
Толбухiна вулиця	Толбухіна вулиця
Томіліна вулиця	Томіліна вулиця
Третякевича вулиця	Третякевича вулиця
Трудівнича вулиця	Трудівнича вулиця
Трункіна вулиця	Трункіна вулиця
Трушкевича вулиця	Трушкевича вулиця
Туркенича вулиця	Туркенича вулиця
Туркенича провулок	Туркенича провулок
Турутіна вулиця	Турутіна вулиця
Тьоміна вулиця	Тьоміна вулиця
Тюленіна вулиця	Тюленіна вулиця
Тюленіна провулок	Тюленіна провулок
Тюлєніна вулиця	Тюлєніна вулиця
Тюлєніна провулок	Тюлєніна провулок
Тюркіна вулиця	Тюркіна вулиця
Убаревича вулиця	Убаревича вулиця
Увлаховича вулиця	Увлаховича вулиця
Устияновича вулиця	Устияновича вулиця
Утіна вулиця	Утіна вулиця
Уткiна вулиця	Уткіна вулиця
Утiна вулиця	Утіна вулиця
Федковича вулиця	Федковича вулиця
Фісановича вулиця	Фісановича вулиця
Фісановича провулок	Фісановича провулок
Хадотовича вулиця	Хадотовича вулиця
Хатаєвича вулиця	Хатаєвича вулиця
Хворостіна вулиця	Хворостіна вулиця
Хітріна Архітектора вулиця	Хітріна Архітектора вулиця
Хлопіна вулиця	Хлопіна вулиця
Хлюпіна вулиця	Хлюпіна вулиця
Ходневича вулиця	Ходневича вулиця
Цибулькіна вулиця	Цибулькіна вулиця
Чагіна вулиця	Чагіна вулиця
Чегоріна вулиця	Чегоріна вулиця
Чекаліна вулиця	Чекаліна вулиця
Челюскіна в’їзд	Челюскіна вʼїзд
Челюскіна вулиця	Челюскіна вулиця
Челюскіна провулок	Челюскіна провулок
Чепчуріна вулиця	Чепчуріна вулиця
Черепіна вулиця	Черепіна вулиця
Черепніна проспект	Черепніна проспект
Чернавіна вулиця	Чернавіна вулиця
Чернишевича вулиця	Чернишевича вулиця
Черьомушкіна вулиця	Черьомушкіна вулиця
Чечоріна вулиця	Чечоріна вулиця
Чиркіна вулиця	Чиркіна вулиця
Чича вулиця	Чича вулиця
Чукаріна вулиця	Чукаріна вулиця
Шавріна вулиця	Шавріна вулиця
Шапоріна вулиця	Шапоріна вулиця
Шарохіна вулиця	Шарохіна вулиця
Шашуріна вулиця	Шашуріна вулиця
Шепаровича вулиця	Шепаровича вулиця
Шершавіна вулиця	Шершавіна вулиця
Шестерніна вулиця	Шестерніна вулиця
Шешкевича вулиця	Шешкевича вулиця
Широніна вулиця	Широніна вулиця
Шкапіна вулиця	Шкапіна вулиця
Шкапіна провулок	Шкапіна провулок
Шкуріна вулиця	Шкуріна вулиця
Шляховича вулиця	Шляховича вулиця
Шолбіна вулиця	Шолбіна вулиця
Шоніна вулиця	Шоніна вулиця
Шопіна вулиця	Шопіна вулиця
Шоріна вулиця	Шоріна вулиця
Шоріна провулок	Шоріна провулок
Шпагіна вулиця	Шпагіна вулиця
Штепіна вулиця	Штепіна вулиця
Шукліна вулиця	Шукліна вулиця
Шукліна провулок	Шукліна провулок
Шулейкіна вулиця	Шулейкіна вулиця
Щепкiна вулиця	Щепкіна вулиця
Щепоткіна вулиця	Щепоткіна вулиця
Щетиніна вулиця	Щетиніна вулиця
Щєпкіна вулиця	Щєпкіна вулиця
Щучкіна вулиця	Щучкіна вулиця
Юбкіна вулиця	Юбкіна вулиця
Юркіна вулиця	Юркіна вулиця
Юхневича вулиця	Юхневича вулиця
Яблочкіна вулиця	Яблочкіна вулиця
Яблочкіна провулок	Яблочкіна провулок
Яківа Миколаєвича вулиця	Яківа Миколаєвича вулиця
Яневича вулиця	Яневича вулиця
Яра Славутича вулиця	Яра Славутича вулиця
Яхимовича вулиця	Яхимовича вулиця
Cушкевича вулиця	Сушкевича вулиця