Блінна вулиця	Блінна вулиця
Вигінна вулиця	Вигінна вулиця
Вищевигінна вулиця	Вищевигінна вулиця
Відмінна вулиця	Відмінна вулиця
Водогінна вулиця	Водогінна вулиця
Вуглекамінна вулиця	Вуглекамінна вулиця
Жасмінна вулиця	Жасмінна вулиця
Кальвінна вулиця	Кальвінна вулиця
Камінна вулиця	Камінна вулиця
Кінна вулиця	Кінна вулиця
Корінна вулиця	Корінна вулиця
Кремінна вулиця	Кремінна вулиця
Курінна вулиця	Курінна вулиця
Насінна вулиця	Насінна вулиця
Нижчевигінна вулиця	Нижчевигінна вулиця
Новосінна вулиця	Новосінна вулиця
Першокінна вулиця	Першокінна вулиця
Погінна вулиця	Погінна вулиця
Прогінна вулиця	Прогінна вулиця
Сінна вулиця	Сінна вулиця
Сінна площа	Сінна площа
Старосінна площа	Старосінна площа
Турбінна вулиця	Турбінна вулиця
Уклінна вулиця	Уклінна вулиця
Автогенна вулиця	Автогенна вулиця
Автоґенна вулиця	Автоґенна вулиця
Антенна вулиця	Антенна вулиця
Базіменна вулиця	Базіменна вулиця
Баклажанна вулиця	Баклажанна вулиця
Банна вулиця	Банна вулиця
Баштанна вулиця	Баштанна вулиця
Безименна вулиця	Безименна вулиця
Безіменна вулиця	Безіменна вулиця
Вахтенна вулиця	Вахтенна вулиця
Велика Фонтанна вулиця	Велика Фонтанна вулиця
Гаванна вулиця	Гаванна вулиця
Гарманна вулиця	Гарманна вулиця
Доменна вулиця	Доменна вулиця
Желанна вулиця	Желанна вулиця
Загуменна вулиця	Загуменна вулиця
Залиманна вулиця	Залиманна вулиця
Знаменна вулиця	Знаменна вулиця
Зорянна вулиця	Зорянна вулиця
Косвенна вулиця	Косвенна вулиця
Краснознаменна вулиця	Краснознаменна вулиця
Курганна вулиця	Курганна вулиця
Лазенна вулиця	Лазенна вулиця
Лиманна вулиця	Лиманна вулиця
Ліманна вулиця	Ліманна вулиця
Лунна вулиця	Лунна вулиця
Майданна вулиця	Майданна вулиця
Малофонтанна вулиця	Малофонтанна вулиця
Набережнна вулиця	Набережнна вулиця
Надлиманна вулиця	Надлиманна вулиця
Окраїнна вулиця	Окраїнна вулиця
Південна вулиця	Південна вулиця
Південна вулицяц	Південна вулицяц
Південна дорога	Південна дорога
Піденна вулиця	Піденна вулиця
Пісенна вулиця	Пісенна вулиця
Пранна стежка	Пранна стежка
Присутственна вулиця	Присутственна вулиця
Пiвденна вулиця	Південна вулиця
Салганна вулиця	Салганна вулиця
Староказарменна дільниця вулиця	Староказарменна дільниця вулиця
Струнна вулиця	Струнна вулиця
Суверенна вулиця	Суверенна вулиця
Сухолиманна вулиця	Сухолиманна вулиця
Тюльпанна вулиця	Тюльпанна вулиця
Фонтанна вулиця	Фонтанна вулиця
Хазяйственна вулиця	Хазяйственна вулиця
Чавунна вулиця	Чавунна вулиця
Чеканна вулиця	Чеканна вулиця
Червознаменна вулиця	Червознаменна вулиця
Червонознаменна вулиця	Червонознаменна вулиця
Шафранна вулиця	Шафранна вулиця