Абельханова вулиця	Абельханова вулиця
Абельханова провулок	Абельханова провулок
Абрикосовий в’їзд	Абрикосовий вʼїзд
Абрикосовий провулок	Абрикосовий провулок
Абрикосовий тупик	Абрикосовий тупик
Абросимова вулиця	Абросимова вулиця
Авер’янова вулиця	Аверʼянова вулиця
Авер’янова провулок	Аверʼянова провулок
Авілова вулиця	Авілова вулиця
Автопаркова вулиця	Автопаркова вулиця
Автопарковий провулок	Автопарковий провулок
Автошляхова вулиця	Автошляхова вулиця
Агрусова вулиця	Агрусова вулиця
Аґрусова вулиця	Аґрусова вулиця
Адонісова вулиця	Адонісова вулиця
Азарнова вулиця	Азарнова вулиця
Азізбекова вулиця	Азізбекова вулиця
Айвова вулиця	Айвова вулиця
Айлантова вулиця	Айлантова вулиця
Айстрова вулиця	Айстрова вулиця
Алавердова вулиця	Алавердова вулиця
Алатова вулиця	Алатова вулиця
Алебастрова вулиця	Алебастрова вулиця
Алебастровий провулок	Алебастровий провулок
Алекулова вулиця	Алекулова вулиця
Аліфанова вулиця	Аліфанова вулиця
Алхімова вулиця	Алхімова вулиця
Альпова вулиця	Альпова вулиця
Альферова вулиця	Альферова вулиця
Ангелова вулиця	Ангелова вулиця
Андрелова вулиця	Андрелова вулиця
Андроннікова вулиця	Андроннікова вулиця
Антрацитовий провулок	Антрацитовий провулок
Апатова вулиця	Апатова вулиця
Аргунова вулиця	Аргунова вулиця
Аристова вулиця	Аристова вулиця
Арковий міст	Арковий міст
Артузова вулиця	Артузова вулиця
Арцеулова вулиця	Арцеулова вулиця
Асмолова вулиця	Асмолова вулиця
Астапова аллея	Астапова аллея
Афіногенова вулиця	Афіногенова вулиця
Африкантова вулиця	Африкантова вулиця
Ахсарова вулиця	Ахсарова вулиця
Ачкасова вулиця	Ачкасова вулиця
Аширбекова вулиця	Аширбекова вулиця
Аширбекова провулок	Аширбекова провулок
Баал-Шем-Това вулиця	Баал-Шем-Това вулиця
Бабенкова вулиця	Бабенкова вулиця
Багньова вулиця	Багньова вулиця
Базальтова вулиця	Базальтова вулиця
Базова вулиця	Базова вулиця
Базовий провулок	Базовий провулок
Байдарковий провулок	Байдарковий провулок
Байдовий міст	Байдовий міст
Байдукова вулиця	Байдукова вулиця
Байдукова провулок	Байдукова провулок
Байкова вулиця	Байкова вулиця
Балкова вулиця	Балкова вулиця
Балковий міст	Балковий міст
Балковий провулок	Балковий провулок
Балукова вулиця	Балукова вулиця
Балукова провулок	Балукова провулок
Балшова вулиця	Балшова вулиця
Балюкова вулиця	Балюкова вулиця
Банкова вулиця	Банкова вулиця
Баранникова вулиця	Баранникова вулиця
Бараннікова провулок	Бараннікова провулок
Барбашова вулиця	Барбашова вулиця
Барвінкова вулиця	Барвінкова вулиця
Барвінковий провулок	Барвінковий провулок
Барвінковий проїзд	Барвінковий проїзд
Барвінова вулиця	Барвінова вулиця
Барінова вулиця	Барінова вулиця
Баркалова вулиця	Баркалова вулиця
Бархутова вулиця	Бархутова вулиця
Басейнова вулиця	Басейнова вулиця
Бастракова вулиця	Бастракова вулиця
Бастрикова вулиця	Бастрикова вулиця
Батенкова вулиця	Батенкова вулиця
Батова вулиця	Батова вулиця
Башкірова провулок	Башкірова провулок
Башкiрова провулок	Башкірова провулок
Баштова вулиця	Баштова вулиця
Баштовий провулок	Баштовий провулок
Беглова вулиця	Беглова вулиця
Безменова вулиця	Безменова вулиця
Безпалова вулиця	Безпалова вулиця
Бейбулатова вулиця	Бейбулатова вулиця
Белякова вулиця	Белякова вулиця
Бендерова вулиця	Бендерова вулиця
Бендерова провулок	Бендерова провулок
Береброва вулиця	Береброва вулиця
Берегова вулиця	Берегова вулиця
Берегова провулок	Берегова провулок
Береговий провулок	Береговий провулок
Береговий тупик	Береговий тупик
Березова вулиця	Березова вулиця
Березовий в'їзд	Березовий вʼїзд
Березовий в’їзд	Березовий вʼїзд
Березовий провулок	Березовий провулок
Березюкова вулиця	Березюкова вулиця
Бересткова вулиця	Бересткова вулиця
Берестова вулиця	Берестова вулиця
Берестовий провулок	Берестовий провулок
Берізкова вулиця	Берізкова вулиця
Берінговий провулок	Берінговий провулок
Беркутова вулиця	Беркутова вулиця
Бесарабова вулиця	Бесарабова вулиця
Бесєдова вулиця	Бесєдова вулиця
Бєлороссова вулиця	Бєлороссова вулиця
Бивалова вулиця	Бивалова вулиця
Биченкова вулиця	Биченкова вулиця
Бівакова вулиця	Бівакова вулиця
Бігова вулиця	Бігова вулиця
Білокопитова вулиця	Білокопитова вулиця
Білякова вулиця	Білякова вулиця
Біржова вулиця	Біржова вулиця
Бірюзовий провулок	Бірюзовий провулок
Бічна-Лугова вулиця	Бічна-Лугова вулиця
Благовлаштована вулиця	Благовлаштована вулиця
Близнюкова вулиця	Близнюкова вулиця
Блинова вулиця	Блинова вулиця
Бобильова вулиця	Бобильова вулиця
Бобурова вулиця	Бобурова вулиця
Боженова вулиця	Боженова вулиця
Бойова вулиця	Бойова вулиця
Бойовий провулок	Бойовий провулок
Бойцова вулиця	Бойцова вулиця
Боковий провулок	Боковий провулок
Болгарова вулиця	Болгарова вулиця
Болотникова вулиця	Болотникова вулиця
Болотникова провулок	Болотникова провулок
Болотнікова вулиця	Болотнікова вулиця
Болотнікова провулок	Болотнікова провулок
Больотова вулиця	Больотова вулиця
Большунова вулиця	Большунова вулиця
Бордунова вулиця	Бордунова вулиця
Борова вулиця	Борова вулиця
Боровая вулиця	Боровая вулиця
Боровий провулок	Боровий провулок
Боровкова вулиця	Боровкова вулиця
Боровковий провулок	Боровковий провулок
Борщова вулиця	Борщова вулиця
Бочанова вулиця	Бочанова вулиця
Бочкова вулиця	Бочкова вулиця
Братчикова вулиця	Братчикова вулиця
Бризова вулиця	Бризова вулиця
Бровар вулиця	Бровар вулиця
Бровар провулок	Бровар провулок
Броварів вулиця	Броварів вулиця
Броварна вулиця	Броварна вулиця
Броварний провулок	Броварний провулок
Броварова вулиця	Броварова вулиця
Бродова вулиця	Бродова вулиця
Бронетанкова вулиця	Бронетанкова вулиця
Бронзова вулиця	Бронзова вулиця
Бронзовий провулок	Бронзовий провулок
Броньова вулиця	Броньова вулиця
Брукована вулиця	Брукована вулиця
Брюханова вулиця	Брюханова вулиця
Брюхнова вулиця	Брюхнова вулиця
Бублікова вулиця	Бублікова вулиця
Бугова вулиця	Бугова вулиця
Бугровий провулок	Бугровий провулок
Будинкова вулиця	Будинкова вулиця
Бузинова вулиця	Бузинова вулиця
Бузиновий провулок	Бузиновий провулок
Бузкова алея	Бузкова алея
Бузкова вулиця	Бузкова вулиця
Бузковий провулок	Бузковий провулок
Бузковий проїзд	Бузковий проїзд
Бузова вулиця	Бузова вулиця
Бузькова вулиця	Бузькова вулиця
Буканова вулиця	Буканова вулиця
Букова алея	Букова алея
Букова вулиця	Букова вулиця
Буковий провулок	Буковий провулок
бульвар Коробкова	бульвар Коробкова
бульвар Старшинова	бульвар Старшинова
Бумажкова вулиця	Бумажкова вулиця
Бунчукова вулиця	Бунчукова вулиця
Бунчуковий провулок	Бунчуковий провулок
Буровий провулок	Буровий провулок
Бурштинова вулиця	Бурштинова вулиця
Бурштиновий провулок	Бурштиновий провулок
Буцикова вулиця	Буцикова вулиця
Буцикова провулок	Буцикова провулок
Буянова вулиця	Буянова вулиця
В’язова вулиця	Вʼязова вулиця
В’язовий провулок	Вʼязовий провулок
Вагжанова вулиця	Вагжанова вулиця
Вагова вулиця	Вагова вулиця
Вазова вулиця	Вазова вулиця
Валова вулиця	Валова вулиця
Валовий провулок	Валовий провулок
Вантовий міст	Вантовий міст
Вапнякова вулиця	Вапнякова вулиця
Варганова вулиця	Варганова вулиця
Варченкова вулиця	Варченкова вулиця
Васильковий провулок	Васильковий провулок
Васнєцова вулиця	Васнєцова вулиця
Васнєцова провулок	Васнєцова провулок
Вежова вулиця	Вежова вулиця
Веліканова вулиця	Веліканова вулиця
Вентова вулиця	Вентова вулиця
Вербова вулиця	Вербова вулиця
Вербовий завулок	Вербовий завулок
Вербовий провулок	Вербовий провулок
Верескова вулиця	Верескова вулиця
Вересковий провулок	Вересковий провулок
Вересовий проїзд	Вересовий проїзд
Веретенікова вулиця	Веретенікова вулиця
Веретьянова провулок	Веретьянова провулок
Верстова вулиця	Верстова вулиця
Верстовий тупик	Верстовий тупик
Верхньоключова вулиця	Верхньоключова вулиця
Верхньосадова вулиця	Верхньосадова вулиця
Верхньоторгова вулиця	Верхньоторгова вулиця
Верхова вулиця	Верхова вулиця
Веселкова вулиця	Веселкова вулиця
Веселковий провулок	Веселковий провулок
Вєстова вулиця	Вєстова вулиця
Вєтрогонова вулиця	Вєтрогонова вулиця
Вивозова вулиця	Вивозова вулиця
Вивозовий провулок	Вивозовий провулок
Видова вулиця	Видова вулиця
Вижунова вулиця	Вижунова вулиця
Виноградовий провулок	Виноградовий провулок
Випасова вулиця	Випасова вулиця
Виселкова вулиця	Виселкова вулиця
Виставкова вулиця	Виставкова вулиця
Відвалова вулиця	Відвалова вулиця
Відпочинкова вулиця	Відпочинкова вулиця
Військова вулиця	Військова вулиця
Військовий провулок	Військовий провулок
Військовий проїзд	Військовий проїзд
Військовий узвіз	Військовий узвіз
Вікова вулиця	Вікова вулиця
Вілєсова вулиця	Вілєсова вулиця
Вільхова вулиця	Вільхова вулиця
Вільховий провулок	Вільховий провулок
Вільховий проїзд	Вільховий проїзд
Вітанова вулиця	Вітанова вулиця
Вітрова вулиця	Вітрова вулиця
Вітрякова вулиця	Вітрякова вулиця
Вічова вулиця	Вічова вулиця
Вовкова вулиця	Вовкова вулиця
Водоп'янова вулиця	Водопʼянова вулиця
Водоп’янова вулиця	Водопʼянова вулиця
Водоп’янова провулок	Водопʼянова провулок
Водопарковий провулок	Водопарковий провулок
Водопьянова спуск	Водопьянова спуск
Водопʼянова вулиця	Водопʼянова вулиця
Водясова вулиця	Водясова вулиця
Войкова вулиця	Войкова вулиця
Войкова провулок	Войкова провулок
Войцехова вулиця	Войцехова вулиця
Волинова вулиця	Волинова вулиця
Володимирова вулиця	Володимирова вулиця
Волошкова вулиця	Волошкова вулиця
Волошковий провулок	Волошковий провулок
Волошковий проїзд	Волошковий проїзд
Вольовий провулок	Вольовий провулок
Воскова вулиця	Воскова вулиця
Врубова вулиця	Врубова вулиця
Врубовий провулок	Врубовий провулок
Вуглова вулиця	Вуглова вулиця
Вугловий провулок	Вугловий провулок
Вузлова вулиця	Вузлова вулиця
Вузловий провулок	Вузловий провулок
вул. Торгова	вул. Торгова
Вул. Торгова	Вул. Торгова
Вуликова вулиця	Вуликова вулиця
вулиця Безпалова	вулиця Безпалова
вулиця Войкова	вулиця Войкова
вулиця Дністрова	вулиця Дністрова
вулиця Калинова	вулиця Калинова
вулиця Кирова	вулиця Кирова
вулиця Лісова	вулиця Лісова
вулиця Малинова	вулиця Малинова
вулиця Махтулова	вулиця Махтулова
вулиця Наддністрова	вулиця Наддністрова
вулиця Новобудова	вулиця Новобудова
вулиця Паркова	вулиця Паркова
вулиця Польова	вулиця Польова
вулиця Поштова	вулиця Поштова
вулиця Садова	вулиця Садова
вулиця Святкова	вулиця Святкова
вулиця Соснова	вулиця Соснова
вулиця Сурікова	вулиця Сурікова
вулиця Чіковані	вулиця Чіковані
Вулійникова вулиця	Вулійникова вулиця
Габдрахманова вулиця	Габдрахманова вулиця
Гаджибекова вулиця	Гаджибекова вулиця
Газова вулиця	Газова вулиця
Газовий провулок	Газовий провулок
Гайова вулиця	Гайова вулиця
Гайовий провулок	Гайовий провулок
Гайовий проїзд	Гайовий проїзд
Гайовий тупик	Гайовий тупик
Галанова вулиця	Галанова вулиця
Галатова вулиця	Галатова вулиця
Галовий провулок	Галовий провулок
Галушкова вулиця	Галушкова вулиця
Гарбузова вулиця	Гарбузова вулиця
Гарбузовий провулок	Гарбузовий провулок
Гардова вулиця	Гардова вулиця
Гербовий провулок	Гербовий провулок
Гирьовий провулок	Гирьовий провулок
Гіацинтова вулиця	Гіацинтова вулиця
Гіацинтовий провулок	Гіацинтовий провулок
Гідропаркова вулиця	Гідропаркова вулиця
Гільмутдінова вулиця	Гільмутдінова вулиця
Гіпсова вулиця	Гіпсова вулиця
Гірничопромислова вулиця	Гірничопромислова вулиця
Гірнопромисловий провулок	Гірнопромисловий провулок
Гірськопромислова вулиця	Гірськопромислова вулиця
Глебова вулиця	Глебова вулиця
Глекова вулиця	Глекова вулиця
Глушенкова провулок	Глушенкова провулок
Глiбова вулиця	Глібова вулиця
Гмирьова вулиця	Гмирьова вулиця
Гнилосирова вулиця	Гнилосирова вулиця
Годованого вулиця	Годованого вулиця
Годовикова вулиця	Годовикова вулиця
Головковий провулок	Головковий провулок
Голоснова вулиця	Голоснова вулиця
Голощапова вулиця	Голощапова вулиця
Голощатова вулиця	Голощатова вулиця
Гонімова вулиця	Гонімова вулиця
Горбкова вулиця	Горбкова вулиця
Горбова вулиця	Горбова вулиця
Горілова вулиця	Горілова вулиця
Горіхова вулиця	Горіхова вулиця
Горіховий в’їзд	Горіховий вʼїзд
Горіховий провулок	Горіховий провулок
Горіховий проїзд	Горіховий проїзд
Горкунова вулиця	Горкунова вулиця
Горлатова вулиця	Горлатова вулиця
Горнова вулиця	Горнова вулиця
Горобинова вулиця	Горобинова вулиця
Горобиновий в’їзд	Горобиновий вʼїзд
Горобиновий провулок	Горобиновий провулок
Горовий провулок	Горовий провулок
Горовий проїзд	Горовий проїзд
Городова вулиця	Городова вулиця
Городовикова вулиця	Городовикова вулиця
Городовікова вулиця	Городовікова вулиця
Гороховий провулок	Гороховий провулок
Горошкова вулиця	Горошкова вулиця
Горячова вулиця	Горячова вулиця
Гостроверхова вулиця	Гостроверхова вулиця
Гр. Дериглазова	Гр. Дериглазова
Грабова вулиця	Грабова вулиця
Грабовий провулок	Грабовий провулок
Градусова вулиця	Градусова вулиця
Гранатова вулиця	Гранатова вулиця
Гребеннікова вулиця	Гребеннікова вулиця
Греньова вулиця	Греньова вулиця
Гречишникова вулиця	Гречишникова вулиця
Гридасова вулиця	Гридасова вулиця
Гришунова вулиця	Гришунова вулиця
Грозова вулиця	Грозова вулиця
Грузовий провулок	Грузовий провулок
Грунтова вулиця	Грунтова вулиця
Грунтова дорога	Грунтова дорога
грунтовая дорога	грунтовая дорога
Груповий провулок	Груповий провулок
Грушникова вулиця	Грушникова вулиця
Грушова вулиця	Грушова вулиця
Грушовий провулок	Грушовий провулок
Грядкова вулиця	Грядкова вулиця
Грязнова вулиця	Грязнова вулиця
Грязнова провулок	Грязнова провулок
Гудованцева в’їзд	Гудованцева вʼїзд
Гудованцева вулиця	Гудованцева вулиця
Гуртова вулиця	Гуртова вулиця
Гуртовий провулок	Гуртовий провулок
Гуторова вулиця	Гуторова вулиця
Гушова вулиця	Гушова вулиця
Ґрунтова вулиця	Ґрунтова вулиця
Ґрунтовий провулок	Ґрунтовий провулок
Далибогова вулиця	Далибогова вулиця
Дальнова вулиця	Дальнова вулиця
Дамбова вулиця	Дамбова вулиця
Дахнова вулиця	Дахнова вулиця
Дахова вулиця	Дахова вулиця
Дача Ковалевского	Дача Ковалевского
Дворникова вулиця	Дворникова вулиця
Дворнікова вулиця	Дворнікова вулиця
Дворова вулиця	Дворова вулиця
Дворцова вулиця	Дворцова вулиця
Дворцовий провулок	Дворцовий провулок
Дворцьова вулиця	Дворцьова вулиця
Дежньова вулиця	Дежньова вулиця
Дежньова провулок	Дежньова провулок
Дем'янова вулиця	Демʼянова вулиця
Дем’янова вулиця	Демʼянова вулиця
Деманова провулок	Деманова провулок
Дендропаркова вулиця	Дендропаркова вулиця
Дербукова вулиця	Дербукова вулиця
Дерибасова вулиця	Дерибасова вулиця
Дернова вулиця	Дернова вулиця
Джгутова вулиця	Джгутова вулиця
Джутова вулиця	Джутова вулиця
Джутовий в’їзд	Джутовий вʼїзд
Джутовий провулок	Джутовий провулок
Дзвінкова вулиця	Дзвінкова вулиця
Дзвонова вулиця	Дзвонова вулиця
Дикалова вулиця	Дикалова вулиця
Диктова вулиця	Диктова вулиця
Димітрова вулиця	Димітрова вулиця
Діамантова вулиця	Діамантова вулиця
Діамантовий провулок	Діамантовий провулок
Ділова вулиця	Ділова вулиця
Дніпрова вулиця	Дніпрова вулиця
Дніпровий провулок	Дніпровий провулок
Дністрова вулиця	Дністрова вулиця
Днiпрова вулиця	Дніпрова вулиця
Добрикова вулиця	Добрикова вулиця
Додохова вулиця	Додохова вулиця
Докова вулиця	Докова вулиця
Долинова вулиця	Долинова вулиця
Долматова вулиця	Долматова вулиця
Дольникова вулиця	Дольникова вулиця
Дольнікова вулиця	Дольнікова вулиця
Доріжка польова	Доріжка польова
Дощовий провулок	Дощовий провулок
Драгова вул.	Драгова вул.
Драгунова вулиця	Драгунова вулиця
Дріжджова вулиця	Дріжджова вулиця
Дрінова вулиця	Дрінова вулиця
Дровальова вулиця	Дровальова вулиця
Дровнікова вулиця	Дровнікова вулиця
Дубова алея	Дубова алея
Дубова вулиця	Дубова вулиця
Дубова роща	Дубова роща
Дубова стежка	Дубова стежка
Дубовий провулок	Дубовий провулок
Дуговий провулок	Дуговий провулок
Дукова вулиця	Дукова вулиця
Дулова вулиця	Дулова вулиця
Дусухамбетова вулиця	Дусухамбетова вулиця
Духова вулиця	Духова вулиця
Дюґова вулиця	Дюґова вулиця
Дюжинова вулиця	Дюжинова вулиця
Дiброва вулиця	Діброва вулиця
Евкаліптова вулиця	Евкаліптова вулиця
Ельцова вулиця	Ельцова вулиця
Євграшова вулиця	Євграшова вулиця
Євплова провулок	Євплова провулок
Єгупова вулиця	Єгупова вулиця
Єжкова вулиця	Єжкова вулиця
Жадова вулиця	Жадова вулиця
Жайворонкова вулиця	Жайворонкова вулиця
Жайворонковий провулок	Жайворонковий провулок
Жанова вулиця	Жанова вулиця
Жарикова вулиця	Жарикова вулиця
Жарінова вулиця	Жарінова вулиця
Жасминова алея	Жасминова алея
Жасминова вулиця	Жасминова вулиця
Жасминовий провулок	Жасминовий провулок
Жасмінова вулиця	Жасмінова вулиця
Жасміновий бульвар	Жасміновий бульвар
Жасміновий провулок	Жасміновий провулок
Жевахова вулиця	Жевахова вулиця
Желвакова вулиця	Желвакова вулиця
Железнякова вулиця	Железнякова вулиця
Желєзнякова в’їзд	Желєзнякова вʼїзд
Желєзнякова вулиця	Желєзнякова вулиця
Жеребилова вулиця	Жеребилова вулиця
Жеріхова вулиця	Жеріхова вулиця
Живанова вулиця	Живанова вулиця
Жилова вулиця	Жилова вулиця
Житлова вулиця	Житлова вулиця
Житловий провулок	Житловий провулок
Житникова вулиця	Житникова вулиця
Жоржиновий проїзд	Жоржиновий проїзд
Жуланова вулиця	Жуланова вулиця
Забенкова вулиця	Забенкова вулиця
Задоріжкова вулиця	Задоріжкова вулиця
Займиськова вулиця	Займиськова вулиця
Зайчукова вулиця	Зайчукова вулиця
Замкова вулиця	Замкова вулиця
Замкова горішня	Замкова горішня
Замкова долішня	Замкова долішня
Замкова площа	Замкова площа
Замковий майдан	Замковий майдан
Замковий провулок	Замковий провулок
Замковий узвіз	Замковий узвіз
Запаркова вулиця	Запаркова вулиця
Зарипова вулиця	Зарипова вулиця
Зарінкова вулиця	Зарінкова вулиця
Засадкова вулиця	Засадкова вулиця
Затінкова вулиця	Затінкова вулиця
Заярова вулиця	Заярова вулиця
Збройовий провулок	Збройовий провулок
Зв'язкова вулиця	Звʼязкова вулиця
Зв’язкова вулиця	Звʼязкова вулиця
Зв’язковий провулок	Звʼязковий провулок
Зв’язковий тупик	Звʼязковий тупик
Звєрькова вулиця	Звєрькова вулиця
Зелікова вулиця	Зелікова вулиця
Земнухова вулиця	Земнухова вулиця
Зернова вулиця	Зернова вулиця
Зерновий провулок	Зерновий провулок
Зерновий проїзд	Зерновий проїзд
Зєрова вулиця	Зєрова вулиця
Зимівникова вулиця	Зимівникова вулиця
Зимова вулиця	Зимова вулиця
Зимовий провулок	Зимовий провулок
Зимовий шлях	Зимовий шлях
Зіначова вулиця	Зіначова вулиця
Зіркова вулиця	Зіркова вулиця
Зірковий провулок	Зірковий провулок
Злакова вулиця	Злакова вулиця
Зоопаркова вулиця	Зоопаркова вулиця
Зразкова вулиця	Зразкова вулиця
Зразковий провулок	Зразковий провулок
Зрубова вулиця	Зрубова вулиця
зруйнований міст	зруйнований міст
Зруйнований міст	Зруйнований міст
Зубцова вулиця	Зубцова вулиця
Івова вулиця	Івова вулиця
Іграчова вулиця	Іграчова вулиця
Ізвесткова вулиця	Ізвесткова вулиця
Ілляшкова вулиця	Ілляшкова вулиця
Ільменітовий провулок	Ільменітовий провулок
Ільмова вулиця	Ільмова вулиця
Іляшова вулиця	Іляшова вулиця
Індюкова вулиця	Індюкова вулиця
Інзова провулок	Інзова провулок
Іосьолова вулиця	Іосьолова вулиця
Йожикова вулиця	Йожикова вулиця
Кавова вулиця	Кавова вулиця
Кавунова вулиця	Кавунова вулиця
Кавюкова вулиця	Кавюкова вулиця
Каганова вулиця	Каганова вулиця
Кадочнікова вулиця	Кадочнікова вулиця
Кадрова вулиця	Кадрова вулиця
Кадровий провулок	Кадровий провулок
Казберова вулиця	Казберова вулиця
Казкова вулиця	Казкова вулиця
Казковий провулок	Казковий провулок
Казковий тунель	Казковий тунель
Калачова вулиця	Калачова вулиця
Калганова вулиця	Калганова вулиця
Каленченкова вулиця	Каленченкова вулиця
Калинова вулиця	Калинова вулиця
Калинова провулок	Калинова провулок
Калиновий в'їзд	Калиновий вʼїзд
Калиновий в’їзд	Калиновий вʼїзд
Калиновий провулок	Калиновий провулок
Калиновий проїзд	Калиновий проїзд
Каліброва вулиця	Каліброва вулиця
Калінова вулиця	Калінова вулиця
Каменовата вулиця	Каменовата вулиця
Камишова вулиця	Камишова вулиця
Кандаурова вулиця	Кандаурова вулиця
Каничникова вулиця	Каничникова вулиця
Кантемірова вулиця	Кантемірова вулиця
Каплунова вулиця	Каплунова вулиця
Капровий провулок	Капровий провулок
Карбованця вулиця	Карбованця вулиця
Карнакова вулиця	Карнакова вулиця
Картингова траса	Картингова траса
Картинговий трек	Картинговий трек
Картукова вулиця	Картукова вулиця
Катальповая аллея	Катальповая аллея
Катанова вулиця	Катанова вулиця
Катанова провулок	Катанова провулок
Катасанова вулиця	Катасанова вулиця
Катранова вулиця	Катранова вулиця
Кауркова вулиця	Кауркова вулиця
Каурова провулок	Каурова провулок
Кафтанова вулиця	Кафтанова вулиця
Качукова вулиця	Качукова вулиця
Кашкарова вулиця	Кашкарова вулиця
Кашпурова вулиця	Кашпурова вулиця
Каштановий бульвар	Каштановий бульвар
Каштановий в’їзд	Каштановий вʼїзд
Каштановий провулок	Каштановий провулок
Каштановий проїзд	Каштановий проїзд
Квасова вулиця	Квасова вулиця
Квиткова вулиця	Квиткова вулиця
Квіткова вілиця	Квіткова вілиця
Квіткова вулиця	Квіткова вулиця
Квітковий бульвар	Квітковий бульвар
Квітковий в’їзд	Квітковий вʼїзд
Квітковий провулок	Квітковий провулок
Квітковий проїзд	Квітковий проїзд
Квітковий тупик	Квітковий тупик
Квітникова вулиця	Квітникова вулиця
Квітова вулиця	Квітова вулиця
Кедрова вулиця	Кедрова вулиця
Кедровий в’їзд	Кедровий вʼїзд
Кедровий провулок	Кедровий провулок
Кедрово-Сакуровая аллея	Кедрово-Сакуровая аллея
Керамікова вулиця	Керамікова вулиця
Кизилова вулиця	Кизилова вулиця
Кизиловий провулок	Кизиловий провулок
Кизирова вулиця	Кизирова вулиця
Килимова вулиця	Килимова вулиця
Килимовий провулок	Килимовий провулок
Кимова провулок	Кимова провулок
Кипарисова вулиця	Кипарисова вулиця
Кипарисовая аллея	Кипарисовая аллея
Кипарисовий провулок	Кипарисовий провулок
Киргизова вулиця	Киргизова вулиця
Кирова проспект	Кирова проспект
Кисільова вулиця	Кисільова вулиця
Кільовий провулок	Кільовий провулок
Кільцьова вулиця	Кільцьова вулиця
Кіндякова вулиця	Кіндякова вулиця
Кладкова вулиця	Кладкова вулиця
Клапцова вулиця	Клапцова вулиця
Клеенова вулиця	Клеенова вулиця
Кленова алея	Кленова алея
Кленова балка	Кленова балка
Кленова вулиця	Кленова вулиця
Кленовий в’їзд	Кленовий вʼїзд
Кленовий провулок	Кленовий провулок
Кленовий проїзд	Кленовий проїзд
Клєвцова вулиця	Клєвцова вулиця
Клинова вулиця	Клинова вулиця
Клімовцова вулиця	Клімовцова вулиця
Ключова вулиця	Ключова вулиця
Ключовий в’їзд	Ключовий вʼїзд
Ключовий провулок	Ключовий провулок
Клюшнікова вулиця	Клюшнікова вулиця
Книжкова вулиця	Книжкова вулиця
Книжковий провулок	Книжковий провулок
Кновальця вулиця	Кновальця вулиця
Князькова вулиця	Князькова вулиця
Коваленків вулиця	Коваленків вулиця
Ковалі вулиця	Ковалі вулиця
Ковалів вулиця	Ковалів вулиця
Ковалька вулиця	Ковалька вулиця
Ковальский провулок	Ковальский провулок
Ковальского вулиця	Ковальского вулиця
Ковальчуків вулиця	Ковальчуків вулиця
Ковганова провулок	Ковганова провулок
Ковешнікова вулиця	Ковешнікова вулиця
Ковиловий провулок	Ковиловий провулок
Коврова вулиця	Коврова вулиця
Кодакова вулиця	Кодакова вулиця
Кожарова вулиця	Кожарова вулиця
Козачкова вулиця	Козачкова вулиця
Козирьова вулиця	Козирьова вулиця
Коксова вулиця	Коксова вулиця
Коксовий масив	Коксовий масив
Коксовий провулок	Коксовий провулок
Кокшарова вулиця	Кокшарова вулиця
Колерова вулиця	Колерова вулиця
Колокольцова вулиця	Колокольцова вулиця
Колонова вулиця	Колонова вулиця
Колосковий провулок	Колосковий провулок
Кольорова вулиця	Кольорова вулиця
Кольоровий провулок	Кольоровий провулок
Ком’яхова вулиця	Комʼяхова вулиця
Команова провулок	Команова провулок
Комбайнова вулиця	Комбайнова вулиця
Комбайновий провулок	Комбайновий провулок
Комбата Красникова	Комбата Красникова
Комишова вулиця	Комишова вулиця
Комкова вулиця	Комкова вулиця
Комочкова вулиця	Комочкова вулиця
Комяхова вулиця	Комяхова вулиця
Кондрова вулиця	Кондрова вулиця
Коненкова вулиця	Коненкова вулиця
Контрактова площа	Контрактова площа
Конюшиновий провулок	Конюшиновий провулок
Копиловий провулок	Копиловий провулок
Копровий провулок	Копровий провулок
Копцова вулиця	Копцова вулиця
Копцова провулок	Копцова провулок
Коралова вулиця	Коралова вулиця
Корганова вулиця	Корганова вулиця
Коркова вулиця	Коркова вулиця
Корнилова вулиця	Корнилова вулиця
Коробейнікова провулок	Коробейнікова провулок
Коробкова вулиця	Коробкова вулиця
Кортунова вулиця	Кортунова вулиця
Коршикова вулиця	Коршикова вулиця
Косінова вулиця	Косінова вулиця
Костоманова вулиця	Костоманова вулиця
Котєльнікова провулок	Котєльнікова провулок
Котлова вулиця	Котлова вулиця
Котлова провулок	Котлова провулок
Кошова вулиця	Кошова вулиця
Кошовий провулок	Кошовий провулок
Кошовий узвіз	Кошовий узвіз
Крайова вулиця	Крайова вулиця
Кракова вулиця	Кракова вулиця
Кранова вулиця	Кранова вулиця
Крановий тупик	Крановий тупик
Красильникова вулиця	Красильникова вулиця
Красікова вулиця	Красікова вулиця
Красова вулиця	Красова вулиця
Кремльова вулиця	Кремльова вулиця
Кремньова вулиця	Кремньова вулиця
Кречетова вулиця	Кречетова вулиця
Кривомазова вулиця	Кривомазова вулиця
Кривомазова провулок	Кривомазова провулок
Кривоносова вулиця	Кривоносова вулиця
Криворукова вулиця	Криворукова вулиця
Крижова вулиця	Крижова вулиця
Кришанова вулиця	Кришанова вулиця
Кришановий провулок	Кришановий провулок
Кругликова вулиця	Кругликова вулиця
Круглікова вулиця	Круглікова вулиця
Кругова вулиця	Кругова вулиця
Круговий провулок	Круговий провулок
Крукова вулиця	Крукова вулиця
Кубасова вулиця	Кубасова вулиця
Кубикова вулиця	Кубикова вулиця
Кудакова вулиця	Кудакова вулиця
Кузбасова вулиця	Кузбасова вулиця
Кузніцова вулиця	Кузніцова вулиця
Кузовкова вулиця	Кузовкова вулиця
Кузоятова вулиця	Кузоятова вулиця
Кузьмінова вулиця	Кузьмінова вулиця
Кулабухова вулиця	Кулабухова вулиця
Кульбакова вулиця	Кульбакова вулиця
Кумачовий провулок	Кумачовий провулок
Курасова вулиця	Курасова вулиця
Курасова провулок	Курасова провулок
Курашова вулиця	Курашова вулиця
Кургузова вулиця	Кургузова вулиця
Курдибанова вулиця	Курдибанова вулиця
Курдіманова вулиця	Курдіманова вулиця
Курнакова вулиця	Курнакова вулиця
Куроп’ятникова вулиця	Куропʼятникова вулиця
Курсова вулиця	Курсова вулиця
Курсовий провулок	Курсовий провулок
Курузова вулиця	Курузова вулиця
Кустолова вулиця	Кустолова вулиця
Куткова вулиця	Куткова вулиця
Кутова вулиця	Кутова вулиця
Кутовий провулок	Кутовий провулок
Куценова вулиця	Куценова вулиця
Кучумова вулиця	Кучумова вулиця
Кушнікова вулиця	Кушнікова вулиця
Кушнова вулиця	Кушнова вулиця
Кущова вулиця	Кущова вулиця
Лабузова вулиця	Лабузова вулиця
Лавандова алея	Лавандова алея
Лавандова вулиця	Лавандова вулиця
Лавкова вулиця	Лавкова вулиця
Лавреньова вулиця	Лавреньова вулиця
Лагуновий провулок	Лагуновий провулок
Лазова вулиця	Лазова вулиця
Лаймова вулиця	Лаймова вулиця
Ланковий провулок	Ланковий провулок
Ланова вулиця	Ланова вулиця
Лановий провулок	Лановий провулок
Лановий проїзд	Лановий проїзд
Ланцова вулиця	Ланцова вулиця
Ласкова вулиця	Ласкова вулиця
Ласкова провулок	Ласкова провулок
Левенцова вулиця	Левенцова вулиця
Левінцова вулиця	Левінцова вулиця
Легунова вулиця	Легунова вулиця
Леонідова вулиця	Леонідова вулиця
Лермонова вулиця	Лермонова вулиця
Лескова вулиця	Лескова вулиця
Лескова провулок	Лескова провулок
Ливанова вулиця	Ливанова вулиця
Липова алея	Липова алея
Липова вулиця	Липова вулиця
Липова-Осада вулиця	Липова-Осада вулиця
Липовий провулок	Липовий провулок
Лисікова вулиця	Лисікова вулиця
Листова вулиця	Листова вулиця
Листопадова вулиця	Листопадова вулиця
Листопадовий провулок	Листопадовий провулок
Литвінова вулиця	Литвінова вулиця
Литвінова провулок	Литвінова провулок
Лихолєтова вулиця	Лихолєтова вулиця
Личова вулиця	Личова вулиця
Лідова вулиця	Лідова вулиця
Лісанова вулиця	Лісанова вулиця
Ліскова вулиця	Ліскова вулиця
Ліскова провулок	Ліскова провулок
Лісова (Жовтнева)	Лісова (Жовтнева)
Лісова алея	Лісова алея
Лісова вулиця	Лісова вулиця
ЛІсова вулиця	ЛІсова вулиця
Лісова дорога	Лісова дорога
Лісова Дорога	Лісова Дорога
Лісова Стежка	Лісова Стежка
Лісова Україна	Лісова Україна
Лісовав вулиця	Лісовав вулиця
Лісовий в''їзд	Лісовий в'ʼїзд
Лісовий в’їзд	Лісовий вʼїзд
Лісовий провулок	Лісовий провулок
Лісовий проїзд	Лісовий проїзд
Лісовий проспект	Лісовий проспект
Лісопаркова вулиця	Лісопаркова вулиця
Лісостепова вулиця	Лісостепова вулиця
Лісостеповий тупик	Лісостеповий тупик
Літакова вулиця	Літакова вулиця
Літвинова вулиця	Літвинова вулиця
Літова вулиця	Літова вулиця
Ліфанова вулиця	Ліфанова вулиця
Ліхолетова вулиця	Ліхолетова вулиця
Ліщинова вулиця	Ліщинова вулиця
Ловцова вулиця	Ловцова вулиця
Лозова вулиця	Лозова вулиця
Лозовий провулок	Лозовий провулок
Локтюхова вулиця	Локтюхова вулиця
Ломізова вулиця	Ломізова вулиця
ломоносова вулиця	ломоносова вулиця
Луги-Клифа (вітровали!!!)	Луги-Клифа (вітровали!!!)
Лугова вулиця	Лугова вулиця
Луговая вулиця	Луговая вулиця
Луговий провулок	Луговий провулок
Луговий проїзд	Луговий проїзд
Луговий проспект	Луговий проспект
Луговцова вулиця	Луговцова вулиця
Лугопаркова вулиця	Лугопаркова вулиця
Лужникова вулиця	Лужникова вулиця
Лузанова вулиця	Лузанова вулиця
Лук’янова вулиця	Лукʼянова вулиця
Лухманова вулиця	Лухманова вулиця
Луцова вулиця	Луцова вулиця
Лучова вулиця	Лучова вулиця
Лучовий провулок	Лучовий провулок
Льодова вулиця	Льодова вулиця
Льодовий провулок	Льодовий провулок
Льонкова вулиця	Льонкова вулиця
Любімова вулиця	Любімова вулиця
Людникова вулиця	Людникова вулиця
Люднікова вулиця	Люднікова вулиця
Лютікова вулиця	Лютікова вулиця
Лянгасова вулиця	Лянгасова вулиця
Лянгузова вулиця	Лянгузова вулиця
Лiсова вулиця	Лісова вулиця
М’ясникова вулиця	Мʼясникова вулиця
М’ясникова провулок	Мʼясникова провулок
Магазинова вулиця	Магазинова вулиця
Мазунова вулиця	Мазунова вулиця
Майкова в’їзд	Майкова вʼїзд
Майоліковий провулок	Майоліковий провулок
Майстрова вулиця	Майстрова вулиця
Макерова вулиця	Макерова вулиця
Маклакова вулиця	Маклакова вулиця
Макова вулиця	Макова вулиця
Маковий провулок	Маковий провулок
Максютова вулиця	Максютова вулиця
Макухова вулиця	Макухова вулиця
Маланова провулок	Маланова провулок
Малахітова вулиця	Малахітова вулиця
Малахітовий провулок	Малахітовий провулок
Маликова вулиця	Маликова вулиця
Малинова вулиця	Малинова вулиця
Малиновий в’їзд	Малиновий вʼїзд
Малиновий провулок	Малиновий провулок
Малиновий проїзд	Малиновий проїзд
Маліхова вулиця	Маліхова вулиця
Мало-Садова вулиця	Мало-Садова вулиця
Мало-Садовий провулок	Мало-Садовий провулок
Малова вулиця	Малова вулиця
Маломостовий провулок	Маломостовий провулок
Малосадова вулиця	Малосадова вулиця
Малояровий провулок	Малояровий провулок
Мальванова вулиця	Мальванова вулиця
Мальвова вулиця	Мальвова вулиця
Мальованка вулиця	Мальованка вулиця
Малярова вулиця	Малярова вулиця
Малясова вулиця	Малясова вулиця
Мамсурова вулиця	Мамсурова вулиця
Мандаринова вулиця	Мандаринова вулиця
Мандариновий провулок	Мандариновий провулок
Маневрова вулиця	Маневрова вулиця
Маневровий провулок	Маневровий провулок
Мануйлова вулиця	Мануйлова вулиця
Маргариновий провулок	Маргариновий провулок
Маргелова вулиця	Маргелова вулиця
Маркелова вулиця	Маркелова вулиця
Марковникова вулиця	Марковникова вулиця
Мармурова вулиця	Мармурова вулиця
Мармуровий провулок	Мармуровий провулок
Марсовий провулок	Марсовий провулок
Маршова вулиця	Маршова вулиця
Масив Липовий	Масив Липовий
Масленникова вулиця	Масленникова вулиця
Матлахова вулиця	Матлахова вулиця
матросова вулиця	матросова вулиця
матросова провулок	матросова провулок
Матьхова вулиця	Матьхова вулиця
Махоркова вулиця	Махоркова вулиця
Машукова вулиця	Машукова вулиця
Маякова вулиця	Маякова вулиця
Маяковий провулок	Маяковий провулок
Медова вулиця	Медова вулиця
Медовий блюз	Медовий блюз
Медовий в’їзд	Медовий вʼїзд
Медовий провулок	Медовий провулок
Межова вулиця	Межова вулиця
Межовий провулок	Межовий провулок
Мелова вулиця	Мелова вулиця
Менчикова вулиця	Менчикова вулиця
Меренкова вулиця	Меренкова вулиця
Мерецкова вулиця	Мерецкова вулиця
Мерецкова провулок	Мерецкова провулок
Мержанова вулиця	Мержанова вулиця
Метелькова вулиця	Метелькова вулиця
Мешковий провулок	Мешковий провулок
Мєркулова вулиця	Мєркулова вулиця
Мєчникова вулиця	Мєчникова вулиця
Мєчнікова вулиця	Мєчнікова вулиця
Мєчнiкова вулиця	Мєчнікова вулиця
Милашенкова вулиця	Милашенкова вулиця
Мильовий шлях	Мильовий шлях
Минакова вулиця	Минакова вулиця
Мисова вулиця	Мисова вулиця
Митракова провулок	Митракова провулок
Митусова вулиця	Митусова вулиця
Міжрічкова вулиця	Міжрічкова вулиця
Міжсадова вулиця	Міжсадова вулиця
Мілашенкова вулиця	Мілашенкова вулиця
Мілова вулиця	Мілова вулиця
Міртова вулиця	Міртова вулиця
Міскова вулиця	Міскова вулиця
Містечкова вулиця	Містечкова вулиця
Містечковий провулок	Містечковий провулок
Містова вулиця	Містова вулиця
Мітингова вулиця	Мітингова вулиця
Мітинговий провулок	Мітинговий провулок
Мітова вулиця	Мітова вулиця
Мкртумова вулиця	Мкртумова вулиця
Млинова вулиця	Млинова вулиця
Млиновий провулок	Млиновий провулок
Могилкова вулиця	Могилкова вулиця
Модестова вулиця	Модестова вулиця
Модринова вулиця	Модринова вулиця
Модриновий провулок	Модриновий провулок
Молокова вулиця	Молокова вулиця
Молокова провулок	Молокова провулок
Молонова вулиця	Молонова вулиця
Молоткова вулиця	Молоткова вулиця
Молоткова провулок	Молоткова провулок
Молохова вулиця	Молохова вулиця
Мостова вулиця	Мостова вулиця
Мостовий в’їзд	Мостовий вʼїзд
Мостовий провулок	Мостовий провулок
мотокроссовая трасса	мотокроссовая трасса
Мохова вулиця	Мохова вулиця
Моховий провулок	Моховий провулок
Мудрова вулиця	Мудрова вулиця
Мудрова провулок	Мудрова провулок
Музальова вулиця	Музальова вулиця
Муканова вулиця	Муканова вулиця
Мулярова вулиця	Мулярова вулиця
Мурована вулиця	Мурована вулиця
Мурований міст	Мурований міст
Мурованка вулиця	Мурованка вулиця
Мухачова вулиця	Мухачова вулиця
Мяснікова вулиця	Мяснікова вулиця
Мясоєэдова вулиця	Мясоєэдова вулиця
Набережно-Лугова вулиця	Набережно-Лугова вулиця
Набережно-Луговий провулок	Набережно-Луговий провулок
Надберегова вулиця	Надберегова вулиця
Надсоснова вулиця	Надсоснова вулиця
Назімова вулиця	Назімова вулиця
Напівзруйнований міст	Напівзруйнований міст
Нардекова вулиця	Нардекова вулиця
Наріманова вулиця	Наріманова вулиця
Нартова вулиця	Нартова вулиця
Нарцисова вулиця	Нарцисова вулиця
Насонова вулиця	Насонова вулиця
Наукова вулиця	Наукова вулиця
Науковий в’їзд	Науковий вʼїзд
Науковий провулок	Науковий провулок
Науковий проїзд	Науковий проїзд
Науковий проспект	Науковий проспект
Нафтова вулиця	Нафтова вулиця
Нафтовий провулок	Нафтовий провулок
Нахимова проспект	Нахимова проспект
Нахiмова вулиця	Нахімова вулиця
Неверова вулиця	Неверова вулиця
Недоступова провулок	Недоступова провулок
Незабудкова вулиця	Незабудкова вулиця
Нейсалова вулиця	Нейсалова вулиця
Нефедова вулиця	Нефедова вулиця
Нєкрасова вулиця	Нєкрасова вулиця
Нєкрасова провулок	Нєкрасова провулок
Нижньо-Садовий в’їзд	Нижньо-Садовий вʼїзд
Нижньо-Садовий провулок	Нижньо-Садовий провулок
Нижньодворцова вулиця	Нижньодворцова вулиця
Нижньоключова вулиця	Нижньоключова вулиця
Нижньосадова вулиця	Нижньосадова вулиця
Нижче-Польова вулиця	Нижче-Польова вулиця
Нижче-Садова вулиця	Нижче-Садова вулиця
Низова вулиця	Низова вулиця
Низовий провулок	Низовий провулок
Нілова вулиця	Нілова вулиця
Нова вулиця	Нова вулиця
Нова трасса	Нова трасса
Нова-Бічна вулиця	Нова-Бічна вулиця
Новаторів вулиця	Новаторів вулиця
Новаторів провулок	Новаторів провулок
Новая вулиця	Новая вулиця
Новий бульвар	Новий бульвар
Новий в'їзд	Новий вʼїзд
Новий в’їзд	Новий вʼїзд
Новий міст	Новий міст
Новий провулок	Новий провулок
Новий проїзд	Новий проїзд
Новий тупик	Новий тупик
Новий узвіз	Новий узвіз
Ново-Садова вулиця	Ново-Садова вулиця
Ново-Степова вулиця	Ново-Степова вулиця
Новоберегова вулиця	Новоберегова вулиця
Новоброварна вулиця	Новоброварна вулиця
Новобудова вулиця	Новобудова вулиця
Новобудована вулиця	Новобудована вулиця
Новозбудований серпантин	Новозбудований серпантин
Новолісова вулиця	Новолісова вулиця
Новолозова вулиця	Новолозова вулиця
Новомежова вулиця	Новомежова вулиця
Новопаркова вулиця	Новопаркова вулиця
Новопольова вулиця	Новопольова вулиця
Новопольовий провулок	Новопольовий провулок
Новопосілкова вулиця	Новопосілкова вулиця
Новопроектова вулиця	Новопроектова вулиця
Новопроектована вулиця	Новопроектована вулиця
Новопромислова вулиця	Новопромислова вулиця
Новосадова вулиця	Новосадова вулиця
Новосадовий провулок	Новосадовий провулок
Новоселова вулиця	Новоселова вулиця
Новосодовий провулок	Новосодовий провулок
Новоставкова вулиця	Новоставкова вулиця
Новоставковий провулок	Новоставковий провулок
Новостепова вулиця	Новостепова вулиця
Новофурманова вулиця	Новофурманова вулиця
Об'їздова вулиця	Обʼїздова вулиця
Об’їздова вулиця	Обʼїздова вулиця
Оберегова вулиця	Оберегова вулиця
Обереговий провулок	Обереговий провулок
Обліпихова вулиця	Обліпихова вулиця
Обліпіхова вулиця	Обліпіхова вулиця
Овсянникова вулиця	Овсянникова вулиця
Огіркова вулиця	Огіркова вулиця
Огірковий провулок	Огірковий провулок
Оглядова вулиця	Оглядова вулиця
Оглядовий майданчик	Оглядовий майданчик
Огністова вулиця	Огністова вулиця
Огороднікова вулиця	Огороднікова вулиця
Огородова вулиця	Огородова вулиця
Одинцова вулиця	Одинцова вулиця
Ожинова вулиця	Ожинова вулиця
Ожиновий провулок	Ожиновий провулок
Окомкователів вулиця	Окомкователів вулиця
Окорокова вулиця	Окорокова вулиця
Оксамитова вулиця	Оксамитова вулиця
Оксамитовий провулок	Оксамитовий провулок
Олєйнікова вулиця	Олєйнікова вулиця
Оливкова вулиця	Оливкова вулиця
Орешкова в’їзд	Орешкова вʼїзд
Орешкова вулиця	Орешкова вулиця
Орєшкова вулиця	Орєшкова вулиця
Орєшкова провулок	Орєшкова провулок
Оріхова вулиця	Оріхова вулиця
Орішкова вулиця	Орішкова вулиця
Орликова провулок	Орликова провулок
Осетрова вулиця	Осетрова вулиця
Осикова вулиця	Осикова вулиця
Осиковий провулок	Осиковий провулок
Осинкова вулиця	Осинкова вулиця
Осинова вулиця	Осинова вулиця
Осокоровий проїзд	Осокоровий проїзд
Остафова вулиця	Остафова вулиця
Островерхова провулок	Островерхова провулок
Остроухова вулиця	Остроухова вулиця
Осьова алея	Осьова алея
Охрова вулиця	Охрова вулиця
Оцтова алея	Оцтова алея
Очеретова вулиця	Очеретова вулиця
Ощепкова вулиця	Ощепкова вулиця
Ощепкова провулок	Ощепкова провулок
Пайова вулиця	Пайова вулиця
Паланкова вулиця	Паланкова вулиця
Палацова вулиця	Палацова вулиця
Палацовий в'їзд	Палацовий вʼїзд
Пальмова вулиця	Пальмова вулиця
Пальмовая аллея	Пальмовая аллея
Пантюхова вулиця	Пантюхова вулиця
Панферова вулиця	Панферова вулиця
Панфьорова вулиця	Панфьорова вулиця
Паперова вулиця	Паперова вулиця
Паперовий провулок	Паперовий провулок
Папулова вулиця	Папулова вулиця
Папулова провулок	Папулова провулок
Парафіновий провулок	Парафіновий провулок
Паркова алея	Паркова алея
Паркова вулиця	Паркова вулиця
Паркова дорога	Паркова дорога
Паркова площа	Паркова площа
Паркова-Бічна вулиця	Паркова-Бічна вулиця
Парковий бульвар	Парковий бульвар
Парковий в'їзд	Парковий вʼїзд
Парковий в’їзд	Парковий вʼїзд
Парковий міст	Парковий міст
Парковий провулок	Парковий провулок
Парковий проїзд	Парковий проїзд
Парковий узвіз	Парковий узвіз
Парникова вулиця	Парникова вулиця
Парниковий провулок	Парниковий провулок
Парнікова вулиця	Парнікова вулиця
Парова вулиця	Парова вулиця
Паротягова вулиця	Паротягова вулиця
Парфірова вулиця	Парфірова вулиця
Парфірова провулок	Парфірова провулок
Пасова бульвар	Пасова бульвар
Пахтусова вулиця	Пахтусова вулиця
Паширова площа	Паширова площа
Пелехова вулиця	Пелехова вулиця
Пелюстковий провулок	Пелюстковий провулок
пер. Новий	пер. Новий
Передова вулиця	Передова вулиця
Передовий провулок	Передовий провулок
Перекатова вулиця	Перекатова вулиця
Перлинова вулиця	Перлинова вулиця
Перлова вулиця	Перлова вулиця
Персикова вулиця	Персикова вулиця
Персиковий провулок	Персиковий провулок
Першова вулиця	Першова вулиця
Першутова вулиця	Першутова вулиця
Пестрікова вулиця	Пестрікова вулиця
Петлякова вулиця	Петлякова вулиця
Петлякова площа	Петлякова площа
Пешкова вулиця	Пешкова вулиця
Пєвцова вулиця	Пєвцова вулиця
Пєрова вулиця	Пєрова вулиця
Пєрова провулок	Пєрова провулок
Пивоварів вулиця	Пивоварів вулиця
Пивоварна вулиця	Пивоварна вулиця
Пивоварний провулок	Пивоварний провулок
Пильчикова вулиця	Пильчикова вулиця
Писанкова вулиця	Писанкова вулиця
Писанковий провулок	Писанковий провулок
Писклова вулиця	Писклова вулиця
Північно-Степова вулиця	Північно-Степова вулиця
Пігарьова вулиця	Пігарьова вулиця
Піддіброва вулиця	Піддіброва вулиця
Підзамкова вулиця	Підзамкова вулиця
Підкова вулиця	Підкова вулиця
Підсадова вулиця	Підсадова вулиця
Підстепова вулиця	Підстепова вулиця
Підстеповий провулок	Підстеповий провулок
Підшипникова вулиця	Підшипникова вулиця
Підшипниковий провулок	Підшипниковий провулок
Піскова вулиця	Піскова вулиця
Плавньова вулиця	Плавньова вулиця
Плавньовий провулок	Плавньовий провулок
Планова вулиця	Планова вулиця
Плановий провулок	Плановий провулок
Плановий проїзд	Плановий проїзд
Пластова вулиця	Пластова вулиця
Пластовий провулок	Пластовий провулок
Пластовий тупик	Пластовий тупик
Платанова вулиця	Платанова вулиця
Платова вулиця	Платова вулиця
Платова провулок	Платова провулок
Плахова провулок	Плахова провулок
Племяшова вулиця	Племяшова вулиця
Плєханова вулиця	Плєханова вулиця
Плиткова вулиця	Плиткова вулиця
Плитковий тупик	Плитковий тупик
Плитовата вулиця	Плитовата вулиця
Плитоватий вулиця	Плитоватий вулиця
Плодова вулиця	Плодова вулиця
Плодовий провулок	Плодовий провулок
Плодовий проїзд	Плодовий проїзд
Плугова вулиця	Плугова вулиця
Плющова вулиця	Плющова вулиця
Пляхова вулиця	Пляхова вулиця
по дрова	по дрова
Побєжимова вулиця	Побєжимова вулиця
побугрова дорога	побугрова дорога
Побутова вулиця	Побутова вулиця
Побутовий провулок	Побутовий провулок
повалене дерево	повалене дерево
Поварова вулиця	Поварова вулиця
Повітова вулиця	Повітова вулиця
Повчкова вулиця	Повчкова вулиця
Податковий провулок	Податковий провулок
Подова вулиця	Подова вулиця
Подтьолкова вулиця	Подтьолкова вулиця
Покрова вулиця	Покрова вулиця
Полєнова вулиця	Полєнова вулиця
Полєнова провулок	Полєнова провулок
Полійова вулиця	Полійова вулиця
Полкова вулиця	Полкова вулиця
Полковий провулок	Полковий провулок
Полковникова вулиця	Полковникова вулиця
Полнова вулиця	Полнова вулиця
Полова вулиця	Полова вулиця
Полонина Скупова	Полонина Скупова
Полоьова вулиця	Полоьова вулиця
Полубоярова вулиця	Полубоярова вулиця
Польвова вулиця	Польвова вулиця
Польова алея	Польова алея
Польова ву	Польова ву
Польова вулиця	Польова вулиця
Польова площа	Польова площа
Польова улиця	Польова улиця
Польова-бічна вулиця	Польова-бічна вулиця
Польова-Бічна вулиця	Польова-Бічна вулиця
Польовий в’їзд	Польовий вʼїзд
Польовий заїзд	Польовий заїзд
Польовий майдан	Польовий майдан
Польовий провулок	Польовий провулок
Польовий проїзд	Польовий проїзд
Польовий тупик	Польовий тупик
Полюкова вулиця	Полюкова вулиця
Порічкова вулиця	Порічкова вулиця
Порічковий провулок	Порічковий провулок
Порохова вулиця	Порохова вулиця
Порошкова вулиця	Порошкова вулиця
Портова вулиця	Портова вулиця
Портовий провулок	Портовий провулок
Портовий узвіз	Портовий узвіз
Порцелянова вулиця	Порцелянова вулиця
Поселкова вулиця	Поселкова вулиця
Посєлкова вулиця	Посєлкова вулиця
Постанова вулиця	Постанова вулиця
Постова вулиця	Постова вулиця
Посьолкова вулиця	Посьолкова вулиця
Потічкова вулиця	Потічкова вулиця
Потокова вулиця	Потокова вулиця
Початкова вулиця	Початкова вулиця
Поченкова вулиця	Поченкова вулиця
Почтова вулиця	Почтова вулиця
Почтовий провулок	Почтовий провулок
Поштова вулиця	Поштова вулиця
Поштова Вулиця	Поштова Вулиця
Поштова вулицяm	Поштова вулиця
Поштова вулицяqq	Поштова вулиця
Поштова площа	Поштова площа
Поштовий в’їзд	Поштовий вʼїзд
Поштовий провулок	Поштовий провулок
Поштовий проспект	Поштовий проспект
Поштовий тупик	Поштовий тупик
Поштовий узвіз	Поштовий узвіз
Правова вулиця	Правова вулиця
Предмостова слобідка	Предмостова слобідка
Пресова вулиця	Пресова вулиця
Пресовий провулок	Пресовий провулок
Приберегова вул.	Приберегова вул.
Приглібова вулиця	Приглібова вулиця
Пригонова вулиця	Пригонова вулиця
Приколійова вулиця	Приколійова вулиця
Припортова вулиця	Припортова вулиця
Прирейкова вулиця	Прирейкова вулиця
Прирічкова вулиця	Прирічкова вулиця
Приступова вулиця	Приступова вулиця
Пришляховий провулок	Пришляховий провулок
Прімакова вулиця	Прімакова вулиця
провулок Лісовий	провулок Лісовий
провулок Праведнікова	провулок Праведнікова
провулок Садовий	провулок Садовий
Прогулкова вулиця	Прогулкова вулиця
Продуктова вулиця	Продуктова вулиця
Проектова вулиця	Проектова вулиця
Проектована вулиця	Проектована вулиця
Проектована-Тролейбусна вулиця	Проектована-Тролейбусна вулиця
Проїзд Парковий	Проїзд Парковий
Прокудова вулиця	Прокудова вулиця
Проліскова вулиця	Проліскова вулиця
Пролісковий провулок	Пролісковий провулок
Пролісковий проїзд	Пролісковий проїзд
Промислова вулиця	Промислова вулиця
Промисловий провулок	Промисловий провулок
Промисловий проспект	Промисловий проспект
проспект Кирова	проспект Кирова
проспект Нахимова	проспект Нахимова
Просьолкова вулиця	Просьолкова вулиця
Протитанкова вулиця	Протитанкова вулиця
Профатілова вулиця	Профатілова вулиця
Профспілкова вулиця	Профспілкова вулиця
Профспілковий бульвар	Профспілковий бульвар
Профспілковий провулок	Профспілковий провулок
Прудова вулиця	Прудова вулиця
Прудова перевулок	Прудова перевулок
Прянишнікова вулиця	Прянишнікова вулиця
Птахова вулиця	Птахова вулиця
Пузирьова вулиця	Пузирьова вулиця
Пузирьова провулок	Пузирьова провулок
Пузікова вулиця	Пузікова вулиця
Пустельникова вулиця	Пустельникова вулиця
Пустоварова вулиця	Пустоварова вулиця
Пустовойтова вулиця	Пустовойтова вулиця
Путєнцова вулиця	Путєнцова вулиця
Путьова вулиця	Путьова вулиця
Путьовий провулок	Путьовий провулок
Пухначова вулиця	Пухначова вулиця
Радонова вулиця	Радонова вулиця
Разенкова вулиця	Разенкова вулиця
Размислова вулиця	Размислова вулиця
Размислова провулок	Размислова провулок
Районова вулиця	Районова вулиця
Раковий провулок	Раковий провулок
Рампова вулиця	Рампова вулиця
Ранкова вулиця	Ранкова вулиця
Ранковий провулок	Ранковий провулок
Ранковий проїзд	Ранковий проїзд
Рапалова вулиця	Рапалова вулиця
Растопова вулиця	Растопова вулиця
Ратманова вулиця	Ратманова вулиця
Рахункова вулиця	Рахункова вулиця
Рачкова вулиця	Рачкова вулиця
Резедова вулиця	Резедова вулиця
Рейдовий провулок	Рейдовий провулок
Рейкова вулиця	Рейкова вулиця
Рейковий провулок	Рейковий провулок
Рейтузова вулиця	Рейтузова вулиця
Рейтузова провулок	Рейтузова провулок
Рекунова вулиця	Рекунова вулиця
Рекунова площа	Рекунова площа
Ренскова вулиця	Ренскова вулиця
Решетникова вулиця	Решетникова вулиця
Рєзанова вулиця	Рєзанова вулиця
Рибалкова вулиця	Рибалкова вулиця
Ринкова вулиця	Ринкова вулиця
Ринкова площа	Ринкова площа
Ринковий в’їзд	Ринковий вʼїзд
Ринковий провулок	Ринковий провулок
Ричакова вулиця	Ричакова вулиця
Ріжкова вулиця	Ріжкова вулиця
Різникова вулиця	Різникова вулиця
Рінцьова вулиця	Рінцьова вулиця
Річкова вулиця	Річкова вулиця
Річковий в’їзд	Річковий вʼїзд
Річковий провулок	Річковий провулок
Річковий проїзд	Річковий проїзд
Річковий тупик	Річковий тупик
РІЧКОВИЙ ШЛЮЗ	РІЧКОВИЙ ШЛЮЗ
Родникова вулиця	Родникова вулиця
Родниковий провулок	Родниковий провулок
Родниковий тупик	Родниковий тупик
Роднікова вулиця	Роднікова вулиця
Розмаринова вулиця	Розмаринова вулиця
Романкова вулиця	Романкова вулиця
Романькова вулиця	Романькова вулиця
Ромашкова вулиця	Ромашкова вулиця
Ромашковий провулок	Ромашковий провулок
Ромашковий проїзд	Ромашковий проїзд
Росинковий проїзд	Росинковий проїзд
Росьова вулиця	Росьова вулиця
Росьовий вулиця	Росьовий вулиця
Росьовий провулок	Росьовий провулок
Рубінова вулиця	Рубінова вулиця
Рубінова заїзд	Рубінова заїзд
Рубіновий бульвар	Рубіновий бульвар
Рубіновий провулок	Рубіновий провулок
Руденкова вулиця	Руденкова вулиця
Рудникова вулиця	Рудникова вулиця
Рудниковий в’їзд	Рудниковий вʼїзд
Рудькова вулиця	Рудькова вулиця
Рульова вулиця	Рульова вулиця
Рушникова вулиця	Рушникова вулиця
Рябінова вулиця	Рябінова вулиця
Рябіновий в'їзд	Рябіновий вʼїзд
Рядова вулиця	Рядова вулиця
Рядовий провулок	Рядовий провулок
Савчукова вулиця	Савчукова вулиця
Садкова вулиця	Садкова вулиця
Садковий провулок	Садковий провулок
Садковий проїзд	Садковий проїзд
Садова алея	Садова алея
Садова Бічна	Садова Бічна
Садова вудиця	Садова вудиця
Садова вуиця	Садова вуиця
Садова вул.	Садова вул.
Садова вулиця	Садова вулиця
Садова Вулиця	Садова Вулиця
Садова площа	Садова площа
Садовая вулиця	Садовая вулиця
Садовий бульвар	Садовий бульвар
Садовий в'їзд	Садовий вʼїзд
Садовий в’їзд	Садовий вʼїзд
Садовий перевулок	Садовий перевулок
Садовий провулок	Садовий провулок
Садовий проїзд	Садовий проїзд
Садовий проспект	Садовий проспект
Садовникова вулиця	Садовникова вулиця
Садово-Вербова вулиця	Садово-Вербова вулиця
Садовопаркова вулиця	Садовопаркова вулиця
Сазанова провулок	Сазанова провулок
Саліхова провулок	Саліхова провулок
Самбурова провулок	Самбурова провулок
Самшитова алея	Самшитова алея
Сапожинкова вулиця	Сапожинкова вулиця
Саратова вулиця	Саратова вулиця
Сасова вулиця	Сасова вулиця
Сатова вулиця	Сатова вулиця
Саянова вулиця	Саянова вулиця
Свалова вулиця	Свалова вулиця
Свдова вулиця	Свдова вулиця
Свєрдлова вулиця	Свєрдлова вулиця
Свєрдлова провулок	Свєрдлова провулок
Свєшнікова вулиця	Свєшнікова вулиця
Світанкова вулиця	Світанкова вулиця
Світанковий провулок	Світанковий провулок
Світлова провулок	Світлова провулок
Світловий провулок	Світловий провулок
Святкова вулиця	Святкова вулиця
Святковий провулок	Святковий провулок
Святковий тупик	Святковий тупик
Седашова вулиця	Седашова вулиця
Седашова провулок	Седашова провулок
Седова вулиця	Седова вулиця
Селиванова вулиця	Селиванова вулиця
Селиверстова вулиця	Селиверстова вулиця
Семенкова вулиця	Семенкова вулиця
Сердитова вулиця	Сердитова вулиця
Сердлова вулиця	Сердлова вулиця
Серікова вулиця	Серікова вулиця
Серова вулиця	Серова вулиця
Серпанкова вулиця	Серпанкова вулиця
Серпанковий провулок	Серпанковий провулок
Серпова вулиця	Серпова вулиця
Серьожнікова вулиця	Серьожнікова вулиця
Сеченова вулиця	Сеченова вулиця
Сєверова вулиця	Сєверова вулиця
Сєрікова вулиця	Сєрікова вулиця
Сєрікова провулок	Сєрікова провулок
Сєчєнова вулиця	Сєчєнова вулиця
Сєчєнова провулок	Сєчєнова провулок
Сибірякова вулиця	Сибірякова вулиця
Сивкова вулиця	Сивкова вулиця
Сиволапова вулиця	Сиволапова вулиця
Сиворонова вулиця	Сиворонова вулиця
Сиворонова провулок	Сиворонова провулок
Сиглова вулиця	Сиглова вулиця
Силова вулиця	Силова вулиця
Сильникова спуск	Сильникова спуск
Синенкова вулиця	Синенкова вулиця
Синєбрюхова вулиця	Синєбрюхова вулиця
Синцова вулиця	Синцова вулиця
Синчугова вулиця	Синчугова вулиця
Сирецько-садова вулиця	Сирецько-садова вулиця
Сиромятнікова вулиця	Сиромятнікова вулиця
Сирцова вулиця	Сирцова вулиця
Ситалова вулиця	Ситалова вулиця
Ситова вулиця	Ситова вулиця
Ситюкова вулиця	Ситюкова вулиця
Сібільова вулиця	Сібільова вулиця
Сівкова вулиця	Сівкова вулиця
Сігова вулиця	Сігова вулиця
Сіркова вулиця	Сіркова вулиця
Січова вулиця	Січова вулиця
Січова Вулиця	Січова Вулиця
Січовий в’їзд	Січовий вʼїзд
Січовий провулок	Січовий провулок
Скарбова вулиця	Скарбова вулиця
Складова вулиця	Складова вулиця
Скнарьова вулиця	Скнарьова вулиця
Скоблова вулиця	Скоблова вулиця
Скоробагатова вулиця	Скоробагатова вулиця
Скороходова вулиця	Скороходова вулиця
Скребцова провулок	Скребцова провулок
Скушнікова вулиця	Скушнікова вулиця
Сладкова вулиця	Сладкова вулиця
Сливова вулиця	Сливова вулиця
Сливовий провулок	Сливовий провулок
Сліпньова вулиця	Сліпньова вулиця
Словацького вулиця	Словацького вулиця
Словацького провулок	Словацького провулок
Службова вулиця	Службова вулиця
Службовий провулок	Службовий провулок
Службовий прохід	Службовий прохід
Смакова провулок	Смакова провулок
Смарагдова вулиця	Смарагдова вулиця
Смарагдовий провулок	Смарагдовий провулок
Смердова вулиця	Смердова вулиця
Смерекова вулиця	Смерекова вулиця
Смерековий провулок	Смерековий провулок
Смєлякова вулиця	Смєлякова вулиця
Смородинова вулиця	Смородинова вулиця
Смурова Вулиця	Смурова Вулиця
Снігова вулиця	Снігова вулиця
Сніговий провулок	Сніговий провулок
Снігурова вулиця	Снігурова вулиця
Солодилова провулок	Солодилова провулок
Солоділова вулиця	Солоділова вулиця
Солодова вулиця	Солодова вулиця
Солодовнікова вулиця	Солодовнікова вулиця
Соломонова вулиця	Соломонова вулиця
Солончакова вулиця	Солончакова вулиця
Солончаковий провулок	Солончаковий провулок
Солончаковий тупик	Солончаковий тупик
Сомовий провулок	Сомовий провулок
Соняшникова вулиця	Соняшникова вулиця
Соняшниковий в’їзд	Соняшниковий вʼїзд
Соняшниковий провулок	Соняшниковий провулок
Сорокова вулиця	Сорокова вулиця
Соснова вулиця	Соснова вулиця
Сосновий Бір	Сосновий Бір
Сосновий мікрорайон	Сосновий мікрорайон
Сосновий провулок	Сосновий провулок
Сосновий проїзд	Сосновий проїзд
Спадова вулиця	Спадова вулиця
Спасенова вулиця	Спасенова вулиця
Спендіарова вулиця	Спендіарова вулиця
Спортова вулиця	Спортова вулиця
Сроднікова вулиця	Сроднікова вулиця
Ставкова вулиця	Ставкова вулиця
Ставковий провулок	Ставковий провулок
Ставковий проїзд	Ставковий проїзд
Ставова вулиця	Ставова вулиця
Ставовий провулок	Ставовий провулок
Старова вулиця	Старова вулиця
Старова провулок	Старова провулок
Старозамкова вулиця	Старозамкова вулиця
Старомостова площа	Старомостова площа
Старопоштова вулиця	Старопоштова вулиця
Старопоштовий провулок	Старопоштовий провулок
Старопоштовий узвіз	Старопоштовий узвіз
Старосадова вулиця	Старосадова вулиця
Старофурманова вулиця	Старофурманова вулиця
Старошляхова вулиця	Старошляхова вулиця
Староярмаркова вулиця	Староярмаркова вулиця
Стартова вулиця	Стартова вулиця
Стволова вулиця	Стволова вулиця
Степова вулиця	Степова вулиця
Степова Вулиця	Степова Вулиця
Степовий в’їзд	Степовий вʼїзд
Степовий провулок	Степовий провулок
Степовий проїзд	Степовий проїзд
Степовий тупик	Степовий тупик
Стецьова вулиця	Стецьова вулиця
Стєклова вулиця	Стєклова вулиця
Стикова вулиця	Стикова вулиця
Стирова вулиця	Стирова вулиця
Стовбова вулиця	Стовбова вулиця
Стовпова вулиця	Стовпова вулиця
Стовповий провулок	Стовповий провулок
Столетова вулиця	Столетова вулиця
Сторожова вулиця	Сторожова вулиця
Сторожовий провулок	Сторожовий провулок
Стражнікова вулиця	Стражнікова вулиця
Страхова вулиця	Страхова вулиця
Стрекалова вулиця	Стрекалова вулиця
Стрельнікова вулиця	Стрельнікова вулиця
Стрепетова вулиця	Стрепетова вулиця
Стрєльнікова вулиця	Стрєльнікова вулиця
Стригунова вулиця	Стригунова вулиця
Стрілкова вулиця	Стрілкова вулиця
Стрілковий провулок	Стрілковий провулок
Стрільцова вулиця	Стрільцова вулиця
Стрічковий провулок	Стрічковий провулок
Стройова вулиця	Стройова вулиця
Стройовий плац	Стройовий плац
Строкова вулиця	Строкова вулиця
Струмкова вулиця	Струмкова вулиця
Струмковий провулок	Струмковий провулок
Струннікова вулиця	Струннікова вулиця
Стручкова вулиця	Стручкова вулиця
Стулова вулиця	Стулова вулиця
Сугерова вулиця	Сугерова вулиця
Судова вулиця	Судова вулиця
Судовий провулок	Судовий провулок
Сумова вулиця	Сумова вулиця
Сурікова вулиця	Сурікова вулиця
Сурікова провулок	Сурікова провулок
Сухинова вулиця	Сухинова вулиця
Сухинова провулок	Сухинова провулок
Сухобокова вулиця	Сухобокова вулиця
Сухопарова вулиця	Сухопарова вулиця
Сходи Артинова	Сходи Артинова
Сходова вулиця	Сходова вулиця
Таборова вулиця	Таборова вулиця
Таборовий проїзд	Таборовий проїзд
Табунова вулиця	Табунова вулиця
Табунова провулок	Табунова провулок
Тайгова вулиця	Тайгова вулиця
Таланова вулиця	Таланова вулиця
Талова вулиця	Талова вулиця
Таманова вулиця	Таманова вулиця
Танкова вулиця	Танкова вулиця
Танкова дорога	Танкова дорога
Танковая дорога	Танковая дорога
Танковий міст	Танковий міст
Танковий провулок	Танковий провулок
Тановий провулок	Тановий провулок
Танцорова вулиця	Танцорова вулиця
Таранцова провулок	Таранцова провулок
Тараскова вулиця	Тараскова вулиця
Тардова вулиця	Тардова вулиця
Тартікова вулиця	Тартікова вулиця
Тарханова вулиця	Тарханова вулиця
Тархова вулиця	Тархова вулиця
Твердохлібова вулиця	Твердохлібова вулиця
Творогова вулиця	Творогова вулиця
Тезікова вулиця	Тезікова вулиця
Телешова вулиця	Телешова вулиця
Тельнова вулиця	Тельнова вулиця
Теплова вулиця	Теплова вулиця
Теплова провулок	Теплова провулок
Терезова провулок	Терезова провулок
Терникова вулиця	Терникова вулиця
Тернова вулиця	Тернова вулиця
Терновий провулок	Терновий провулок
Терновий проїзд	Терновий проїзд
Терханова провулок	Терханова провулок
Тестова вулиця	Тестова вулиця
Тилова вулиця	Тилова вулиця
Тиловий провулок	Тиловий провулок
Тимчасова вулиця	Тимчасова вулиця
Тимчасовий об'їзд	Тимчасовий обʼїзд
Тинякова вулиця	Тинякова вулиця
Тинянова вулиця	Тинянова вулиця
Типова вулиця	Типова вулиця
Тисова вулиця	Тисова вулиця
Тікунова вулиця	Тікунова вулиця
Тікунова провулок	Тікунова провулок
Тіньова алея	Тіньова алея
Тіньова вулиця	Тіньова вулиця
Тінякова вулиця	Тінякова вулиця
Тіпанова вулиця	Тіпанова вулиця
Тіткова вулиця	Тіткова вулиця
Тіунова вулиця	Тіунова вулиця
Товариства вулиця	Товариства вулиця
товарищество Дружба	товарищество Дружба
Товарна вулиця	Товарна вулиця
Товарна площа	Товарна площа
Товарная площа	Товарная площа
Товарний провулок	Товарний провулок
Товарова вулиця	Товарова вулиця
Товаровського вулиця	Товаровського вулиця
Токова вулиця	Токова вулиця
Толочкова вулиця	Толочкова вулиця
Топольова вулиця	Топольова вулиця
Торгова вулиця	Торгова вулиця
Торгова площа	Торгова площа
Торговий в’їзд	Торговий вʼїзд
Торговий дворик	Торговий дворик
Торговий провулок	Торговий провулок
Торлова вулиця	Торлова вулиця
Тормашова вулиця	Тормашова вулиця
Торова вулиця	Торова вулиця
Торфова вулиця	Торфова вулиця
Торфовий провулок	Торфовий провулок
Трактова вулиця	Трактова вулиця
Трейл Лісовий	Трейл Лісовий
Трейл Садовий	Трейл Садовий
Треньова вулиця	Треньова вулиця
Третʼякова вулиця	Третʼякова вулиця
Трояндова вулиця	Трояндова вулиця
Трояндовий провулок	Трояндовий провулок
Трудова вулиця	Трудова вулиця
Трудовий провулок	Трудовий провулок
Трудовий проїзд	Трудовий проїзд
Трухінова вулиця	Трухінова вулиця
Тугушова вулиця	Тугушова вулиця
Тулікова вулиця	Тулікова вулиця
Тулупова вулиця	Тулупова вулиця
Тупиковий провулок	Тупиковий провулок
Тупиковий проїзд	Тупиковий проїзд
Тупікова вулиця	Тупікова вулиця
Тупіковий провулок	Тупіковий провулок
Тутарілова вулиця	Тутарілова вулиця
Тучкова вулиця	Тучкова вулиця
Тушкова вулиця	Тушкова вулиця
Тюльпанова вулиця	Тюльпанова вулиця
Тюренкова вулиця	Тюренкова вулиця
Тютюнова вулиця	Тютюнова вулиця
Тютюновий провулок	Тютюновий провулок
Тягловий міст	Тягловий міст
Тяговий провулок	Тяговий провулок
Тяпкова вулиця	Тяпкова вулиця
Углова вулиця	Углова вулиця
Угловий провулок	Угловий провулок
Удонова вулиця	Удонова вулиця
Уколова вулиця	Уколова вулиця
Уколова провулок	Уколова провулок
Улʼянова вулиця	Улʼянова вулиця
Умова вулиця	Умова вулиця
Урядовий провулок	Урядовий провулок
Утова вулиця	Утова вулиця
Уханьова вулиця	Уханьова вулиця
Учбова вулиця	Учбова вулиця
Учбовий провулок	Учбовий провулок
Фаринникова вулиця	Фаринникова вулиця
Фартовий провулок	Фартовий провулок
Фарфорова вулиця	Фарфорова вулиця
Фархутдінова вулиця	Фархутдінова вулиця
Фастова вулиця	Фастова вулиця
Февзи Билялова	Февзи Билялова
Феоктістова провулок	Феоктістова провулок
Фіалкова вулиця	Фіалкова вулиця
Фіалковий провулок	Фіалковий провулок
Фібролітова вулиця	Фібролітова вулиця
Фідарова вулиця	Фідарова вулиця
Філіваркова вулиця	Філіваркова вулиця
Філодорова вулиця	Філодорова вулиця
Фільваркова вулиця	Фільваркова вулиця
Фількова вулиця	Фількова вулиця
Фільова вулиця	Фільова вулиця
Фільтрова вулиця	Фільтрова вулиця
Фінансова вулиця	Фінансова вулиця
Фіолетова вулиця	Фіолетова вулиця
Фіронова вулиця	Фіронова вулиця
Фісташкова вулиця	Фісташкова вулиця
Флангова вулиця	Флангова вулиця
Фофанова вулиця	Фофанова вулиця
Фронтова вулиця	Фронтова вулиця
Фронтовий провулок	Фронтовий провулок
Фруктова вулиця	Фруктова вулиця
Фруктовий провулок	Фруктовий провулок
Фруктовий проїзд	Фруктовий проїзд
Хабарова вулиця	Хабарова вулиця
Хазова вулиця	Хазова вулиця
Хакімова вулиця	Хакімова вулиця
Халікова вулиця	Халікова вулиця
Хальзова вулиця	Хальзова вулиця
Хальзунова вулиця	Хальзунова вулиця
Харчевникова вулиця	Харчевникова вулиця
Харченкова вулиця	Харченкова вулиця
Харчова вулиця	Харчова вулиця
Хасанова вулиця	Хасанова вулиця
Хачатурова вулиця	Хачатурова вулиця
Хвильова вулиця	Хвильова вулиця
Хетагурова вулиця	Хетагурова вулиця
Хлястікова вулиця	Хлястікова вулиця
Хмельова вулиця	Хмельова вулиця
Хмельовий провулок	Хмельовий провулок
Хмільова вулиця	Хмільова вулиця
Хмільовий провулок	Хмільовий провулок
Ходякова вулиця	Ходякова вулиця
Холодкова вулиця	Холодкова вулиця
Хорошкова вулиця	Хорошкова вулиця
Хорчінова вулиця	Хорчінова вулиця
Храмовий провулок	Храмовий провулок
Хрептюкова вулиця	Хрептюкова вулиця
Хрестовий провулок	Хрестовий провулок
Хрунова вулиця	Хрунова вулиця
Худайбергенова вулиця	Худайбергенова вулиця
Цвіткова вулиця	Цвіткова вулиця
Ценикова вулиця	Ценикова вулиця
Цеолітова вулиця	Цеолітова вулиця
Цехова вулиця	Цехова вулиця
Цеховий провулок	Цеховий провулок
Цинкова вулиця	Цинкова вулиця
Цирковий провулок	Цирковий провулок
Цитрусова вулиця	Цитрусова вулиця
Цукрова вулиця	Цукрова вулиця
Цукрова гірка	Цукрова гірка
Цукровий завод	Цукровий завод
Цукровий провулок	Цукровий провулок
Цупова вулиця	Цупова вулиця
Чавдарова вулиця	Чавдарова вулиця
Чагарникова вулиця	Чагарникова вулиця
Чалова провулок	Чалова провулок
Чвертьова вулиця	Чвертьова вулиця
Челпанова вулиця	Челпанова вулиця
Черв'якова вулиця	Червʼякова вулиця
Червонокалиновий провулок	Червонокалиновий провулок
Червоношляховий провулок	Червоношляховий провулок
Черемухова вулиця	Черемухова вулиця
Черемхова вулиця	Черемхова вулиця
Черемховий проїзд	Черемховий проїзд
Черемшинова вулиця	Черемшинова вулиця
Черемшиновий завулок	Черемшиновий завулок
Черемшиновий провулок	Черемшиновий провулок
Черникова вулиця	Черникова вулиця
Чернихова вулиця	Чернихова вулиця
Чертова лестница	Чертова лестница
Чибісова вулиця	Чибісова вулиця
Чигирьова вулиця	Чигирьова вулиця
Чигринова вулиця	Чигринова вулиця
Чикирисова провулок	Чикирисова провулок
Чикірисова вулиця	Чикірисова вулиця
Чиковані вулиця	Чиковані вулиця
Числова вулиця	Числова вулиця
Чихачова вулиця	Чихачова вулиця
Чібісова вулиця	Чібісова вулиця
Чікалова вулиця	Чікалова вулиця
Чоботарьова вулиця	Чоботарьова вулиця
Човнова вулиця	Човнова вулиця
Човновий провулок	Човновий провулок
Чудинова вулиця	Чудинова вулиця
Чудова вулиця	Чудова вулиця
Чудовий провулок	Чудовий провулок
Чуйкова в’їзд	Чуйкова вʼїзд
Чуйкова вулиця	Чуйкова вулиця
Чукмарьова вулиця	Чукмарьова вулиця
Чуракова вулиця	Чуракова вулиця
Чурілова вулиця	Чурілова вулиця
Чурілова провулок	Чурілова провулок
Чучупалова вулиця	Чучупалова вулиця
Шабельникова вулиця	Шабельникова вулиця
Шаймуратова вулиця	Шаймуратова вулиця
Шапова вулиця	Шапова вулиця
Шариковий в’їзд	Шариковий вʼїзд
Шариковий проїзд	Шариковий проїзд
Шатилова дача	Шатилова дача
Шаховий провулок	Шаховий провулок
Шаховий проїзд	Шаховий проїзд
Шахтова вулиця	Шахтова вулиця
Шварова вулиця	Шварова вулиця
Шевченкова вулиця	Шевченкова вулиця
Шелгунова вулиця	Шелгунова вулиця
Шелепова вулиця	Шелепова вулиця
Шелковнікова вулиця	Шелковнікова вулиця
Шелохова провулок	Шелохова провулок
Шелушкова вулиця	Шелушкова вулиця
Шеменкова вулиця	Шеменкова вулиця
Шепетова вулиця	Шепетова вулиця
Шереметова вулиця	Шереметова вулиця
Шешукова вулиця	Шешукова вулиця
Шибанкова вулиця	Шибанкова вулиця
Шибанкова площа	Шибанкова площа
Шикунова провулок	Шикунова провулок
Ширшова в`їзд	Ширшова вʼїзд
Ширшова вулиця	Ширшова вулиця
Ширшова провулок	Ширшова провулок
Ширшова тупик	Ширшова тупик
Шитикова вулиця	Шитикова вулиця
Шитікова вулиця	Шитікова вулиця
Шитова вулиця	Шитова вулиця
Шкадінова вулиця	Шкадінова вулиця
Шкірятова вулиця	Шкірятова вулиця
Шкодова гора	Шкодова гора
Шлакова вулиця	Шлакова вулиця
Шлаковий провулок	Шлаковий провулок
Шлаковий тупик	Шлаковий тупик
Шламова вулиця	Шламова вулиця
Шлюзова вулиця	Шлюзова вулиця
Шляховий в’їзд	Шляховий вʼїзд
Шляховий провулок	Шляховий провулок
Шмирьова вулиця	Шмирьова вулиця
Шовкова вулиця	Шовкова вулиця
Шосова вулиця	Шосова вулиця
Шостакова вулиця	Шостакова вулиця
Шпакова вулиця	Шпакова вулиця
Шпаковий провулок	Шпаковий провулок
Шпильова вулиця	Шпильова вулиця
Штильова вулиця	Штильова вулиця
Штирова вулиця	Штирова вулиця
Штормова вулиця	Штормова вулиця
Штормовий провулок	Штормовий провулок
Штурмова вулиця	Штурмова вулиця
Шубнікова вулиця	Шубнікова вулиця
Шумілова вулиця	Шумілова вулиця
Шурупова вулиця	Шурупова вулиця
Шуткова вулиця	Шуткова вулиця
Щелгунова вулиця	Щелгунова вулиця
Щелканова вулиця	Щелканова вулиця
Щепова вулиця	Щепова вулиця
Щєрбакова вулиця	Щєрбакова вулиця
Щитова вулиця	Щитова вулиця
Щоглова вулиця	Щоглова вулиця
Югова вулиця	Югова вулиця
Южакова вулиця	Южакова вулиця
Юрасова вулиця	Юрасова вулиця
Юрова вулиця	Юрова вулиця
Юрова провулок	Юрова провулок
Юхвітова вулиця	Юхвітова вулиця
Яблочкова вулиця	Яблочкова вулиця
Яблочкова провулок	Яблочкова провулок
Яворова вулиця	Яворова вулиця
Яворовий провулок	Яворовий провулок
Язикова вулиця	Язикова вулиця
Ялинкова алея	Ялинкова алея
Ялинкова вулиця	Ялинкова вулиця
Ялинковий провулок	Ялинковий провулок
Ялинова алея	Ялинова алея
Ялинова вулиця	Ялинова вулиця
Яркова вулиця	Яркова вулиця
Ярковий провулок	Ярковий провулок
Ярмаркова вулиця	Ярмаркова вулиця
Ярмаркова площа	Ярмаркова площа
Ярмарковий в’їзд	Ярмарковий вʼїзд
Ярмарковий провулок	Ярмарковий провулок
Ярмарковий узвіз	Ярмарковий узвіз
Ярова вулиця	Ярова вулиця
Яровий провулок	Яровий провулок
Ясенова вулиця	Ясенова вулиця
Ясеновий провулок	Ясеновий провулок
Ясеньова вулиця	Ясеньова вулиця
Ясинова вулиця	Ясинова вулиця
Ясьова криниця	Ясьова криниця
Яхонтова вулиця	Яхонтова вулиця
Яценкова вулиця	Яценкова вулиця
Яцькова вулиця	Яцькова вулиця
Cадова вулиця	Садова вулиця
Cадова Вулиця	Садова Вулиця
Cічова вулиця	Січова вулиця
Cмерекова вулиця	Смерекова вулиця
Cуворова провулок	Суворова провулок