Адмірала Басистого вулиця	Адмірала Басистого вулиця
Адмірала Щасного вулиця	Адмірала Щасного вулиця
Академіка Белецького вулиця	Академіка Белецького вулиця
Андрузького вулиця	Андрузького вулиця
Архітектора Метельницького вулиця	Архітектора Метельницького вулиця
Багрицкого вулиця	Багрицкого вулиця
Безгребельного вулиця	Безгребельного вулиця
Бездворного вулиця	Бездворного вулиця
Бездільного вулиця	Бездільного вулиця
Безкаравайного вулиця	Безкаравайного вулиця
Безроднього вулиця	Безроднього вулиця
Безценного вулиця	Безценного вулиця
Белецького вулиця	Белецького вулиця
Бережницького вулиця	Бережницького вулиця
Березневого Повстання вулиця	Березневого Повстання вулиця
Блакитного вулиця	Блакитного вулиця
Блакитного провулок	Блакитного провулок
Борлуцького провулок	Борлуцького провулок
Боровіцького вулиця	Боровіцького вулиця
Броніцького вулиця	Броніцького вулиця
Брязького вулиця	Брязького вулиця
Будьоннного вулиця	Будьоннного вулиця
Будьоного вулиця	Будьоного вулиця
Будьоного провулок	Будьоного провулок
Бузького Козацтва вулиця	Бузького Козацтва вулиця
Бузького полку вулиця	Бузького полку вулиця
Бурлуцького вулиця	Бурлуцького вулиця
Бурлуцького провулок	Бурлуцького провулок
Бiлецького вулиця	Білецького вулиця
Василенького вулиця	Василенького вулиця
Великого Жовтня вулиця	Великого Жовтня вулиця
Вербовецького вулиця	Вербовецького вулиця
Вирового провулок	Вирового провулок
Висоцкого вулиця	Висоцкого вулиця
Вишиваного вулиця	Вишиваного вулиця
Вишневького вулиця	Вишневького вулиця
Вишнивецького вулиця	Вишнивецького вулиця
Вільного козацтва вулиця	Вільного козацтва вулиця
Вільного Козацтва вулиця	Вільного Козацтва вулиця
Вітряного вулиця	Вітряного вулиця
Віце-адмірала Синецького вулиця	Віце-адмірала Синецького вулиця
Вольного вулиця	Вольного вулиця
Воровского вулиця	Воровского вулиця
Воротного вулиця	Воротного вулиця
Восьмого Березня вулиця	Восьмого Березня вулиця
Восьмого Березня провулок	Восьмого Березня провулок
Восьмого з’їзду Рад вулиця	Восьмого зʼїзду Рад вулиця
Вугільного Путі вулиця	Вугільного Путі вулиця
Гадяцького Договору вулиця	Гадяцького Договору вулиця
Гаевого квартал	Гаевого квартал
Гаєвого вулиця	Гаєвого вулиця
Генерала Горішного вулиця	Генерала Горішного вулиця
Генерала Грушевого вулиця	Генерала Грушевого вулиця
Героїв Зимового Походу провулок	Героїв Зимового Походу провулок
Геруцького вулиця	Геруцького вулиця
Гижицького вулиця	Гижицького вулиця
Гнідого вулиця	Гнідого вулиця
Говорецького вулиця	Говорецького вулиця
Горішного вулиця	Горішного вулиця
Горовецького вулиця	Горовецького вулиця
Горовецького провулок	Горовецького провулок
Грабовсьеого вулиця	Грабовсьеого вулиця
Грушевского вулиця	Грушевского вулиця
Грязного провулок	Грязного провулок
Далекого вулиця	Далекого вулиця
Даргомизкого вулиця	Даргомизкого вулиця
Дачі Песецького вулиця	Дачі Песецького вулиця
Двадцять Другого Січня в’їзд	Двадцять Другого Січня вʼїзд
Двадцять Третього Серпня вулиця	Двадцять Третього Серпня вулиця
Двадцять Третього Серпня провулок	Двадцять Третього Серпня провулок
Дванадцятого Квітня вулиця	Дванадцятого Квітня вулиця
Дверницького вулиця	Дверницького вулиця
Двухбабного вулиця	Двухбабного вулиця
Дзержинcкого квартал	Дзержинского квартал
Добровольского вулиця	Добровольского вулиця
Доброго дуба вулиця	Доброго дуба вулиця
Доброго шляху вулиця	Доброго шляху вулиця
Добродецького вулиця	Добродецького вулиця
Добродецького перевулок	Добродецького перевулок
Дражевского вулиця	Дражевского вулиця
Дробоцького алея	Дробоцького алея
Дрогобицького Повстання вулиця	Дрогобицького Повстання вулиця
Дубецького вулиця	Дубецького вулиця
Дубинецького вулиця	Дубинецького вулиця
Дубовецького вулиця	Дубовецького вулиця
Дужого вулиця	Дужого вулиця
Еміліана Невицького вулиця	Еміліана Невицького вулиця
Желєзного в'їзд	Желєзного вʼїзд
Желєзного вулиця	Желєзного вулиця
Жжоного вулиця	Жжоного вулиця
Жирного вулиця	Жирного вулиця
Заборного вулиця	Заборного вулиця
Загайного вулиця	Загайного вулиця
Загуменного вулиця	Загуменного вулиця
Загуменного провулок	Загуменного провулок
Закоршм'яного вулиця	Закоршмʼяного вулиця
Заливчого вулиця	Заливчого вулиця
Заливчого провулок	Заливчого провулок
Залозецького вулиця	Залозецького вулиця
Залозецького провулок	Залозецького провулок
Залотоцького вулиця	Залотоцького вулиця
Заможного вулиця	Заможного вулиця
Заплішнього вулиця	Заплішнього вулиця
Запорізького Козацтва вулиця	Запорізького Козацтва вулиця
Запорізького Козацтва провулок	Запорізького Козацтва провулок
Зацного вулиця	Зацного вулиця
Зачорного вулиця	Зачорного вулиця
Зенітного Полку вулиця	Зенітного Полку вулиця
Зерваницького вулиця	Зерваницького вулиця
Злоцького вулиця	Злоцького вулиця
Інтернаціонального легіону вулиця	Інтернаціонального легіону вулиця
Камишного вулиця	Камишного вулиця
Карбівничого провулок	Карбівничого провулок
Карбулицького вулиця	Карбулицького вулиця
Карпенко-Карого вулиця	Карпенко-Карого вулиця
Кибального вулиця	Кибального вулиця
Княгиницького вулиця	Княгиницького вулиця
Ковшевацького вулиця	Ковшевацького вулиця
Кодацького вулиця	Кодацького вулиця
Комнацького вулиця	Комнацького вулиця
Коноплястого вулиця	Коноплястого вулиця
Корвацького проїзд	Корвацького проїзд
Коренецького вулиця	Коренецького вулиця
Котляревского вулиця	Котляревского вулиця
Котлярєвского вулиця	Котлярєвского вулиця
Котовского вулиця	Котовского вулиця
Котовсього вулиця	Котовсього вулиця
Кошевого вулиця	Кошевого вулиця
Красницького повіту вулиця	Красницького повіту вулиця
Красносельского проспект	Красносельского проспект
Кудрявицького вулиця	Кудрявицького вулиця
Кузенного вулиця	Кузенного вулиця
Курячого вулиця	Курячого вулиця
Кутвицького вулиця	Кутвицького вулиця
Лавицького вулиця	Лавицького вулиця
Ланецького вулиця	Ланецького вулиця
Лейтенанта Попружного вулиця	Лейтенанта Попружного вулиця
Ленинского комсомола	Ленинского комсомола
Ленинского Комсомола	Ленинского Комсомола
Ленинского комсомола квартал	Ленинского комсомола квартал
Леуцького вулиця	Леуцького вулиця
Леуцького тупік	Леуцького тупік
Листопадового Чину вулиця	Листопадового Чину вулиця
Лихого вулиця	Лихого вулиця
Лицарів Зимового походу вулиця	Лицарів Зимового походу вулиця
Лучицького вулиця	Лучицького вулиця
Лучного вулиця	Лучного вулиця
Любімого вулиця	Любімого вулиця
Лютневого Повстання	Лютневого Повстання
Магдебурзького Права вулиця	Магдебурзького Права вулиця
Майбутнього вулиця	Майбутнього вулиця
Майданчик габаритно-вагового контролю	Майданчик габаритно-вагового контролю
Маковского вулиця	Маковского вулиця
Малиновского вулиця	Малиновского вулиця
Марицького вулиця	Марицького вулиця
Мархоцького вулиця	Мархоцького вулиця
Маршала Батицького вулиця	Маршала Батицького вулиця
Маршала Будьоного вулиця	Маршала Будьоного вулиця
Маяковского вулиця	Маяковского вулиця
Маяковского провулок	Маяковского провулок
Маяковского проспект	Маяковского проспект
Медведцького вулиця	Медведцького вулиця
Мерецького вулиця	Мерецького вулиця
Милого вулиця	Милого вулиця
Михаила Грушевского вулиця	Михаила Грушевского вулиця
Могильницького вулиця	Могильницького вулиця
Молодчого вулиця	Молодчого вулиця
Морецького вулиця	Морецького вулиця
Мохового вулиця	Мохового вулиця
Мурого вулиця	Мурого вулиця
Мусорского вулиця	Мусорского вулиця
Надольного вулиця	Надольного вулиця
Наліваного вулиця	Наліваного вулиця
Нарижного вулиця	Нарижного вулиця
Наукового Містечка вулиця	Наукового Містечка вулиця
Національного Відродження вулиця	Національного Відродження вулиця
Національного Відродження площа	Національного Відродження площа
Національного Прапора вулиця	Національного Прапора вулиця
Національного Прапора провулок	Національного Прапора провулок
Невідомого Бійця вулиця	Невідомого Бійця вулиця
Невідомого Солдата вулиця	Невідомого Солдата вулиця
Новосельского вулиця	Новосельского вулиця
Ногінского вулиця	Ногінского вулиця
Норинского квартал	Норинского квартал
Одинадцятого Липня в’їзд	Одинадцятого Липня вʼїзд
Одинадцятого Липня вулиця	Одинадцятого Липня вулиця
Олеськового вулиця	Олеськового вулиця
Ольхового вулиця	Ольхового вулиця
Онезького провулок	Онезького провулок
Островского вулиця	Островского вулиця
П'ясецького вулиця	Пʼясецького вулиця
П’ятницького вулиця	Пʼятницького вулиця
П’ятого Липня вулиця	Пʼятого Липня вулиця
Паньковецького вулиця	Паньковецького вулиця
Партизана Луб’яного вулиця	Партизана Лубʼяного вулиця
Пашницького вулиця	Пашницького вулиця
Пекельного вулиця	Пекельного вулиця
Перевозного вулиця	Перевозного вулиця
Перуцького вулиця	Перуцького вулиця
Першого Грудня вулиця	Першого Грудня вулиця
Першого Травня в’їзд	Першого Травня вʼїзд
Першого Травня вулиця	Першого Травня вулиця
Першого Травня площа	Першого Травня площа
Першого Травня провулок	Першого Травня провулок
Підгаєцького вулиця	Підгаєцького вулиця
Підколодного вулиця	Підколодного вулиця
Підлисецького вулиця	Підлисецького вулиця
Пісецького вулиця	Пісецького вулиця
Піщаного вулиця	Піщаного вулиця
Плотного вулиця	Плотного вулиця
Погорецького вулиця	Погорецького вулиця
Пожарского вулиця	Пожарского вулиця
Поповицького вулиця	Поповицького вулиця
Попового Яру вулиця	Попового Яру вулиця
Портицького вулиця	Портицького вулиця
Посмітного вулиця	Посмітного вулиця
Постного вулиця	Постного вулиця
Потужнього вулиця	Потужнього вулиця
Приблудного вулиця	Приблудного вулиця
Пригорницького вулиця	Пригорницького вулиця
Придворного вулиця	Придворного вулиця
Просужого вулиця	Просужого вулиця
Протятого Каміння вулиця	Протятого Каміння вулиця
Професора І. Храпливого вулиця	Професора І. Храпливого вулиця
Професора Коровицького вулиця	Професора Коровицького вулиця
Професора Коровицького провулок	Професора Коровицького провулок
Ремінного вулиця	Ремінного вулиця
Робочого вулиця	Робочого вулиця
Розкидного вулиця	Розкидного вулиця
Рокицького вулиця	Рокицького вулиця
Рослого вулиця	Рослого вулиця
Садовского вулиця	Садовского вулиця
Сацького вулиця	Сацького вулиця
Свислоцького вулиця	Свислоцького вулиця
Свідницького вулиця	Свідницького вулиця
Світлого Путі вулиця	Світлого Путі вулиця
Святого Капістрана вулиця	Святого Капістрана вулиця
Святого Юра вулиця	Святого Юра вулиця
Святого Юра площа	Святого Юра площа
Сєдого провулок	Сєдого провулок
Сімнадцятого партз’їзду вулиця	Сімнадцятого партзʼїзду вулиця
Сімнадцятого Партз’їзду провулок	Сімнадцятого Партзʼїзду провулок
Січневого повстання вулиця	Січневого повстання вулиця
Січневого Повстання вулиця	Січневого Повстання вулиця
Січневого Прориву вулиця	Січневого Прориву вулиця
Скопецького вулиця	Скопецького вулиця
Скорого вулиця	Скорого вулиця
Скуцького вулиця	Скуцького вулиця
Слизькоухого вулиця	Слизькоухого вулиця
Смирного вулиця	Смирного вулиця
Сненького вулиця	Сненького вулиця
Собор Святого Юра	Собор Святого Юра
Соколового Каміння вулиця	Соколового Каміння вулиця
Солом'яного провулок	Соломʼяного провулок
Сорокового вулиця	Сорокового вулиця
Соціалістичного Донбасу вулиця	Соціалістичного Донбасу вулиця
Спицького вулиця	Спицького вулиця
Справедливого вулиця	Справедливого вулиця
Спуск до верхнього каскаду водоспаду Гук	Спуск до верхнього каскаду водоспаду Гук
Старого Детюка вулиця	Старого Детюка вулиця
Старого Дніпра вулиця	Старого Дніпра вулиця
Старого Редуту вулиця	Старого Редуту вулиця
Старшого лейтенанта Кагала вулиця	Старшого лейтенанта Кагала вулиця
Старшого сержанта Кульбашного провулок	Старшого сержанта Кульбашного провулок
Стебницького вулиця	Стебницького вулиця
Стебніцького вулиця	Стебніцького вулиця
Стежка до Нарінецького водоспаду	Стежка до Нарінецького водоспаду
Стобецького вулиця	Стобецького вулиця
Ступницького вулиця	Ступницького вулиця
Суворого вулиця	Суворого вулиця
Суворого провулок	Суворого провулок
Сухацького вулиця	Сухацького вулиця
Тіводора Легоцького вулиця	Тіводора Легоцького вулиця
Толстрого вулиця	Толстрого вулиця
Тостого вулиця	Тостого вулиця
Трембицького вулиця	Трембицького вулиця
Уграіцкого вулиця	Уграіцкого вулиця
Уграіцкого провулок	Уграіцкого провулок
Указного вулиця	Указного вулиця
Урицкого вулиця	Урицкого вулиця
Уріцького провулок	Уріцького провулок
Фундамент старого ангару	Фундамент старого ангару
Хижного вулиця	Хижного вулиця
Хороброго вулиця	Хороброго вулиця
Хотовицького вулиця	Хотовицького вулиця
Храпливого вулиця	Храпливого вулиця
Цегельного Заводу вулиця	Цегельного Заводу вулиця
Центр поштового зв'язку (УкрПошта)	Центр поштового звʼязку (УкрПошта)
Червого партизана вулиця	Червого партизана вулиця
Чернишевского вулиця	Чернишевского вулиця
Четвертного вулиця	Четвертного вулиця
Четвертного провулок	Четвертного провулок
Четвертого Універсалу провулок	Четвертого Універсалу провулок
Чорнобривого вулиця	Чорнобривого вулиця
Чорнобрового вулиця	Чорнобрового вулиця
Чубинского вулиця	Чубинского вулиця
Чумовицкого вулиця	Чумовицкого вулиця
Чумовицького вулиця	Чумовицького вулиця
Шатного вулиця	Шатного вулиця
Шелкового вулиця	Шелкового вулиця
Шептицікого вулиця	Шептицікого вулиця
Шостацького вулиця	Шостацького вулиця
Шостацького провулок	Шостацького провулок
Щирого вулиця	Щирого вулиця
Юного Ленінця вулиця	Юного Ленінця вулиця
Яковицького вулиця	Яковицького вулиця
Ярицького вулиця	Ярицького вулиця
Яруцького вулиця	Яруцького вулиця
XIX Партійного З'їзду вулиця	XIX Партійного Зʼїзду вулиця
XXI Партійного З'їзду вулиця	XXI Партійного Зʼїзду вулиця