Автоколонна вулиця	Автоколонна вулиця
Бастіонна вулиця	Бастіонна вулиця
Бастіонний провулок	Бастіонний провулок
Батальйонна вулиця	Батальйонна вулиця
Батальйонний провулок	Батальйонний провулок
Бетонна вулиця	Бетонна вулиця
Бетонная дорога	Бетонная дорога
Біатлонна траса	Біатлонна траса
Болонна вулиця	Болонна вулиця
Вагонна вулиця	Вагонна вулиця
Вагонний провулок	Вагонний провулок
Вигонна вулиця	Вигонна вулиця
Віконний провулок	Віконний провулок
Гарнізонна вулиця	Гарнізонна вулиця
Дивізіонна вулиця	Дивізіонна вулиця
Електронна вулиця	Електронна вулиця
Електронний провулок	Електронний провулок
Електронний проїзд	Електронний проїзд
Залізобетонна вулиця	Залізобетонна вулиця
Заслонна вулиця	Заслонна вулиця
Затонна вулиця	Затонна вулиця
Затонний провулок	Затонний провулок
Каньйонний провулок	Каньйонний провулок
Колонна вулиця	Колонна вулиця
Кордонна вулиця	Кордонна вулиця
Кордонний провулок	Кордонний провулок
Лижно-біатлонна траса	Лижно-біатлонна траса
Лимонна вулиця	Лимонна вулиця
Лохвицьа районна прокуратура	Лохвицьа районна прокуратура
Мікрорайонна вулиця	Мікрорайонна вулиця
Мільйонна вулиця	Мільйонна вулиця
Мільонна вулиця	Мільонна вулиця
Міст-бетонний стовб	Міст-бетонний стовп
Наклонна вулиця	Наклонна вулиця
Нова Прикордонна вулиця	Нова Прикордонна вулиця
Оболонна вулиця	Оболонна вулиця
Оболонний в’їзд	Оболонний вʼїзд
Оболонний провулок	Оболонний провулок
Оборонна вулиця	Оборонна вулиця
Оборонная  вулиця	Оборонная  вулиця
Оборонная вулиця	Оборонная вулиця
Оборонний провулок	Оборонний провулок
Патронний провулок	Патронний провулок
Перонна вулиця	Перонна вулиця
Пішохідний понтонний міст	Пішохідний понтонний міст
Полігонна вулиця	Полігонна вулиця
Полігонний провулок	Полігонний провулок
Понтонна вулиця	Понтонна вулиця
Понтонний міст	Понтонний міст
Понтонний провулок	Понтонний провулок
Прикордонна вулиця	Прикордонна вулиця
Прикордонний заїзд	Прикордонний заїзд
Прикордонний провулок	Прикордонний провулок
Прогонна вулиця	Прогонна вулиця
Прогонний провулок	Прогонний провулок
Прогонний тупик	Прогонний тупик
Районна вулиця	Районна вулиця
Районний Бульвар вулиця	Районний Бульвар вулиця
Районний суд	Районний суд
сезонна (може зорюватись)	сезонна (може зорюватись)
Стадіонна вулиця	Стадіонна вулиця
Стадіонна площа	Стадіонна площа
Стадіонний в’їзд	Стадіонний вʼїзд
Стадіонний провулок	Стадіонний провулок
Стадіонний проїзд	Стадіонний проїзд
Станціонна вулиця	Станціонна вулиця
Станціонний провулок	Станціонний провулок
Станціонний проїзд	Станціонний проїзд
Суконний провулок	Суконний провулок
Телефонний провулок	Телефонний провулок
Териконна вулиця	Териконна вулиця
Терриконна вулиця	Терриконна вулиця
Циклонна вулиця	Циклонна вулиця
Чемпіонна вулиця	Чемпіонна вулиця