Аванкамерний міст	Аванкамерний міст
Аграрна вулиця	Аграрна вулиця
Аграрна площа	Аграрна площа
Аграрний провулок	Аграрний провулок
Аграрний тупик	Аграрний тупик
Ажурна вулиця	Ажурна вулиця
Ажурний провулок	Ажурний провулок
Акціонерна вулиця	Акціонерна вулиця
Амбарна вулиця	Амбарна вулиця
Амбарний провулок	Амбарний провулок
Ангарна вулиця	Ангарна вулиця
Арматурна вулиця	Арматурна вулиця
Арматурний провулок	Арматурний провулок
Архитектурна вулиця	Архитектурна вулиця
Архітектурна вулиця	Архітектурна вулиця
Архітектурний провулок	Архітектурний провулок
Базарна вулиця	Базарна вулиця
Базарна площа	Базарна площа
Базарна Площа вулиця	Базарна Площа вулиця
Базарний майдан	Базарний майдан
Базарний провулок	Базарний провулок
Бар'єрний провулок	Барʼєрний провулок
Бічна Озерна вулиця	Бічна Озерна вулиця
Буксирний провулок	Буксирний провулок
Бульварна вулиця	Бульварна вулиця
Бульварний провулок	Бульварний провулок
Бункерний провулок	Бункерний провулок
Велика Гончарна вулиця	Велика Гончарна вулиця
Ветеринарна вулиця	Ветеринарна вулиця
Ветеринарний провулок	Ветеринарний провулок
Ветиринарна вулиця	Ветиринарна вулиця
Ветиринарний провулок	Ветиринарний провулок
Винокурний проїзд	Винокурний проїзд
Вітерна вулиця	Вітерна вулиця
Восьмиквартирна вулиця	Восьмиквартирна вулиця
Галерна вулиця	Галерна вулиця
Гарна вулиця	Гарна вулиця
Гарна стежка	Гарна стежка
Глісерна вулиця	Глісерна вулиця
Гончарна вулиця	Гончарна вулиця
Гончарний провулок	Гончарний провулок
Граверна вулиця	Граверна вулиця
Граверний провулок	Граверний провулок
Грейдерна вулиця	Грейдерна вулиця
Дегтярна вулиця	Дегтярна вулиця
Дігтярна вулиця	Дігтярна вулиця
Дігтярний в’їзд	Дігтярний вʼїзд
Дігтярний провулок	Дігтярний провулок
Друга Базарна вулиця	Друга Базарна вулиця
Електрозварна вулиця	Електрозварна вулиця
Забазарний вʼїзд	Забазарний вʼїзд
Заозерна вулиця	Заозерна вулиця
Заозерний провулок	Заозерний провулок
Запечерна вулиця	Запечерна вулиця
Заполярна вулиця	Заполярна вулиця
Заярна вулиця	Заярна вулиця
Заярний провулок	Заярний провулок
Земледарна вулиця	Земледарна вулиця
Інженерна вулиця	Інженерна вулиця
Інженерна площа	Інженерна площа
Інженерний провулок	Інженерний провулок
Інженерний проспект	Інженерний проспект
Інжирна вулиця	Інжирна вулиця
Інтеркультурна вулиця	Інтеркультурна вулиця
Календарна вулиця	Календарна вулиця
Календарний провулок	Календарний провулок
Каліберна вулиця	Каліберна вулиця
Кар'єрна вул	Карʼєрна вул
Кар'єрна вулиця	Карʼєрна вулиця
Кар'єрний провулок	Карʼєрний провулок
Кар’єрна вулиця	Карʼєрна вулиця
Кар’єрний провулок	Карʼєрний провулок
Кар’єрний тупик	Карʼєрний тупик
Кар’рний провулок	Карʼрний провулок
Карʼєрна вулиця	Карʼєрна вулиця
Карʼєрний тупик провулок	Карʼєрний тупик провулок
Клеверний провулок	Клеверний провулок
Клінкерна вулиця	Клінкерна вулиця
Комінтерна вулиця	Комінтерна вулиця
Комінтерна провулок	Комінтерна провулок
Комунарна вулиця	Комунарна вулиця
Комунарний провулок	Комунарний провулок
Конча-Озерна вулиця	Конча-Озерна вулиця
Крейсерна вулиця	Крейсерна вулиця
Культурна вулиця	Культурна вулиця
Культурний провулок	Культурний провулок
Кустарна вулиця	Кустарна вулиця
Кустарний провулок	Кустарний провулок
Кучугурна вулиця	Кучугурна вулиця
Лагерна вулиця	Лагерна вулиця
Лагерна коса вулиця	Лагерна коса вулиця
Лагерний провулок	Лагерний провулок
Лагерний проїзд	Лагерний проїзд
Лазурна вулиця	Лазурна вулиця
Лазурний бульвар	Лазурний бульвар
Лазурний мікрорайон	Лазурний мікрорайон
Лазурний провулок	Лазурний провулок
Легендарна вулиця	Легендарна вулиця
Легендарний провулок	Легендарний провулок
Ливарна вулиця	Ливарна вулиця
Ливарний провулок	Ливарний провулок
Літературна вулиця	Літературна вулиця
Літературний провулок	Літературний провулок
Ліхтарна вулиця	Ліхтарна вулиця
Лучезарна вулиця	Лучезарна вулиця
Майдан Озерний вулиця	Майдан Озерний вулиця
Майстерний провулок	Майстерний провулок
Мала Гончарна вулиця	Мала Гончарна вулиця
Малоозерна вулиця	Малоозерна вулиця
Мануфактурна вулиця	Мануфактурна вулиця
Мирна вулиця	Мирна вулиця
Мирний бульвар	Мирний бульвар
Мирний в’їзд	Мирний вʼїзд
Мирний мікрорайон	Мирний мікрорайон
Мирний провулок	Мирний провулок
Мирний проспект	Мирний проспект
Мирний тупик	Мирний тупик
Міжозерна вулиця	Міжозерна вулиця
МІжозерна вулиця	МІжозерна вулиця
Мочарна вулиця	Мочарна вулиця
Над'ярна вулиця	Надʼярна вулиця
Над’ярна вулиця	Надʼярна вулиця
Над’ярний провулок	Надʼярний провулок
Надозерна вулиця	Надозерна вулиця
Надозерний провулок	Надозерний провулок
Надстирна вулиця	Надстирна вулиця
Нектарна вулиця	Нектарна вулиця
Нектарний проїзд	Нектарний проїзд
Нижньобазарна площа	Нижньобазарна площа
Нижня Базарна вулиця	Нижня Базарна вулиця
Новобазарна вулиця	Новобазарна вулиця
Новобазарний провулок	Новобазарний провулок
Новокар’єрний провулок	Новокарʼєрний провулок
Новомирна вулиця	Новомирна вулиця
Обшарна вулиця	Обшарна вулиця
Озерна вулиця	Озерна вулиця
Озерний в’їзд	Озерний вʼїзд
Озерний провулок	Озерний провулок
Озерний проїзд	Озерний проїзд
Озерний тупик	Озерний тупик
Озерний узвіз	Озерний узвіз
Перша Ливарна вулиця	Перша Ливарна вулиця
Північно-Озерна вулиця	Північно-Озерна вулиця
Підмурна вулиця	Підмурна вулиця
Підозерна вулиця	Підозерна вулиця
Піонерна вулиця	Піонерна вулиця
Піонерна дорога	Піонерна дорога
Планерна вулиця	Планерна вулиця
Планерний провулок	Планерний провулок
Планетарна вулиця	Планетарна вулиця
Пожарна вулиця	Пожарна вулиця
Популярна вулиця	Популярна вулиця
Порт-Артурна вулиця	Порт-Артурна вулиця
Приозерна вулиця	Приозерна вулиця
Приозерний бульвар	Приозерний бульвар
Приозерний провулок	Приозерний провулок
Приозерний проїзд	Приозерний проїзд
Приостерний провулок	Приостерний провулок
Пропелерна вулиця	Пропелерна вулиця
Профінтерна вулиця	Профінтерна вулиця
Профінтерний провулок	Профінтерний провулок
Резервуарна вулиця	Резервуарна вулиця
Садово – Янтарна вулиця	Садово – Янтарна вулиця
Салінарна вулиця	Салінарна вулиця
Саперна вулиця	Саперна вулиця
Саперний провулок	Саперний провулок
Северна вулиця	Северна вулиця
Сєверна вулиця	Сєверна вулиця
Сєвєрна вулиця	Сєвєрна вулиця
Сєвєрний провулок	Сєвєрний провулок
Синьоозерна вулиця	Синьоозерна вулиця
Синьоозерний провулок	Синьоозерний провулок
Склотарний провулок	Склотарний провулок
Скреперна вулиця	Скреперна вулиця
Скульптурна вулиця	Скульптурна вулиця
Слюсарна вулиця	Слюсарна вулиця
Слюсарний в’їзд	Слюсарний вʼїзд
Слюсарний провулок	Слюсарний провулок
Слюсарний проїзд	Слюсарний проїзд
Смолярна вулиця	Смолярна вулиця
Солідарна вулиця	Солідарна вулиця
Солідарний в’їзд	Солідарний вʼїзд
Солідарний провулок	Солідарний провулок
Сталеварна вулиця	Сталеварна вулиця
Старобазарна вулиця	Старобазарна вулиця
Старобазарний провулок	Старобазарний провулок
Старобазарний сквер	Старобазарний сквер
Старобульварна вулиця	Старобульварна вулиця
Старогончарна вулиця	Старогончарна вулиця
Столярна вулиця	Столярна вулиця
Столярний провулок	Столярний провулок
Стратосферна вулиця	Стратосферна вулиця
Сухарна вулиця	Сухарна вулиця
Табурна вулиця	Табурна вулиця
Танкерна вулиця	Танкерна вулиця
Танкерний провулок	Танкерний провулок
Тараскіна вулиця - Базарна вулиця	Тараскіна вулиця - Базарна вулиця
Тарна вулиця	Тарна вулиця
Токарна вулиця	Токарна вулиця
Токарний провулок	Токарний провулок
Ударна вулиця	Ударна вулиця
Ударний в’їзд	Ударний вʼїзд
Ударний провулок	Ударний провулок
Фанерна вулиця	Фанерна вулиця
Фанерний провулок	Фанерний провулок
Фізкультурна вулиця	Фізкультурна вулиця
Фізкультурний в’їзд	Фізкультурний вʼїзд
Фізкультурний провулок	Фізкультурний провулок
Фільварна вулиця	Фільварна вулиця
Фразерна вулиця	Фразерна вулиця
Фрезерна вулиця	Фрезерна вулиця
Футлярний провулок	Футлярний провулок
Фiзкультурна вулиця	Фізкультурна вулиця
Хлібодарна вулиця	Хлібодарна вулиця
Хмарна вулиця	Хмарна вулиця
Цвинтарна вулиця	Цвинтарна вулиця
Цвинтарний провулок	Цвинтарний провулок
Чавуноливарна вулиця	Чавуноливарна вулиця
Чепурна вулиця	Чепурна вулиця
Чинарна вулиця	Чинарна вулиця
Чинбарна вулиця	Чинбарна вулиця
Шахтарна вулиця	Шахтарна вулиця
Шиферна вулиця	Шиферна вулиця
Юпітерна вулиця	Юпітерна вулиця
Янтарна вулиця	Янтарна вулиця
Янтарний провулок	Янтарний провулок
Ярна вулиця	Ярна вулиця