Абаканська вулиця	Абаканська вулиця
Абразумівська вулиця	Абразумівська вулиця
Абрамівська вулиця	Абрамівська вулиця
Авангардовська вулиця	Авангардовська вулиця
Аварська вулиця	Аварська вулиця
Августовська вулиця	Августовська вулиця
Авдеєвська вулиця	Авдеєвська вулиця
Авдіївська вулиця	Авдіївська вулиця
Авіаконструкторська вулиця	Авіаконструкторська вулиця
Авіаторська вулиця	Авіаторська вулиця
Авраамівська вулиця	Авраамівська вулиця
Аврамівська вулиця	Аврамівська вулиця
Аврорська вулиця	Аврорська вулиця
Австрійська вулиця	Австрійська вулиця
Автобазівська вулиця	Автобазівська вулиця
Автодорівська вулиця	Автодорівська вулиця
Автозаводська вулиця	Автозаводська вулиця
Автоливмашівська вулиця	Автоливмашівська вулиця
Автопарківська вулиця	Автопарківська вулиця
Авторська вулиця	Авторська вулиця
Агеївська вулиця	Агеївська вулиця
Аглостроївська вулиця	Аглостроївська вулиця
Агропунтівська вулиця	Агропунтівська вулиця
Адамівська вулиця	Адамівська вулиця
Аджаликська вулиця	Аджаликська вулиця
Аджамська вулиця	Аджамська вулиця
Аджарська вулиця	Аджарська вулиця
Адигейська вулиця	Адигейська вулиця
Адлерська вулиця	Адлерська вулиця
Адміралтейська вулиця	Адміралтейська вулиця
Адміралтейська площа	Адміралтейська площа
Адміральська вулиця	Адміральська вулиця
Аеропортівська вулиця	Аеропортівська вулиця
Аерофлотська вулиця	Аерофлотська вулиця
Азербайджанська вулиця	Азербайджанська вулиця
Азовстальська вулиця	Азовстальська вулиця
Азовська вулиця	Азовська вулиця
Айдарівська вулиця	Айдарівська вулиця
Айдарська вулиця	Айдарська вулиця
Айнлагська вулиця	Айнлагська вулиця
Аккаржанська вулиця	Аккаржанська вулиця
Аккерманська вулиця	Аккерманська вулиця
Акмечетська вулиця	Акмечетська вулиця
Акмолинська вулиця	Акмолинська вулиця
Акмолінська вулиця	Акмолінська вулиця
Аксайська вулиця	Аксайська вулиця
Актюбинська вулиця	Актюбинська вулиця
Актюбінська вулиця	Актюбінська вулиця
Алапаєвська вулиця	Алапаєвська вулиця
Алатирська вулиця	Алатирська вулиця
Албанська вулиця	Албанська вулиця
Алданська вулиця	Алданська вулиця
Алексинська вулиця	Алексинська вулиця
Алеутська вулиця	Алеутська вулиця
Алітуська вулиця	Алітуська вулиця
Алма-Атинська вулиця	Алма-Атинська вулиця
Алматинська вулиця	Алматинська вулиця
Алтайська вулиця	Алтайська вулиця
Алупкінська вулиця	Алупкінська вулиця
Алуштинська вулиця	Алуштинська вулиця
Алчевська вулиця	Алчевська вулиця
Альпійська вулиця	Альпійська вулиця
Альтинська вулиця	Альтинська вулиця
Аматорська вулиця	Аматорська вулиця
Амстердамська вулиця	Амстердамська вулиця
Амудар’їнська вулиця	Амударʼїнська вулиця
Амурська вулиця	Амурська вулиця
Амурська площа	Амурська площа
Анадирська вулиця	Анадирська вулиця
Анадольська вулиця	Анадольська вулиця
Ананьєвська вулиця	Ананьєвська вулиця
Ананьївська вулиця	Ананьївська вулиця
Анапська вулиця	Анапська вулиця
Анастасіївська вулиця	Анастасіївська вулиця
Анатоліївська вулиця	Анатоліївська вулиця
Ангарська вулиця	Ангарська вулиця
Андижанська вулиця	Андижанська вулиця
Андрієвська вулиця	Андрієвська вулиця
Андріївська вулиця	Андріївська вулиця
Андрусівська вулиця	Андрусівська вулиця
Андрушівська вулиця	Андрушівська вулиця
Анівська вулиця	Анівська вулиця
Антипівська вулиця	Антипівська вулиця
Антонівська вулиця	Антонівська вулиця
Антонієвська вулиця	Антонієвська вулиця
Антоновська вулиця	Антоновська вулиця
Аполлонівська вулиця	Аполлонівська вулиця
Апостолівська вулиця	Апостолівська вулиця
Аптекарська вулиця	Аптекарська вулиця
Апшанська вулиця	Апшанська вулиця
Апшеронська вулиця	Апшеронська вулиця
Арабатська вулиця	Арабатська вулиця
Аравійська вулиця	Аравійська вулиця
Арадська вулиця	Арадська вулиця
Аральська вулиця	Аральська вулиця
Араратська вулиця	Араратська вулиця
Арбатська вулиця	Арбатська вулиця
Арбузинська вулиця	Арбузинська вулиця
Арзамаська вулиця	Арзамаська вулиця
Аркадійська алея	Аркадійська алея
Аркадійська Алея	Аркадійська Алея
Аркалаївська вулиця	Аркалаївська вулиця
Аркасівська вулиця	Аркасівська вулиця
Армавірська вулиця	Армавірська вулиця
Армійська вулиця	Армійська вулиця
Армiйська вулиця	Армiйська вулиця
Арнаутська вулиця	Арнаутська вулиця
Арсенальська вулиця	Арсенальська вулиця
Артамонівська вулиця	Артамонівська вулиця
Артезіанська вулиця	Артезіанська вулиця
Артеківська вулиця	Артеківська вулиця
Артемівська вулиця	Артемівська вулиця
артилерийська вулиця	артилерийська вулиця
Артилерійська вулиця	Артилерійська вулиця
Артилерiйська вулиця	Артилерiйська вулиця
Артищівська вулиця	Артищівська вулиця
Артурівська вулиця	Артурівська вулиця
Артюхівська вулиця	Артюхівська вулиця
Архангельська вулиця	Архангельська вулиця
Архієрейська вулиця	Архієрейська вулиця
Архітекторська вулиця	Архітекторська вулиця
Асканійська вулиця	Асканійська вулиця
Аскольдівська вулиця	Аскольдівська вулиця
Астейська вулиця	Астейська вулиця
Астраханська вулиця	Астраханська вулиця
Аудиторська вулиця	Аудиторська вулиця
Афанасівська вулиця	Афанасівська вулиця
Афінська вулиця	Афінська вулиця
Ахтирська вулиця	Ахтирська вулиця
Ачинська вулиця	Ачинська вулиця
Ашгабадська вулиця	Ашгабадська вулиця
Ашхабадська вулиця	Ашхабадська вулиця
Аэрофлотська вулиця	Аэрофлотська вулиця
Бабаївська вулиця	Бабаївська вулиця
Бабинська вулиця	Бабинська вулиця
Бабичівська вулиця	Бабичівська вулиця
Баварська вулиця	Баварська вулиця
Багачанська вулиця	Багачанська вулиця
Багговутівська вулиця	Багговутівська вулиця
Баглійська вулиця	Баглійська вулиця
Багметівська вулиця	Багметівська вулиця
Багнянська вулиця	Багнянська вулиця
Багратіонівська вулиця	Багратіонівська вулиця
Багринівська вулиця	Багринівська вулиця
Бадовська вулиця	Бадовська вулиця
Бажанівська вулиця	Бажанівська вулиця
Базарська вулиця	Базарська вулиця
Базівська вулиця	Базівська вулиця
Баїнська вулиця	Баїнська вулиця
Байгородська вулиця	Байгородська вулиця
Байдаківська вулиця	Байдаківська вулиця
Байдарська вулиця	Байдарська вулиця
Байкальська вулиця	Байкальська вулиця
Байконурівська вулиця	Байконурівська вулиця
Байконурська вулиця	Байконурська вулиця
Байрактарська вулиця	Байрактарська вулиця
Байрачанська вулиця	Байрачанська вулиця
Бакаївська вулиця	Бакаївська вулиця
Бакайська вулиця	Бакайська вулиця
Бакинська вулиця	Бакинська вулиця
Бакінська вулиця	Бакінська вулиця
Бакшарівська вулиця	Бакшарівська вулиця
Балабанівська вулиця	Балабанівська вулиця
Балаклавська вулиця	Балаклавська вулиця
Балакліївська вулиця	Балакліївська вулиця
Балаклійська вулиця	Балаклійська вулиця
Баланівська вулиця	Баланівська вулиця
Балашівська вулиця	Балашівська вулиця
Балашовська вулиця	Балашовська вулиця
Балканська вулиця	Балканська вулиця
Балківська вулиця	Балківська вулиця
Баллінська вулиця	Баллінська вулиця
Балтазарівська вулиця	Балтазарівська вулиця
Балтівська вулиця	Балтівська вулиця
Балтійська вулиця	Балтійська вулиця
Балтська вулиця	Балтська вулиця
Балтська дорога	Балтська дорога
Балхаська вулиця	Балхаська вулиця
Бальзаківська вулиця	Бальзаківська вулиця
Бамівська вулиця	Бамівська вулиця
Банилівська вулиця	Банилівська вулиця
Банківська академія	Банківська академія
Банківська вулиця	Банківська вулиця
Баннівська вулиця	Баннівська вулиця
Банська вулиця	Банська вулиця
Банянська вулиця	Банянська вулиця
Барабінська вулиця	Барабінська вулиця
Бараниківська вулиця	Бараниківська вулиця
Баранівська вулиця	Баранівська вулиця
Барахтянська вулиця	Барахтянська вулиця
Барашівська вулиця	Барашівська вулиця
Барвінківська вулиця	Барвінківська вулиця
Бардаківська вулиця	Бардаківська вулиця
Бардіївська вулиця	Бардіївська вулиця
Бариська вулиця	Бариська вулиця
Баришівська вулиця	Баришівська вулиця
Барнаульська вулиця	Барнаульська вулиця
Баронівська вулиця	Баронівська вулиця
Баронська вулиця	Баронська вулиця
Барська вулиця	Барська вулиця
Басарабівська вулиця	Басарабівська вулиця
Басарабська вулиця	Басарабська вулиця
Басівкутська вулиця	Басівкутська вулиця
Басівська вулиця	Басівська вулиця
Батайська вулиця	Батайська вулиця
Батівська вулиця	Батівська вулиця
Батумська вулиця	Батумська вулиця
Батуринська вулиця	Батуринська вулиця
Бауманська вулиця	Бауманська вулиця
Бахмутська вулиця	Бахмутська вулиця
Бахчисарайська вулиця	Бахчисарайська вулиця
Башкирівська вулиця	Башкирівська вулиця
Башкирська вулиця	Башкирська вулиця
Башкірська вулиця	Башкірська вулиця
Баштанська вулиця	Баштанська вулиця
Бедівська вулиця	Бедівська вулиця
Безлюдівська вулиця	Безлюдівська вулиця
Беївська вулиця	Беївська вулиця
Бейкуська вулиця	Бейкуська вулиця
Белгородська вулиця	Белгородська вулиця
Бельведерська вулиця	Бельведерська вулиця
Бельгійська вулиця	Бельгійська вулиця
Бендерська вулиця	Бендерська вулиця
Бенедиківська вулиця	Бенедиківська вулиця
Бенівська вулиця	Бенівська вулиця
Бергометська вулиця	Бергометська вулиця
Бердичівська вулиця	Бердичівська вулиця
Бердянська вулиця	Бердянська вулиця
Берегівська вулиця	Берегівська вулиця
Берегівська-бічна вулиця	Берегівська-бічна вулиця
Берегівська-обʼїзна вулиця	Берегівська-обʼїзна вулиця
Берегометська вулиця	Берегометська вулиця
Бережанська вулиця	Бережанська вулиця
Бережинська вулиця	Бережинська вулиця
Бережківська вулиця	Бережківська вулиця
Бережнянська вулиця	Бережнянська вулиця
Березанівська вулиця	Березанівська вулиця
Березанська вулиця	Березанська вулиця
Берездівська вулиця	Берездівська вулиця
Березенська вулиця	Березенська вулиця
Березинська вулиця	Березинська вулиця
Березівська вулиця	Березівська вулиця
Березнегуватська вулиця	Березнегуватська вулиця
Березниківська вулиця	Березниківська вулиця
Березнівська вулиця	Березнівська вулиця
Березняківська вулиця	Березняківська вулиця
Березнянська вулиця	Березнянська вулиця
Береславська вулиця	Береславська вулиця
Берестейська вулиця	Берестейська вулиця
Берестечківська вулиця	Берестечківська вулиця
Берестівська вулиця	Берестівська вулиця
Берестовська вулиця	Берестовська вулиця
Берестянська вулиця	Берестянська вулиця
Бериславська вулиця	Бериславська вулиця
Берладинська вулиця	Берладинська вулиця
Берлінська вулиця	Берлінська вулиця
Бернардинська вулиця	Бернардинська вулиця
Бернардинська площа	Бернардинська площа
Берсенівська вулиця	Берсенівська вулиця
Бершадська вулиця	Бершадська вулиця
Бесарабська вулиця	Бесарабська вулиця
Бесемерівська вулиця	Бесемерівська вулиця
Бескидська вулиця	Бескидська вулиця
Бессарабська вулиця	Бессарабська вулиця
Бессарабська площа	Бессарабська площа
Бессемерівська вулиця	Бессемерівська вулиця
Беcсарабська вулиця	Беcсарабська вулиця
Бєлгородська вулиця	Бєлгородська вулиця
Бєлградська вулиця	Бєлградська вулиця
Бєлогорівська вулиця	Бєлогорівська вулиця
Бєлорєченська вулиця	Бєлорєченська вулиця
Бєльовська вулиця	Бєльовська вулиця
Бєляєвська вулиця	Бєляєвська вулиця
Бибиківська вулиця	Бибиківська вулиця
Бидгощська вулиця	Бидгощська вулиця
Биківнянська вулиця	Биківнянська вулиця
Бистрянська вулиця	Бистрянська вулиця
Бишівська вулиця	Бишівська вулиця
Бібрська вулиця	Бібрська вулиця
Бійська вулиця	Бійська вулиця
Білаївська вулиця	Білаївська вулиця
Білашівська вулиця	Білашівська вулиця
Білгород-Дністровська вулиця	Білгород-Дністровська вулиця
Білгородська вулиця	Білгородська вулиця
Білецьківська вулиця	Білецьківська вулиця
Біличанська вулиця	Біличанська вулиця
Білківська вулиця	Білківська вулиця
Біловарська вулиця	Біловарська вулиця
Біловодська вулиця	Біловодська вулиця
Білогірська вулиця	Білогірська вулиця
Білоглинська вулиця	Білоглинська вулиця
Білогородська вулиця	Білогородська вулиця
Білогорська вулиця	Білогорська вулиця
Білогрудівська вулиця	Білогрудівська вулиця
Білозерська вулиця	Білозерська вулиця
Білозерська площа	Білозерська площа
Білозірська вулиця	Білозірська вулиця
Білокам'янська вулиця	Білокамʼянська вулиця
Біломорська вулиця	Біломорська вулиця
Білоозерська вулиця	Білоозерська вулиця
Білопільська алея	Білопільська алея
Білопільська вулиця	Білопільська вулиця
Білоріченська вулиця	Білоріченська вулиця
Білоруська вулиця	Білоруська вулиця
Білосарайська вулиця	Білосарайська вулиця
Білоуська вулиця	Білоуська вулиця
Білоцерківська вулиця	Білоцерківська вулиця
Біляївська вулиця	Біляївська вулиця
Бірзульська вулиця	Бірзульська вулиця
Бірківська вулиця	Бірківська вулиця
Бірючанська вулиця	Бірючанська вулиця
Бічна-Чуперносівська вулиця	Бічна-Чуперносівська вулиця
Біянська набережна	Біянська набережна
Благовещенська вулиця	Благовещенська вулиця
Благовіщенська вулиця	Благовіщенська вулиця
Благовіщенська площа	Благовіщенська площа
Благовіщинська вулиця	Благовіщинська вулиця
Ближньопечерська вулиця	Ближньопечерська вулиця
Близнюківська вулиця	Близнюківська вулиця
Блятівська вулиця	Блятівська вулиця
Бляхарська вулиця	Бляхарська вулиця
Бобринківська вулиця	Бобринківська вулиця
Бобруйська вулиця	Бобруйська вулиця
Бовищанська вулиця	Бовищанська вулиця
Бовсунівська вулиця	Бовсунівська вулиця
Богатирська вулиця	Богатирська вулиця
Богачівська вулиця	Богачівська вулиця
Богданівська вулиця	Богданівська вулиця
Богодухівська вулиця	Богодухівська вулиця
Боголюбівська вулиця	Боголюбівська вулиця
Боголюбська вулиця	Боголюбська вулиця
Богопільська вулиця	Богопільська вулиця
Богословська вулиця	Богословська вулиця
Богоявленська вулиця	Богоявленська вулиця
Богунівська вулиця	Богунівська вулиця
Богунська вулиця	Богунська вулиця
Богуславська вулиця	Богуславська вулиця
Бодайбинська вулиця	Бодайбинська вулиця
Боднарівська вулиця	Боднарівська вулиця
Боднарська вулиця	Боднарська вулиця
Божедарівська вулиця	Божедарівська вулиця
Бойківська вулиця	Бойківська вулиця
Болгарська вулиця	Болгарська вулиця
Болгачівська вулиця	Болгачівська вулиця
Болградська вулиця	Болградська вулиця
Болехівська вулиця	Болехівська вулиця
Болкарська вулиця	Болкарська вулиця
Болонська вулиця	Болонська вулиця
Болотинська вулиця	Болотинська вулиця
Болохівська вулиця	Болохівська вулиця
Болсуновська вулиця	Болсуновська вулиця
Болюбашівська вулиця	Болюбашівська вулиця
Болярська вулиця	Болярська вулиця
Бондаренківська вулиця	Бондаренківська вулиця
Бондарівська вулиця	Бондарівська вулиця
Бондарська вулиця	Бондарська вулиця
Боратинська вулиця	Боратинська вулиця
Борейська вулиця	Борейська вулиця
Боржавська вулиця	Боржавська вулиця
Боржомська вулиця	Боржомська вулиця
Борзенська вулиця	Борзенська вулиця
Борисівська вулиця	Борисівська вулиця
Бориславська вулиця	Бориславська вулиця
Борисоглебська вулиця	Борисоглебська вулиця
Борисоглєбська вулиця	Борисоглєбська вулиця
Борисоглібська вулиця	Борисоглібська вулиця
Бориспільська вулиця	Бориспільська вулиця
Борівська вулиця	Борівська вулиця
Боровинська вулиця	Боровинська вулиця
Боровиченська вулиця	Боровиченська вулиця
Боровська вулиця	Боровська вулиця
Бородинівська вулиця	Бородинівська вулиця
Бородинська вулиця	Бородинська вулиця
Бородінська вулиця	Бородінська вулиця
Бородянська вулиця	Бородянська вулиця
Борозенська вулиця	Борозенська вулиця
Боролівська вулиця	Боролівська вулиця
Борохівська вулиця	Борохівська вулиця
Боршівська вулиця	Боршівська вулиця
Борщагівська вулиця	Борщагівська вулиця
Борщаківська вулиця	Борщаківська вулиця
Борщівська вулиця	Борщівська вулиця
Ботарська вулиця	Ботарська вулиця
Бочальська вулиця	Бочальська вулиця
Бочанська вулиця	Бочанська вулиця
Боянівська вулиця	Боянівська вулиця
Боярська вулиця	Боярська вулиця
Бразильська вулиця	Бразильська вулиця
Брамська вулиця	Брамська вулиця
Братерська вулиця	Братерська вулиця
Братиславська вулиця	Братиславська вулиця
Братська вулиця	Братська вулиця
Брацлавська вулиця	Брацлавська вулиця
Брестська вулиця	Брестська вулиця
Бриківська вулиця	Бриківська вулиця
Брисівська вулиця	Брисівська вулиця
Бритайська вулиця	Бритайська вулиця
Британська вулиця	Британська вулиця
Бричанська вулиця	Бричанська вулиця
Брідківська вулиця	Брідківська вулиця
Брідська вулиця	Брідська вулиця
Брідчанська вулиця	Брідчанська вулиця
Броварська вулиця	Броварська вулиця
Бровчуківська вулиця	Бровчуківська вулиця
Бродівська вулиця	Бродівська вулиця
Бродська вулиця	Бродська вулиця
Брусилівська вулиця	Брусилівська вулиця
Бруснівська вулиця	Бруснівська вулиця
Брюссельська вулиця	Брюссельська вулиця
Брянська вулиця	Брянська вулиця
Брянцевська вулиця	Брянцевська вулиця
Бубнаровська вулиця	Бубнаровська вулиця
Бубновська вулиця	Бубновська вулиця
Бугаївська вулиця	Бугаївська вулиця
Буго-Гардівська вулиця	Буго-Гардівська вулиця
Бугогардівська вулиця	Бугогардівська вулиця
Бугська вулиця	Бугська вулиця
Будаївська вулиця	Будаївська вулиця
Будапештська вулиця	Будапештська вулиця
Буджакська вулиця	Буджакська вулиця
Будильська вулиця	Будильська вулиця
Будищанська вулиця	Будищанська вулиця
Будищівська вулиця	Будищівська вулиця
Будьонівська вулиця	Будьонівська вулиця
Будьоннівська вулиця	Будьоннівська вулиця
Будянська вулиця	Будянська вулиця
Бужанська вулиця	Бужанська вулиця
Бужинська вулиця	Бужинська вулиця
Букавонська вулиця	Букавонська вулиця
Буківська вулиця	Буківська вулиця
Буковинська вулиця	Буковинська вулиця
Бульварно-Кудрявська вулиця	Бульварно-Кудрявська вулиця
Буняківська вулиця	Буняківська вулиця
Буокинська вулиця	Буокинська вулиця
Бурімська вулиця	Бурімська вулиця
Бурштинська вулиця	Бурштинська вулиця
Бурятська вулиця	Бурятська вулиця
Буслівська вулиця	Буслівська вулиця
Бусовогірська вулиця	Бусовогірська вулиця
Буська вулиця	Буська вулиця
Бутирська вулиця	Бутирська вулиця
Бутівська вулиця	Бутівська вулиця
Бутовська вулиця	Бутовська вулиця
Бутурлінівська вулиця	Бутурлінівська вулиця
Бухарестська вулиця	Бухарестська вулиця
Бухарська вулиця	Бухарська вулиця
Бухнівська дорога	Бухнівська дорога
Буцинська вулиця	Буцинська вулиця
Бучанська вулиця	Бучанська вулиця
Буянівська вулиця	Буянівська вулиця
Бiлоцеркiвська вулиця	Бiлоцеркiвська вулиця
В’єтнамська вулиця	Вʼєтнамська вулиця
В’яземська вулиця	Вʼяземська вулиця
В’ялівська вулиця	Вʼялівська вулиця
Ваканська вулиця	Ваканська вулиця
Вакуленцівська вулиця	Вакуленцівська вулиця
Вакулівська вулиця	Вакулівська вулиця
Валдайська вулиця	Валдайська вулиця
Валентинівська вулиця	Валентинівська вулиця
Валер’янівська вулиця	Валерʼянівська вулиця
Валківська вулиця	Валківська вулиця
Валуйська вулиця	Валуйська вулиця
Вапнярська вулиця	Вапнярська вулиця
Варваринська вулиця	Варваринська вулиця
Варварівська вулиця	Варварівська вулиця
Варваріська вулиця	Варваріська вулиця
Варвинська вулиця	Варвинська вулиця
Варненська вулиця	Варненська вулиця
Варовичівська вулиця	Варовичівська вулиця
Варшавська вулиця	Варшавська вулиця
Василіанська вулиця	Василіанська вулиця
Василівська вулиця	Василівська вулиця
Васильєвська вулиця	Васильєвська вулиця
Васильївська вулиця	Васильївська вулиця
Васильківська вулиця	Васильківська вулиця
Васильківська площа	Васильківська площа
Васищівська вулиця	Васищівська вулиця
Васюрівська вулиця	Васюрівська вулиця
Вахівська вулиця	Вахівська вулиця
Вацьківська вулиця	Вацьківська вулиця
Вашківська вулиця	Вашківська вулиця
Введенська вулиця	Введенська вулиця
Веговська вулиця	Веговська вулиця
Ведмежівська вулиця	Ведмежівська вулиця
Великівська вулиця	Великівська вулиця
Великоанадольська вулиця	Великоанадольська вулиця
Великодолинська дорога	Великодолинська дорога
Великокохнівська вулиця	Великокохнівська вулиця
Великолужська вулиця	Великолужська вулиця
Великоновосілківська вулиця	Великоновосілківська вулиця
Великопільська вулиця	Великопільська вулиця
Великопокровська вулиця	Великопокровська вулиця
Великопромінська вулиця	Великопромінська вулиця
Великорігська вулиця	Великорігська вулиця
Великорогізнянська вулиця	Великорогізнянська вулиця
Великороманівська вулиця	Великороманівська вулиця
Великоруська вулиця	Великоруська вулиця
Великоснітинська вулиця	Великоснітинська вулиця
Великотирнівська вулиця	Великотирнівська вулиця
Великотирновська вулиця	Великотирновська вулиця
Великохутірська вулиця	Великохутірська вулиця
Великочернеччинська вулиця	Великочернеччинська вулиця
Великоярянська вулиця	Великоярянська вулиця
Велишевська вулиця	Велишевська вулиця
Велозаводська вулиця	Велозаводська вулиця
Венгерська вулиця	Венгерська вулиця
Венделівська вулиця	Венделівська вулиця
Вендичанська вулиця	Вендичанська вулиця
Вербівська вулиця	Вербівська вулиця
Верболозівська вулиця	Верболозівська вулиця
Веренчанська вулиця	Веренчанська вулиця
Веретенівська вулиця	Веретенівська вулиця
Верзанська вулиця	Верзанська вулиця
Веригінська вулиця	Веригінська вулиця
Верхівська вулиця	Верхівська вулиця
Верхнєудінська вулиця	Верхнєудінська вулиця
Верхньо-Головківська вулиця	Верхньо-Головківська вулиця
Верхньоактюбинська вулиця	Верхньоактюбинська вулиця
Верхньогірська вулиця	Верхньогірська вулиця
Верхньодніпровська вулиця	Верхньодніпровська вулиця
Верхньокурганська вулиця	Верхньокурганська вулиця
Верхньороганська вулиця	Верхньороганська вулиця
Верхньоудинська вулиця	Верхньоудинська вулиця
Верховинська вулиця	Верховинська вулиця
Верхолянська вулиця	Верхолянська вулиця
Верхоянська вулиця	Верхоянська вулиця
Веселинівська вулиця	Веселинівська вулиця
Веселівська вулиця	Веселівська вулиця
Веселовська вулиця	Веселовська вулиця
Веселодолинська вулиця	Веселодолинська вулиця
Веселопільська вулиця	Веселопільська вулиця
Веселотернівська вулиця	Веселотернівська вулиця
Ветеранська вулиця	Ветеранська вулиця
Ветська вулиця	Ветська вулиця
Ветхинська вулиця	Ветхинська вулиця
Вечірньокутська вулиця	Вечірньокутська вулиця
Вешенська вулиця	Вешенська вулиця
Вибранівська вулиця	Вибранівська вулиця
Вигінська вулиця	Вигінська вулиця
Вигінчанська вулиця	Вигінчанська вулиця
Вигнанська вулиця	Вигнанська вулиця
Вигонопоселенська вулиця	Вигонопоселенська вулиця
Виденська вулиця	Виденська вулиця
Видранська вулиця	Видранська вулиця
Вижарська вулиця	Вижарська вулиця
Виконкомівська вулиця	Виконкомівська вулиця
Вилківська вулиця	Вилківська вулиця
Вилянська вулиця	Вилянська вулиця
Винниківська вулиця	Винниківська вулиця
Винногірська вулиця	Винногірська вулиця
Виноградівська вулиця	Виноградівська вулиця
Виноградська вулиця	Виноградська вулиця
Вирівська вулиця	Вирівська вулиця
Високопільська вулиця	Високопільська вулиця
Височанська вулиця	Височанська вулиця
Височинська вулиця	Височинська вулиця
Висторпська вулиця	Висторпська вулиця
Витавська вулиця	Витавська вулиця
Витківська вулиця	Витківська вулиця
Витягайлівська вулиця	Витягайлівська вулиця
Вифлеємська вулиця	Вифлеємська вулиця
Вишгородська вулиця	Вишгородська вулиця
Вишгородська набережна	Вишгородська набережна
Вишеньківська вулиця	Вишеньківська вулиця
Вишівська вулиця	Вишівська вулиця
Вишківська вулиця	Вишківська вулиця
Вишневська вулиця	Вишневська вулиця
Вишнівська вулиця	Вишнівська вулиця
Вишняківська вулиця	Вишняківська вулиця
Вишнянська вулиця	Вишнянська вулиця
Вищедубечанська вулиця	Вищедубечанська вулиця
Вівчанська вулиця	Вівчанська вулиця
Віденська вулиця	Віденська вулиця
Відінська вулиця	Відінська вулиця
Відножанська вулиця	Відножанська вулиця
Візантійська вулиця	Візантійська вулиця
Військкоматська вулиця	Військкоматська вулиця
Військовоморська вулиця	Військовоморська вулиця
Віленська вулиця	Віленська вулиця
Вілійська вулиця	Вілійська вулиця
Вільногірська вулиця	Вільногірська вулиця
Вільностепська вулиця	Вільностепська вулиця
Вільнюська вулиця	Вільнюська вулиця
Вільхівська вулиця	Вільхівська вулиця
Вільшанська вулиця	Вільшанська вулиця
Вільшинська вулиця	Вільшинська вулиця
Вілюйська вулиця	Вілюйська вулиця
Віринська вулиця	Віринська вулиця
Вірманська вулиця	Вірманська вулиця
Вірменська вулиця	Вірменська вулиця
Вірміївська вулиця	Вірміївська вулиця
Вітавська вулиця	Вітавська вулиця
Вітебська вулиця	Вітебська вулиця
Вітівська вулиця	Вітівська вулиця
Вітрівська вулиця	Вітрівська вулиця
Вітянська вулиця	Вітянська вулиця
Вішенська вулиця	Вішенська вулиця
Владивостокська вулиця	Владивостокська вулиця
Внуковська вулиця	Внуковська вулиця
Вовківська вулиця	Вовківська вулиця
Вовнянська вулиця	Вовнянська вулиця
Вовчанська вулиця	Вовчанська вулиця
Вовчогірська вулиця	Вовчогірська вулиця
Вовчоярівська вулиця	Вовчоярівська вулиця
Водійська вулиця	Водійська вулиця
Водолажська вулиця	Водолажська вулиця
Водопійська вулиця	Водопійська вулиця
Водянська вулиця	Водянська вулиця
Воєводська вулиця	Воєводська вулиця
Воєгощанська дорога	Воєгощанська дорога
Воздвиженська вулиця	Воздвиженська вулиця
Вознесенівська вулиця	Вознесенівська вулиця
Вознесенська вулиця	Вознесенська вулиця
Вознесінська вулиця	Вознесінська вулиця
Воїнська вулиця	Воїнська вулиця
Войнівська вулиця	Войнівська вулиця
Волго-Донська вулиця	Волго-Донська вулиця
Волго-Уральська вулиця	Волго-Уральська вулиця
Волговська вулиця	Волговська вулиця
Волгоградська вулиця	Волгоградська вулиця
Волгодонська вулиця	Волгодонська вулиця
Волдаєвська вулиця	Волдаєвська вулиця
Волинська вулиця	Волинська вулиця
Волноваська вулиця	Волноваська вулиця
Вологодська вулиця	Вологодська вулиця
Володарська вулиця	Володарська вулиця
Володимирівська вулиця	Володимирівська вулиця
Володимиро-Либідська вулиця	Володимиро-Либідська вулиця
Володимирська вулиця	Володимирська вулиця
Володимирська площа	Володимирська площа
Воложанівська вулиця	Воложанівська вулиця
Волоколамська вулиця	Волоколамська вулиця
Волонтерівська вулиця	Волонтерівська вулиця
Волонтерська вулиця	Волонтерська вулиця
Волоська вулиця	Волоська вулиця
Волохінська вулиця	Волохінська вулиця
Волочаєвська вулиця	Волочаєвська вулиця
Волочаївська вулиця	Волочаївська вулиця
Волочиська вулиця	Волочиська вулиця
Волошинська вулиця	Волошинська вулиця
Волощанська вулиця	Волощанська вулиця
Волховська вулиця	Волховська вулиця
Волчанська вулиця	Волчанська вулиця
Вольська вулиця	Вольська вулиця
Волянська вулиця	Волянська вулиця
Вонігівська вулиця	Вонігівська вулиця
Ворзельська вулиця	Ворзельська вулиця
Воркутянська вулиця	Воркутянська вулиця
Вороб'ївська вулиця	Воробʼївська вулиця
Вороб'ївська набережна	Воробʼївська набережна
Вороб’ївська набережна	Воробʼївська набережна
Воробинська вулиця	Воробинська вулиця
Ворожб'янська вулиця	Ворожбʼянська вулиця
Ворожбянська вулиця	Ворожбянська вулиця
Воронєжська вулиця	Воронєжська вулиця
Воронівська вулиця	Воронівська вулиця
Воронська дорога	Воронська дорога
Воронцовська вулиця	Воронцовська вулиця
Воропаївська вулиця	Воропаївська вулиця
Ворохтянська вулиця	Ворохтянська вулиця
Ворошиловградська вулиця	Ворошиловградська вулиця
Ворсівська вулиця	Ворсівська вулиця
Воскресенська вулиця	Воскресенська вулиця
Воскресінська вулиця	Воскресінська вулиця
Восточанська вулиця	Восточанська вулиця
Вроцлавська алея	Вроцлавська алея
Вроцлавська вулиця	Вроцлавська вулиця
Врублівська вулиця	Врублівська вулиця
Всіхсвятська вулиця	Всіхсвятська вулиця
Вуглегірська вулиця	Вуглегірська вулиця
Вуглегорська вулиця	Вуглегорська вулиця
Вуглеградська вулиця	Вуглеградська вулиця
Вугледарська вулиця	Вугледарська вулиця
Вугринівська вулиця	Вугринівська вулиця
Вузівська вулиця	Вузівська вулиця
Вузловська вулиця	Вузловська вулиця
вул. Дністровська	вул. Дністровська
Вул. Кишинівська	Вул. Кишинівська
Вул. Князівська	Вул. Князівська
Вул. Марсельська	Вул. Марсельська
Вул. Махачкалинська	Вул. Махачкалинська
Вул. Ольгіївська	Вул. Ольгіївська
вул. Пухiвська	вул. Пухiвська
Вул. Середньофонтанська	Вул. Середньофонтанська
Вул. Тираспольська	Вул. Тираспольська
вулиця Алтайська	вулиця Алтайська
вулиця Андріївська	вулиця Андріївська
вулиця Бидгощська	вулиця Бидгощська
вулиця Броварська	вулиця Броварська
вулиця Буковинська	вулиця Буковинська
вулиця Верховинська	вулиця Верховинська
вулиця Володимирівська	вулиця Володимирівська
вулиця Вчительська	вулиця Вчительська
вулиця Гвардійська	вулиця Гвардійська
вулиця Дібровинська	вулиця Дібровинська
вулиця Дністровська	вулиця Дністровська
вулиця Добросусідська	вулиця Добросусідська
вулиця Заводська	вулиця Заводська
вулиця Зарожанська	вулиця Зарожанська
вулиця Казбетська	вулиця Казбетська
вулиця Київська	вулиця Київська
вулиця Кобилянська	вулиця Кобилянська
вулиця Комсомольська	вулиця Комсомольська
вулиця Краківська	вулиця Краківська
вулиця Кривалівська	вулиця Кривалівська
вулиця Магазійська	вулиця Магазійська
вулиця Магалянська	вулиця Магалянська
вулиця Михайлівська	вулиця Михайлівська
вулиця Млинська	вулиця Млинська
вулиця Молдовська	вулиця Молдовська
вулиця Молодогвардійська	вулиця Молодогвардійська
вулиця Надністровська	вулиця Надністровська
вулиця Нарбутівська	вулиця Нарбутівська
вулиця Одеська	вулиця Одеська
вулиця Партизанська	вулиця Партизанська
вулиця Піддубівська	вулиця Піддубівська
вулиця Піонерська	вулиця Піонерська
вулиця Погорілівська	вулиця Погорілівська
вулиця Покровська	вулиця Покровська
вулиця Полянська	вулиця Полянська
вулиця Пролетарська	вулиця Пролетарська
Вулиця Рудківська	Вулиця Рудківська
вулиця Руська	вулиця Руська
вулиця Свято-Дмитріївська	вулиця Свято-Дмитріївська
вулиця Свято-Михайлівська	вулиця Свято-Михайлівська
вулиця Севастопольська	вулиця Севастопольська
вулиця Спаська	вулиця Спаська
вулиця Українська	вулиця Українська
вулиця Університетська	вулиця Університетська
вулиця Фермерська	вулиця Фермерська
вулиця Фінляндська	вулиця Фінляндська
вулиця Холодногірська	вулиця Холодногірська
вулиця Хотинська	вулиця Хотинська
Вусівська вулиця	Вусівська вулиця
Вчительська вулиця	Вчительська вулиця
Вяземська вулиця	Вяземська вулиця
Вязівська вулиця	Вязівська вулиця
Вяловська вулиця	Вяловська вулиця
Вятська вулиця	Вятська вулиця
Вiтянська вулиця	Вiтянська вулиця
Габрилівська вулиця	Габрилівська вулиця
Гаванська вулиця	Гаванська вулиця
Гаврилівська вулиця	Гаврилівська вулиця
Гагарінська вулиця	Гагарінська вулиця
Гагринська вулиця	Гагринська вулиця
Газдівська вулиця	Газдівська вулиця
Гаївська вулиця	Гаївська вулиця
Гайворонська вулиця	Гайворонська вулиця
Гайдейська вулиця	Гайдейська вулиця
Гайківська вулиця	Гайківська вулиця
Гайсинська вулиця	Гайсинська вулиця
Гайська вулиця	Гайська вулиця
Галаборівська вулиця	Галаборівська вулиця
Галаганівська вулиця	Галаганівська вулиця
Галаська вулиця	Галаська вулиця
Галатівська вулиця	Галатівська вулиця
Галахівська вулиця	Галахівська вулиця
Галинська вулиця	Галинська вулиця
Галицинівська вулиця	Галицинівська вулиця
Галичанська вулиця	Галичанська вулиця
Галкінська вулиця	Галкінська вулиця
Галузівська вулиця	Галузівська вулиця
Галушкинська вулиця	Галушкинська вулиця
Гамаліївська вулиця	Гамаліївська вулиця
Гаманівська вулиця	Гаманівська вулиця
Ганжівська вулиця	Ганжівська вулиця
Ганнівська вулиця	Ганнівська вулиця
Гарбарська вулиця	Гарбарська вулиця
Гарбузинська вулиця	Гарбузинська вулиця
Гарбузівська вулиця	Гарбузівська вулиця
Гардишівська вулиця	Гардишівська вулиця
Гатищанська вулиця	Гатищанська вулиця
Гатненська вулиця	Гатненська вулиця
Гатчинська вулиця	Гатчинська вулиця
Гвардійська вулиця	Гвардійська вулиця
Гвоздівська вулиця	Гвоздівська вулиця
Гданська вулиця	Гданська вулиця
Гданцівська вулиця	Гданцівська вулиця
Геївська вулиця	Геївська вулиця
Гельмязівська вулиця	Гельмязівська вулиця
Генеральська вулиця	Генеральська вулиця
Генівська вулиця	Генівська вулиця
Генічеська вулиця	Генічеська вулиця
Геодезічеська вулиця	Геодезічеська вулиця
Георгіївська вулиця	Георгіївська вулиця
Герасимівська вулиця	Герасимівська вулиця
Геройська вулиця	Геройська вулиця
Геронимівська вулиця	Геронимівська вулиця
Герцаївська вулиця	Герцаївська вулиця
Гетманська вулиця	Гетманська вулиця
Гетьманська вулиця	Гетьманська вулиця
Гжатська вулиця	Гжатська вулиця
Гиївська вулиця	Гиївська вулиця
Гідропроектовська вулиця	Гідропроектовська вулиця
Гідросилівська вулиця	Гідросилівська вулиця
Гіївська вулиця	Гіївська вулиця
Гімалайська вулиця	Гімалайська вулиця
Гірківська вулиця	Гірківська вулиця
Гірничозаводська вулиця	Гірничозаводська вулиця
Гірська вулиця	Гірська вулиця
Гладківська вулиця	Гладківська вулиця
Гладосівська вулиця	Гладосівська вулиця
Гладосовська вулиця	Гладосовська вулиця
Глибівська вулиця	Глибівська вулиця
Глибоко-Долинська вулиця	Глибоко-Долинська вулиця
Глибочанська вулиця	Глибочанська вулиця
Глинищанська вулиця	Глинищанська вулиця
Глинська вулиця	Глинська вулиця
Глиньська вулиця	Глиньська вулиця
Глинянська вулиця	Глинянська вулиця
Глібівська вулиця	Глібівська вулиця
Глібківська вулиця	Глібківська вулиця
Глобинська вулиця	Глобинська вулиця
Глобівська вулиця	Глобівська вулиця
Глодянська вулиця	Глодянська вулиця
Глухівська вулиця	Глухівська вулиця
Гнилушська вулиця	Гнилушська вулиця
Гнідавська вулиця	Гнідавська вулиця
Гнідинська вулиця	Гнідинська вулиця
Гніздичівська вулиця	Гніздичівська вулиця
Говерлівська вулиця	Говерлівська вулиця
Говерлянська вулиця	Говерлянська вулиця
Гоголівська вулиця	Гоголівська вулиця
Годинівська вулиця	Годинівська вулиця
Годунівська вулиця	Годунівська вулиця
Гожулівська вулиця	Гожулівська вулиця
Голешівська вулиця	Голешівська вулиця
Голівська вулиця	Голівська вулиця
Голландська вулиця	Голландська вулиця
Головківська вулиця	Головківська вулиця
Головлівська вулиця	Головлівська вулиця
Головурівська вулиця	Головурівська вулиця
Голопристанська вулиця	Голопристанська вулиця
Голосіївська вулиця	Голосіївська вулиця
Голосіївська площа	Голосіївська площа
Голосківська вулиця	Голосківська вулиця
Голтянська вулиця	Голтянська вулиця
Голубенська вулиця	Голубенська вулиця
Голубівська вулиця	Голубівська вулиця
Гольдбергівська вулиця	Гольдбергівська вулиця
Гольмовська вулиця	Гольмовська вулиця
Гомелєвська вулиця	Гомелєвська вулиця
Гомельська вулиця	Гомельська вулиця
Гончарівська вулиця	Гончарівська вулиця
Гончарівська площа	Гончарівська площа
Гончарська вулиця	Гончарська вулиця
Горанська вулиця	Горанська вулиця
Горб’янська вулиця	Горбʼянська вулиця
Горбанівська вулиця	Горбанівська вулиця
Горбасівська вулиця	Горбасівська вулиця
Горбівська вулиця	Горбівська вулиця
Горбчанська вулиця	Горбчанська вулиця
Гордієнківська вулиця	Гордієнківська вулиця
Горенська вулиця	Горенська вулиця
Горинська вулиця	Горинська вулиця
Гориньська вулиця	Гориньська вулиця
Горівська вулиця	Горівська вулиця
Горійська вулиця	Горійська вулиця
Горіхівська вулиця	Горіхівська вулиця
Горішнянська вулиця	Горішнянська вулиця
Горкутська вулиця	Горкутська вулиця
Горлівська вулиця	Горлівська вулиця
Горнинська вулиця	Горнинська вулиця
Горно-Алтайська вулиця	Горно-Алтайська вулиця
Горнозаводська вулиця	Горнозаводська вулиця
Горностаївська вулиця	Горностаївська вулиця
Городищанська вулиця	Городищанська вулиця
Городищенська вулиця	Городищенська вулиця
Городненська вулиця	Городненська вулиця
Городнянська вулиця	Городнянська вулиця
Городська вулиця	Городська вулиця
Городчинська вулиця	Городчинська вулиця
Горожанська вулиця	Горожанська вулиця
Горохівська вулиця	Горохівська вулиця
Горошківська вулиця	Горошківська вулиця
Горсинська вулиця	Горсинська вулиця
Горьківська вулиця	Горьківська вулиця
Горяєвська вулиця	Горяєвська вулиця
Горянська вулиця	Горянська вулиця
Господарська вулиця	Господарська вулиця
Господарська вулицяmmmmmm	Господарська вулицяmmmmmm
Господинська вулиця	Господинська вулиця
Гостинно двірська	Гостинно двірська
Гостиннодвірська вулиця	Гостиннодвірська вулиця
Гостомельська вулиця	Гостомельська вулиця
Гостомельська площа	Гостомельська площа
Готфейська вулиця	Готфейська вулиця
Гошівська вулиця	Гошівська вулиця
Грабарська вулиця	Грабарська вулиця
Грабинівська вулиця	Грабинівська вулиця
Грабівська вулиця	Грабівська вулиця
Грабовська вулиця	Грабовська вулиця
Грабська вулиця	Грабська вулиця
Градинська вулиця	Градинська вулиця
Градівська вулиця	Градівська вулиця
Гражданська вулиця	Гражданська вулиця
Грайворонська вулиця	Грайворонська вулиця
Граківська вулиця	Граківська вулиця
Графська вулиця	Графська вулиця
Гребениківська вулиця	Гребениківська вулиця
Гребенюківська вулиця	Гребенюківська вулиця
Гребінківська вулиця	Гребінківська вулиця
Гредянська вулиця	Гредянська вулиця
Греківська вулиця	Греківська вулиця
Гресівська вулиця	Гресівська вулиця
Григор’євська вулиця	Григорʼєвська вулиця
Григорівська вулиця	Григорівська вулиця
Гримайлівська вулиця	Гримайлівська вулиця
Гринівська вулиця	Гринівська вулиця
Грише-Ровенська дорога	Грише-Ровенська дорога
Гришинська вулиця	Гришинська вулиця
Грібувська вулиця	Грібувська вулиця
Гроденська вулиця	Гроденська вулиця
Гродівська вулиця	Гродівська вулиця
Гродненська вулиця	Гродненська вулиця
Грозненська вулиця	Грозненська вулиця
Громадська вулиця	Громадська вулиця
Громадянська вулиця	Громадянська вулиця
Громовська вулиця	Громовська вулиця
Громокліївська вулиця	Громокліївська вулиця
Грузинська вулиця	Грузинська вулиця
Грузська вулиця	Грузська вулиця
Грунська вулиця	Грунська вулиця
Грушевська вулиця	Грушевська вулиця
Грушинська вулиця	Грушинська вулиця
Грушівська вулиця	Грушівська вулиця
Грюнвальдська вулиця	Грюнвальдська вулиця
Грязнянська вулиця	Грязнянська вулиця
Губернська вулиця	Губернська вулиця
Губинська вулиця	Губинська вулиця
Губкомівська вулиця	Губкомівська вулиця
Гудзовська вулиця	Гудзовська вулиця
Гудимівська вулиця	Гудимівська вулиця
Гуківська вулиця	Гуківська вулиця
Гульдівська вулиця	Гульдівська вулиця
Гуменська вулиця	Гуменська вулиця
Гунська вулиця	Гунська вулиця
Гуньківська вулиця	Гуньківська вулиця
Гур’євська вулиця	Гурʼєвська вулиця
Гур’ївська вулиця	Гурʼївська вулиця
Гурджанська вулиця	Гурджанська вулиця
Гуржіївська вулиця	Гуржіївська вулиця
Гурзуфська вулиця	Гурзуфська вулиця
Гуринівська вулиця	Гуринівська вулиця
Гурканівська вулиця	Гурканівська вулиця
Гуртянська вулиця	Гуртянська вулиця
Гусаківська вулиця	Гусаківська вулиця
Гусинівська вулиця	Гусинівська вулиця
Гусинська вулиця	Гусинська вулиця
Густинська вулиця	Густинська вулиця
Гусятинська вулиця	Гусятинська вулиця
Гутівська вулиця	Гутівська вулиця
Гутівська дорога	Гутівська дорога
Гутнянська вулиця	Гутнянська вулиця
Гутянська вулиця	Гутянська вулиця
Гуцульська вулиця	Гуцульська вулиця
Гущанська вулиця	Гущанська вулиця
Гiрська вулиця	Гiрська вулиця
Ґалаґанівська вулиця	Ґалаґанівська вулиця
Ґданська вулиця	Ґданська вулиця
Ґельсингська вулиця	Ґельсингська вулиця
Ґрюнвальдська вулиця	Ґрюнвальдська вулиця
Дагестанська вулиця	Дагестанська вулиця
Дагестантська вулиця	Дагестантська вулиця
Дажевська вулиця	Дажевська вулиця
Дакалівська вулиця	Дакалівська вулиця
Далекоуральська вулиця	Далекоуральська вулиця
Дальньоуральська вулиця	Дальньоуральська вулиця
Данилівська вулиця	Данилівська вулиця
Данська вулиця	Данська вулиця
Дапутатська вулиця	Дапутатська вулиця
Дар'ївська вулиця	Дарʼївська вулиця
Дар’яльська вулиця	Дарʼяльська вулиця
Дараганівська вулиця	Дараганівська вулиця
Дармштатська вулиця	Дармштатська вулиця
Даугавська вулиця	Даугавська вулиця
Даурська вулиця	Даурська вулиця
Дахнівська вулиця	Дахнівська вулиця
Дашавська вулиця	Дашавська вулиця
Двинська вулиця	Двинська вулиця
Двінська вулиця	Двінська вулиця
Двірківська вулиця	Двірківська вулиця
Двірська вулиця	Двірська вулиця
Дворянська вулиця	Дворянська вулиця
Дебальцевська вулиця	Дебальцевська вулиця
Дебальцівська вулиця	Дебальцівська вулиця
Деволанівська вулиця	Деволанівська вулиця
Дегтярівська вулиця	Дегтярівська вулиця
Деземовська вулиця	Деземовська вулиця
Деївська вулиця	Деївська вулиця
Деконівська вулиця	Деконівська вулиця
Делегатська вулиця	Делегатська вулиця
Дем'янівська вулиця	Демʼянівська вулиця
Дем’янівська вулиця	Демʼянівська вулиця
Демиденківська вулиця	Демиденківська вулиця
Демидівська вулиця	Демидівська вулиця
Деміївська вулиця	Деміївська вулиця
Деміївська площа	Деміївська площа
Демнянська вулиця	Демнянська вулиця
Денисівська вулиця	Денисівська вулиця
Денишівська вулиця	Денишівська вулиця
Деповська вулиця	Деповська вулиця
Депутатська вулиця	Депутатська вулиця
Деражнянська вулиця	Деражнянська вулиця
Дербентська вулиця	Дербентська вулиця
Дергачівська вулиця	Дергачівська вулиця
Деревлянська вулиця	Деревлянська вулиця
Державінська вулиця	Державінська вулиця
Дерибасівська вулиця	Дерибасівська вулиця
Деркачівська вулиця	Деркачівська вулиця
Дерманська вулиця	Дерманська вулиця
Деснянська вулиця	Деснянська вулиця
Детальбудівська вулиця	Детальбудівська вулиця
Джамбульська вулиця	Джамбульська вулиця
Джанкойська вулиця	Джанкойська вулиця
Джгунівська вулиця	Джгунівська вулиця
Джерелянська вулиця	Джерелянська вулиця
Дзвонарська вулиця	Дзвонарська вулиця
Дзюбівська вулиця	Дзюбівська вулиця
Дивногірська вулиця	Дивногірська вулиця
Дивногорська вулиця	Дивногорська вулиця
Дийдівська вулиця	Дийдівська вулиця
Дийдянська вулиця	Дийдянська вулиця
Диканівська вулиця	Диканівська вулиця
Димерська вулиця	Димерська вулиця
Димитріївська вулиця	Димитріївська вулиця
Димківська вулиця	Димківська вулиця
Динамівська вулиця	Динамівська вулиця
Динівська вулиця	Динівська вулиця
Динковська вулиця	Динковська вулиця
Диспетчерська вулиця	Диспетчерська вулиця
Дібрівська вулиця	Дібрівська вулиця
Дібровська вулиця	Дібровська вулиця
Дідівська вулиця	Дідівська вулиця
Дімовська вулиця	Дімовська вулиця
Дмитрівська вулиця	Дмитрівська вулиця
Дмитровградська вулиця	Дмитровградська вулиця
Дніпрельстанівська вулиця	Дніпрельстанівська вулиця
Дніпробудівська вулиця	Дніпробудівська вулиця
Дніпроводська вулиця	Дніпроводська вулиця
Дніпровська вулиця	Дніпровська вулиця
Дніпровська набережна	Дніпровська набережна
Дніпровська набережня	Дніпровська набережня
Дніпрогесівська вулиця	Дніпрогесівська вулиця
Дніпродзержинська вулиця	Дніпродзержинська вулиця
Дніпропетрівська вулиця	Дніпропетрівська вулиця
Дніпропетровська вулиця	Дніпропетровська вулиця
Дніпропетровська дорога	Дніпропетровська дорога
Дніпросталівська вулиця	Дніпросталівська вулиця
Дніпростроївська вулиця	Дніпростроївська вулиця
Дністерська вулиця	Дністерська вулиця
Дністрівська вулиця	Дністрівська вулиця
Дністровська вулиця	Дністровська вулиця
Дністрянська вулиця	Дністрянська вулиця
Добівська вулиця	Добівська вулиця
Добринінська вулиця	Добринінська вулиця
Добрівлянська вулиця	Добрівлянська вулиця
Добровлянська вулиця	Добровлянська вулиця
Доброгірська вулиця	Доброгірська вулиця
Доброіванівська вулиця	Доброіванівська вулиця
Доброкриничанська вулиця	Доброкриничанська вулиця
Добромильська вулиця	Добромильська вулиця
Добропільська вулиця	Добропільська вулиця
Добросусідська вулиця	Добросусідська вулиця
Добротвірська вулиця	Добротвірська вулиця
Добруська вулиця	Добруська вулиця
Довбиська вулиця	Довбиська вулиця
Довгалівська вулиця	Довгалівська вулиця
Довгопільська вулиця	Довгопільська вулиця
Довжанська вулиця	Довжанська вулиця
Довська вулиця	Довська вулиця
Доківська вулиця	Доківська вулиця
Докторська вулиця	Докторська вулиця
Докучаєвська вулиця	Докучаєвська вулиця
Долгінцівська вулиця	Долгінцівська вулиця
Долинська вулиця	Долинська вулиця
Долинянська вулиця	Долинянська вулиця
Доманинська вулиця	Доманинська вулиця
Домантівська вулиця	Домантівська вулиця
Домініканська вулиця	Домініканська вулиця
Домодєдовська вулиця	Домодєдовська вулиця
Донбасівська вулиця	Донбасівська вулиця
Донбаська вулиця	Донбаська вулиця
Донвугільська вулиця	Донвугільська вулиця
Донівська вулиця	Донівська вулиця
Донсодівська вулиця	Донсодівська вулиця
Донська вулиця	Донська вулиця
дороги Мостиська-Самбір-Борислав	дороги Мостиська-Самбір-Борислав
Дорогиничівська вулиця	Дорогиничівська вулиця
Дорогинська вулиця	Дорогинська вулиця
Дорогичинська вулиця	Дорогичинська вулиця
Дорожівська вулиця	Дорожівська вулиця
Дорошенківська вулиця	Дорошенківська вулиця
Дорошівська вулиця	Дорошівська вулиця
Досафська вулиця	Досафська вулиця
Драгобратська вулиця	Драгобратська вулиця
Драговська вулиця	Драговська вулиця
Драгомирівська вулиця	Драгомирівська вулиця
Драчинська вулиця	Драчинська вулиця
Древлянська вулиця	Древлянська вулиця
Дрезденська вулиця	Дрезденська вулиця
Дроздівська вулиця	Дроздівська вулиця
Дронівська вулиця	Дронівська вулиця
Дроновська вулиця	Дроновська вулиця
Дружбівська вулиця	Дружбівська вулиця
Дружківська вулиця	Дружківська вулиця
Друкарська вулиця	Друкарська вулиця
Друхівська вулиця	Друхівська вулиця
Дубенська вулиця	Дубенська вулиця
Дубинська вулиця	Дубинська вулиця
Дубичанська вулиця	Дубичанська вулиця
Дубичнянська вулиця	Дубичнянська вулиця
Дубівська вулиця	Дубівська вулиця
Дубінинська вулиця	Дубінинська вулиця
Дубківська вулиця	Дубківська вулиця
Дублянська вулиця	Дублянська вулиця
Дубнівська вулиця	Дубнівська вулиця
Дубовинська вулиця	Дубовинська вулиця
Дубовська вулиця	Дубовська вулиця
Дубравська вулиця	Дубравська вулиця
Дубрівська вулиця	Дубрівська вулиця
Дубровська вулиця	Дубровська вулиця
Дударківська вулиця	Дударківська вулиця
Дудинська вулиця	Дудинська вулиця
Дудківська вулиця	Дудківська вулиця
Дулібська вулиця	Дулібська вулиця
Думська вулиця	Думська вулиця
Думська площа	Думська площа
Дунайгородська вулиця	Дунайгородська вулиця
Дунайська алея	Дунайська алея
Дунайська вулиця	Дунайська вулиця
Дунауйварошська вулиця	Дунауйварошська вулиця
Дунинівська вулиця	Дунинівська вулиця
Дуншівська вулиця	Дуншівська вулиця
Духовська вулиця	Духовська вулиця
Душанбинська вулиця	Душанбинська вулиця
Дюківська вулиця	Дюківська вулиця
Дюковська вулиця	Дюковська вулиця
Евенкійська вулиця	Евенкійська вулиця
Европейська вулиця	Европейська вулиця
Ейсмонтівська вулиця	Ейсмонтівська вулиця
Експресівська вулиця	Експресівська вулиця
Елеваторська вулиця	Елеваторська вулиця
Електрозаводська вулиця	Електрозаводська вулиця
Електростальська вулиця	Електростальська вулиця
Елістинська вулиця	Елістинська вулиця
Еллінська вулиця	Еллінська вулиця
Ельтонська вулиця	Ельтонська вулиця
Енергодарська вулиця	Енергодарська вулиця
Епронівська вулиця	Епронівська вулиця
Есенська вулиця	Есенська вулиця
Ессенська вулиця	Ессенська вулиця
Естонська вулиця	Естонська вулиця
Есхарівська вулиця	Есхарівська вулиця
Євгенівська вулиця	Євгенівська вулиця
Євдокіївська вулиця	Євдокіївська вулиця
Євлашівська вулиця	Євлашівська вулиця
Євпаторійська вулиця	Євпаторійська вулиця
Єврейська вулиця	Єврейська вулиця
Європейська вулиця	Європейська вулиця
Європейська площа	Європейська площа
Єгорівська вулиця	Єгорівська вулиця
Єйська вулиця	Єйська вулиця
Єлагінська вулиця	Єлагінська вулиця
Єланська вулиця	Єланська вулиця
Єлизаветинська вулиця	Єлизаветинська вулиця
Єлизаветівська вулиця	Єлизаветівська вулиця
Єлисаветградська вулиця	Єлисаветградська вулиця
Єлисеївська вулиця	Єлисеївська вулиця
Єлисєєвська вулиця	Єлисєєвська вулиця
Єлісаветинська вулиця	Єлісаветинська вулиця
Ємільчинська вулиця	Ємільчинська вулиця
Єнакієвська вулиця	Єнакієвська вулиця
Єнакіївська вулиця	Єнакіївська вулиця
Єнисейська вулиця	Єнисейська вулиця
Єнісейська вулиця	Єнісейська вулиця
Єньківська вулиця	Єньківська вулиця
Єреванська вулиця	Єреванська вулиця
Єрківська вулиця	Єрківська вулиця
Єрмаківська вулиця	Єрмаківська вулиця
Єрусалимська вулиця	Єрусалимська вулиця
Єстонська вулиця	Єстонська вулиця
Жаб’євська вулиця	Жабʼєвська вулиця
Жадьківська вулиця	Жадьківська вулиця
Жашківська вулиця	Жашківська вулиця
Желєзноводська вулиця	Желєзноводська вулиця
Желєзногорська вулиця	Желєзногорська вулиця
Женевська вулиця	Женевська вулиця
Женьовська вулиця	Женьовська вулиця
Жердовська вулиця	Жердовська вулиця
Жеревська вулиця	Жеревська вулиця
Животноводчеська вулиця	Животноводчеська вулиця
Жигулівська вулиця	Жигулівська вулиця
Жидачівська вулиця	Жидачівська вулиця
Жилянська вулиця	Жилянська вулиця
Жирівська вулиця	Жирівська вулиця
Житлкоопівська вулиця	Житлкоопівська вулиця
Житомирська вулиця	Житомирська вулиця
Житомирська вулиця'	Житомирська вулицяʼ
Жихарська вулиця	Жихарська вулиця
Жихорська вулиця	Жихорська вулиця
Жінрадівська вулиця	Жінрадівська вулиця
Жлобинська вулиця	Жлобинська вулиця
Жмеринська вулиця	Жмеринська вулиця
Жовківська вулиця	Жовківська вулиця
Жовтоводська вулиця	Жовтоводська вулиця
Жовторіченська вулиця	Жовторіченська вулиця
Жовторічинська вулиця	Жовторічинська вулиця
Жорниська вулиця	Жорниська вулиця
Жуківська вулиця	Жуківська вулиця
Жулянівська вулиця	Жулянівська вулиця
Жулянська вулиця	Жулянська вулиця
Жупанатська площа	Жупанатська площа
Журавенська вулиця	Журавенська вулиця
Журавинська вулиця	Журавинська вулиця
Журавлівська вулиця	Журавлівська вулиця
Журавлівська набережна	Журавлівська набережна
Журавська вулиця	Журавська вулиця
Журналістська вулиця	Журналістська вулиця
Жутівська вулиця	Жутівська вулиця
З’їздівська вулиця	Зʼїздівська вулиця
Забайкальська вулиця	Забайкальська вулиця
Забайківська вулиця	Забайківська вулиця
Забарівська вулиця	Забарівська вулиця
Забарська вулиця	Забарська вулиця
Забілінська вулиця	Забілінська вулиця
Заболотівська вулиця	Заболотівська вулиця
Заборинська вулиця	Заборинська вулиця
Забрамська вулиця	Забрамська вулиця
Забрідська вулиця	Забрідська вулиця
Забрідчанська вулиця	Забрідчанська вулиця
Забудівська вулиця	Забудівська вулиця
Забурська вулиця	Забурська вулиця
Забуянська вулиця	Забуянська вулиця
Завадівська вулиця	Завадівська вулиця
Завальська вулиця	Завальська вулиця
Завбірська вулиця	Завбірська вулиця
Заверблянська вулиця	Заверблянська вулиця
Заверічнянська вулиця	Заверічнянська вулиця
Завертаївська вулиця	Завертаївська вулиця
Завертянська вулиця	Завертянська вулиця
Завидівська вулиця	Завидівська вулиця
Завирська вулиця	Завирська вулиця
Заводська вулиця	Заводська вулиця
Заводська площа	Заводська площа
Заводська-Бічна вулиця	Заводська-Бічна вулиця
Загаївська вулиця	Загаївська вулиця
Загайпільська вулиця	Загайпільська вулиця
Загірська вулиця	Загірська вулиця
Загородська вулиця	Загородська вулиця
Загорська вулиця	Загорська вулиця
Загорянська вулиця	Загорянська вулиця
Загреблівська вулиця	Загреблівська вулиця
Загреблянська вулиця	Загреблянська вулиця
Загрязнянська вулиця	Загрязнянська вулиця
Задарська вулиця	Задарська вулиця
Задніпровська вулиця	Задніпровська вулиця
Задністровська вулиця	Задністровська вулиця
Задолинська вулиця	Задолинська вулиця
Задонська вулиця	Задонська вулиця
Задубрівська вулиця	Задубрівська вулиця
Задунаївська вулиця	Задунаївська вулиця
Задунайська вулиця	Задунайська вулиця
Зазимська вулиця	Зазимська вулиця
Займищанська вулиця	Займищанська вулиця
Закам’янська вулиця	Закамʼянська вулиця
Закарпатська вулиця	Закарпатська вулиця
Закубанська вулиця	Закубанська вулиця
Закутинська вулиця	Закутинська вулиця
Залевадівська вулиця	Залевадівська вулиця
Залиманівська вулиця	Залиманівська вулиця
Залипська вулиця	Залипська вулиця
Залізноводська вулиця	Залізноводська вулиця
Заліська вулиця	Заліська вулиця
Залужанська вулиця	Залужанська вулиця
Залужська вулиця	Залужська вулиця
Залучанська вулиця	Залучанська вулиця
Залютинська вулиця	Залютинська вулиця
Залющинська вулиця	Залющинська вулиця
Залядинська вулиця	Залядинська вулиця
Замарстинівська вулиця	Замарстинівська вулиця
Заміська вулиця	Заміська вулиця
Замківська вулиця	Замківська вулиця
Замлинська вулиця	Замлинська вулиця
Замонастирська вулиця	Замонастирська вулиця
Заморська вулиця	Заморська вулиця
Замостянська вулиця	Замостянська вулиця
Замощанська вулиця	Замощанська вулиця
Замуромська вулиця	Замуромська вулиця
Зантуська вулиця	Зантуська вулиця
Заорільська вулиця	Заорільська вулиця
Западинська вулиця	Западинська вулиця
Запоріжбудівська вулиця	Запоріжбудівська вулиця
Запоріжсталівська вулиця	Запоріжсталівська вулиця
Запоріжська вулиця	Запоріжська вулиця
Запречистська вулиця	Запречистська вулиця
Запрудська вулиця	Запрудська вулиця
Зарванська вулиця	Зарванська вулиця
Зарічанська вулиця	Зарічанська вулиця
Зарічненська вулиця	Зарічненська вулиця
Зарічнянська вулиця	Зарічнянська вулиця
Зарожанська вулиця	Зарожанська вулиця
Зароженська вулиця	Зароженська вулиця
Заросянська вулиця	Заросянська вулиця
Зарубська вулиця	Зарубська вулиця
Зарудновська вулиця	Зарудновська вулиця
Зарудянська вулиця	Зарудянська вулиця
Зарянська вулиця	Зарянська вулиця
Засільська вулиця	Засільська вулиця
Заславська вулиця	Заславська вулиця
Заставнівська вулиця	Заставнівська вулиця
Заставнянська вулиця	Заставнянська вулиця
Заставська вулиця	Заставська вулиця
Засумська вулиця	Засумська вулиця
Засянська вулиця	Засянська вулиця
Затишнянська вулиця	Затишнянська вулиця
Затуринська вулиця	Затуринська вулиця
Захарівська вулиця	Захарівська вулиця
Захватівська вулиця	Захватівська вулиця
Західно-Донбаська вулиця	Західно-Донбаська вулиця
Західнодонбаська вулиця	Західнодонбаська вулиця
Захонська вулиця	Захонська вулиця
Зачепилівська вулиця	Зачепилівська вулиця
Зачуговська вулиця	Зачуговська вулиця
Заярівська вулиця	Заярівська вулиця
Заярська вулиця	Заярська вулиця
Зборівська вулиця	Зборівська вулиця
Збручанська вулиця	Збручанська вулиця
Зваричівська вулиця	Зваричівська вулиця
Звенигородська вулиця	Звенигородська вулиця
Звенигородська площа	Звенигородська площа
Звенігородська вулиця	Звенігородська вулиця
Звенячинська вулиця	Звенячинська вулиця
Звірівська вулиця	Звірівська вулиця
Зворянська вулиця	Зворянська вулиця
Звягельська вулиця	Звягельська вулиця
Згарська вулиця	Згарська вулиця
Згурівська вулиця	Згурівська вулиця
Здвиженська вулиця	Здвиженська вулиця
Здолбунівська вулиця	Здолбунівська вулиця
Зейська вулиця	Зейська вулиця
Зеленбудівська вулиця	Зеленбудівська вулиця
Зеленовська вулиця	Зеленовська вулиця
Зеленогайська вулиця	Зеленогайська вулиця
Зеленогірська вулиця	Зеленогірська вулиця
Зеленогорська вулиця	Зеленогорська вулиця
Зеленоградська вулиця	Зеленоградська вулиця
Зеленодільська вулиця	Зеленодільська вулиця
Зеленодольська вулиця	Зеленодольська вулиця
Зеленокутська вулиця	Зеленокутська вулиця
Зеленосадська вулиця	Зеленосадська вулиця
Зеленоярівська вулиця	Зеленоярівська вулиця
Зеленоярська вулиця	Зеленоярська вулиця
Землемірська вулиця	Землемірська вулиця
Землянська вулиця	Землянська вулиця
Земовська вулиця	Земовська вулиця
Земська вулиця	Земська вулиця
Зернобазівська вулиця	Зернобазівська вулиця
Зерновська вулиця	Зерновська вулиця
Зерноградська вулиця	Зерноградська вулиця
Зестафонська вулиця	Зестафонська вулиця
Зимичівська вулиця	Зимичівська вулиця
Зимнівська вулиця	Зимнівська вулиця
Зимноводівська вулиця	Зимноводівська вулиця
Зимноводська вулиця	Зимноводська вулиця
Зідьковська вулиця	Зідьковська вулиця
Зінгенська вулиця	Зінгенська вулиця
Зіньківська вулиця	Зіньківська вулиця
Зірненська вулиця	Зірненська вулиця
Зірчанська вулиця	Зірчанська вулиця
Златопільська вулиця	Златопільська вулиця
Златопольська вулиця	Златопольська вулиця
Златоустівська вулиця	Златоустівська вулиця
Змагайлівська вулиця	Змагайлівська вулиця
Зміївська вулиця	Зміївська вулиця
Знам'янська вулиця	Знамʼянська вулиця
Знам’янська вулиця	Знамʼянська вулиця
Знам’янська площа	Знамʼянська площа
Знаменська вулиця	Знаменська вулиця
Зозулинська вулиця	Зозулинська вулиця
Зозулівська вулиця	Зозулівська вулиця
Золотаревська вулиця	Золотаревська вулиця
Золотарівська вулиця	Золотарівська вулиця
Золотіївська вулиця	Золотіївська вулиця
Золотоворітська вулиця	Золотоворітська вулиця
Золотогірська вулиця	Золотогірська вулиця
Золотоніська вулиця	Золотоніська вулиця
Золотонішська вулиця	Золотонішська вулиця
Золотоустівська вулиця	Золотоустівська вулиця
Золочевська вулиця	Золочевська вулиця
Золочівська вулиця	Золочівська вулиця
Зоринська вулиця	Зоринська вулиця
Зорянська вулиця	Зорянська вулиця
Зубанівська вулиця	Зубанівська вулиця
Зубівська вулиця	Зубівська вулиця
Зубрівська вулиця	Зубрівська вулиця
Зугресівська вулиця	Зугресівська вулиця
Зугреська вулиця	Зугреська вулиця
Зуївська вулиця	Зуївська вулиця
Івангородська площа	Івангородська площа
Іваниківська вулиця	Іваниківська вулиця
Іванівська вулиця	Іванівська вулиця
Іванівська набережна	Іванівська набережна
Іванківська вулиця	Іванківська вулиця
Івано-Франківська вулиця	Івано-Франківська вулиця
Іванопільська вулиця	Іванопільська вулиця
Іванська вулиця	Іванська вулиця
Івашинівська вулиця	Івашинівська вулиця
Івашківська вулиця	Івашківська вулиця
Івківська вулиця	Івківська вулиця
Івончанська вулиця	Івончанська вулиця
Ігарська вулиця	Ігарська вулиця
Ігнатівська вулиця	Ігнатівська вулиця
Ігорівська вулиця	Ігорівська вулиця
Ігренська вулиця	Ігренська вулиця
Іжевська вулиця	Іжевська вулиця
Іжиківська вулиця	Іжиківська вулиця
Іжкарська вулиця	Іжкарська вулиця
Ізворська вулиця	Ізворська вулиця
Ізмаїльська вулиця	Ізмаїльська вулиця
Ізмайлівська вулиця	Ізмайлівська вулиця
Ізмайловська вулиця	Ізмайловська вулиця
Ізюмівська вулиця	Ізюмівська вулиця
Ізюмська вулиця	Ізюмська вулиця
Ізяславська вулиця	Ізяславська вулиця
ІІІ-Гвардійська вулиця	ІІІ-Гвардійська вулиця
Іларіонівська вулиця	Іларіонівська вулиця
Іллінська вулиця	Іллінська вулиця
Іллічівська вулиця	Іллічівська вулиця
Іловайська вулиця	Іловайська вулиця
Ільїнська вулиця	Ільїнська вулиця
Ільменська вулиця	Ільменська вулиця
Інгульська вулиця	Інгульська вулиця
Інгушська вулиця	Інгушська вулиця
Інзовська вулиця	Інзовська вулиця
інспекторська автодорога	інспекторська автодорога
Інститутська вулиця	Інститутська вулиця
Інтендантська вулиця	Інтендантська вулиця
Інтернатська вулиця	Інтернатська вулиця
Іоанно-Предтеченська вулиця	Іоанно-Предтеченська вулиця
Іорданська вулиця	Іорданська вулиця
Ірдинська вулиця	Ірдинська вулиця
Іржавська вулиця	Іржавська вулиця
Ірининська вулиця	Ірининська вулиця
Ірклійська вулиця	Ірклійська вулиця
Іркутська вулиця	Іркутська вулиця
Ірпінська вулиця	Ірпінська вулиця
Ірпіньська вулиця	Ірпіньська вулиця
Іртиська вулиця	Іртиська вулиця
Іртишська вулиця	Іртишська вулиця
Іршавська вулиця	Іршавська вулиця
Іршанська вулиця	Іршанська вулиця
Ісаївська вулиця	Ісаївська вулиця
Іскоростенська вулиця	Іскоростенська вулиця
Іскринська вулиця	Іскринська вулиця
Іскрівська вулиця	Іскрівська вулиця
Іскрянська вулиця	Іскрянська вулиця
Іспанська вулиця	Іспанська вулиця
Іспаська вулиця	Іспаська вулиця
Істомінська вулиця	Істомінська вулиця
Істринська вулиця	Істринська вулиця
Італійська вулиця	Італійська вулиця
Ічинська вулиця	Ічинська вулиця
Ічкерська вулиця	Ічкерська вулиця
Ішимська вулиця	Ішимська вулиця
Іюльська вулиця	Іюльська вулиця
Їсіпівська вулиця	Їсіпівська вулиця
Йоврянська вулиця	Йоврянська вулиця
Йорданська вулиця	Йорданська вулиця
Йосипівська вулиця	Йосипівська вулиця
Кабардинська вулиця	Кабардинська вулиця
Кавалерійська вулиця	Кавалерійська вулиця
Кагульська вулиця	Кагульська вулиця
Кадієвська вулиця	Кадієвська вулиця
Кадіївська вулиця	Кадіївська вулиця
Казанська вулиця	Казанська вулиця
Казахстанська вулиця	Казахстанська вулиця
Казахська вулиця	Казахська вулиця
Казбетська вулиця	Казбетська вулиця
Кайданівська вулиця	Кайданівська вулиця
Кайтанівська вулиця	Кайтанівська вулиця
Калаборокська вулиця	Калаборокська вулиця
Калантаївська вулиця	Калантаївська вулиця
Калантирська вулиця	Калантирська вулиця
Калигірська вулиця	Калигірська вулиця
Калинівська вулиця	Калинівська вулиця
Калинська вулиця	Калинська вулиця
Калишівська вулиця	Калишівська вулиця
Калінінградська вулиця	Калінінградська вулиця
Калінінська вулиця	Калінінська вулиця
Каліська вулиця	Каліська вулиця
Калічанська площа	Калічанська площа
Калужська вулиця	Калужська вулиця
Калуська вулиця	Калуська вулиця
Кальміуська вулиця	Кальміуська вулиця
Кальчанська вулиця	Кальчанська вулиця
Калюська вулиця	Калюська вулиця
Кам'янець-Подільська вулиця	Камʼянець-Подільська вулиця
Кам'янська вулиця	Камʼянська вулиця
Кам’ янська вулиця	Камʼянська вулиця
Кам’янець-Подільська вулиця	Камʼянець-Подільська вулиця
Кам’яногірська вулиця	Камʼяногірська вулиця
Кам’яномостівська вулиця	Камʼяномостівська вулиця
Кам’янська вулиця	Камʼянська вулиця
Кам’янсько-Дніпровська вулиця	Камʼянсько-Дніпровська вулиця
Кам’януватська вулиця	Камʼянуватська вулиця
Камазівська вулиця	Камазівська вулиця
Каменська вулиця	Каменська вулиця
Камишинська вулиця	Камишинська вулиця
Камська вулиця	Камська вулиця
Камчатська вулиця	Камчатська вулиця
Камʼянська вулиця	Камʼянська вулиця
Канадська вулиця	Канадська вулиця
Канальська вулиця	Канальська вулиця
Канальська дорога	Канальська дорога
Канарська вулиця	Канарська вулиця
Канатівська вулиця	Канатівська вулиця
Канашська вулиця	Канашська вулиця
Кандибівська вулиця	Кандибівська вулиця
Кандибінська вулиця	Кандибінська вулиця
Канівська вулиця	Канівська вулиця
Канківська вулиця	Канківська вулиця
Кантемирівська вулиця	Кантемирівська вулиця
Капеланська вулиця	Капеланська вулиця
Капітанська вулиця	Капітанська вулиця
Капранівська вулиця	Капранівська вулиця
Капустянська вулиця	Капустянська вулиця
Капушанська вулиця	Капушанська вулиця
Карабинівська вулиця	Карабинівська вулиця
Караванська вулиця	Караванська вулиця
Карагандинська вулиця	Карагандинська вулиця
Каразінська вулиця	Каразінська вулиця
Караїмська вулиця	Караїмська вулиця
Каракалпакська вулиця	Каракалпакська вулиця
Караківська вулиця	Караківська вулиця
Каракумська вулиця	Каракумська вулиця
Каранська вулиця	Каранська вулиця
Карапчівська вулиця	Карапчівська вулиця
Карасівська вулиця	Карасівська вулиця
Карачаєвська вулиця	Карачаєвська вулиця
Карачинівська вулиця	Карачинівська вулиця
Карачинська вулиця	Карачинська вулиця
Карельська вулиця	Карельська вулиця
Карінтійська вулиця	Карінтійська вулиця
Карлівська вулиця	Карлівська вулиця
Карнаватська вулиця	Карнаватська вулиця
Карнетівська вулиця	Карнетівська вулиця
Карпатська вулиця	Карпатська вулиця
Карпівська вулиця	Карпівська вулиця
Картамишевська вулиця	Картамишевська вулиця
Карташівська вулиця	Карташівська вулиця
Карякінська вулиця	Карякінська вулиця
Касперовська вулиця	Касперовська вулиця
Каспійська вулиця	Каспійська вулиця
Каталеївська вулиця	Каталеївська вулиця
Катерининська вулиця	Катерининська вулиця
Катерининська площа	Катерининська площа
Катеринівська вулиця	Катеринівська вулиця
Катеринінська вулиця	Катеринінська вулиця
Катеринопільська вулиця	Катеринопільська вулиця
Катеринославська вулиця	Катеринославська вулиця
Катіонівська вулиця	Катіонівська вулиця
Каунаська вулиця	Каунаська вулиця
Кафайська вулиця	Кафайська вулиця
Каховська вулиця	Каховська вулиця
Качанівська вулиця	Качанівська вулиця
Качурівська вулиця	Качурівська вулиця
Каширівська вулиця	Каширівська вулиця
Каширська вулиця	Каширська вулиця
Каштанівська вулиця	Каштанівська вулиця
Каянська вулиця	Каянська вулиця
Кварцівська вулиця	Кварцівська вулиця
Квашинська вулиця	Квашинська вулиця
Квіткинська вулиця	Квіткинська вулиця
Кегичівська вулиця	Кегичівська вулиця
Кедовська вулиця	Кедовська вулиця
Кемеровська вулиця	Кемеровська вулиця
Керченська вулиця	Керченська вулиця
Керченська площа	Керченська площа
Києво-Московська вулиця	Києво-Московська вулиця
Києво-Подільська вулиця	Києво-Подільська вулиця
Кизильська вулиця	Кизильська вулиця
Кизилянська вулиця	Кизилянська вулиця
Киівська вулиця	Киівська вулиця
Київська вулиця	Київська вулиця
Київська набережна	Київська набережна
Київська площа	Київська площа
Кийлівська вулиця	Кийлівська вулиця
Кинашівська вулиця	Кинашівська вулиця
Кирданівська вулиця	Кирданівська вулиця
Кириківська вулиця	Кириківська вулиця
Кирилівська вулиця	Кирилівська вулиця
Кирило-Мефодіївська вулиця	Кирило-Мефодіївська вулиця
Кирпичнозаводська вулиця	Кирпичнозаводська вулиця
Киселівська вулиця	Киселівська вулиця
Кисельовська вулиця	Кисельовська вулиця
Кисилбасівська вулиця	Кисилбасівська вулиця
Кисилівська вулиця	Кисилівська вулиця
Кисловодська вулиця	Кисловодська вулиця
Кисляківська вулиця	Кисляківська вулиця
Китаївська вулиця	Китаївська вулиця
Китайгородська вулиця	Китайгородська вулиця
Китайська вулиця	Китайська вулиця
Кичеївська вулиця	Кичеївська вулиця
Кишиневська вулиця	Кишиневська вулиця
Кишинівська вулиця	Кишинівська вулиця
Кишинська вулиця	Кишинська вулиця
Киъвська вулиця	Киъвська вулиця
Киянська вулиця	Киянська вулиця
Ківерцівська вулиця	Ківерцівська вулиця
Кідьоська вулиця	Кідьоська вулиця
Кізіярська вулиця	Кізіярська вулиця
Кілійська вулиця	Кілійська вулиця
Кільченська вулиця	Кільченська вулиця
Кімівська вулиця	Кімівська вулиця
Кінбурнська вулиця	Кінбурнська вулиця
Кіндійська вулиця	Кіндійська вулиця
Кінноармійська вулиця	Кінноармійська вулиця
Кіннозаводська вулиця	Кіннозаводська вулиця
Кіреська вулиця	Кіреська вулиця
Кірінаківська вулиця	Кірінаківська вулиця
Кіровабадська вулиця	Кіровабадська вулиця
Кіровобадська вулиця	Кіровобадська вулиця
Кіровоградська вулиця	Кіровоградська вулиця
Кіровська вулиця	Кіровська вулиця
Кіцманська вулиця	Кіцманська вулиця
Кічкарівська вулиця	Кічкарівська вулиця
Клавдіївська вулиця	Клавдіївська вулиця
Кладижинська вулиця	Кладижинська вулиця
Кладовищенська вулиця	Кладовищенська вулиця
Клайпедська вулиця	Клайпедська вулиця
Клеванська вулиця	Клеванська вулиця
Клеківська вулиця	Клеківська вулиця
Клеманська вулиця	Клеманська вулиця
Клеменівська вулиця	Клеменівська вулиця
Кленівська вулиця	Кленівська вулиця
Клепальська вулиця	Клепальська вулиця
Клепарівська вулиця	Клепарівська вулиця
Климівська вулиця	Климівська вулиця
Клинівська вулиця	Клинівська вулиця
Клинська вулиця	Клинська вулиця
Кличанська вулиця	Кличанська вулиця
Клосівська вулиця	Клосівська вулиця
Клочанська вулиця	Клочанська вулиця
Клочківська вулиця	Клочківська вулиця
Кльованівська вулиця	Кльованівська вулиця
Клюсівська вулиця	Клюсівська вулиця
Клюсовська вулиця	Клюсовська вулиця
Ключарківська вулиця	Ключарківська вулиця
Ключарська вулиця	Ключарська вулиця
Ключівська вулиця	Ключівська вулиця
Кляпарівська вулиця	Кляпарівська вулиця
Княгининська вулиця	Княгининська вулиця
Княждвірська вулиця	Княждвірська вулиця
Князівська вулиця	Князівська вулиця
Кобзарівська вулиця	Кобзарівська вулиця
Кобзарська вулиця	Кобзарська вулиця
Кобилянська вулиця	Кобилянська вулиця
Коблевська вулиця	Коблевська вулиця
Кобринська вулиця	Кобринська вулиця
Ковалинська вулиця	Ковалинська вулиця
Ковалівська вулиця	Ковалівська вулиця
Ковальська вулиця	Ковальська вулиця
Кованківська вулиця	Кованківська вулиця
Ковельська вулиця	Ковельська вулиця
Ковровська вулиця	Ковровська вулиця
Кодемська вулиця	Кодемська вулиця
Кодимська вулиця	Кодимська вулиця
Кожарівська вулиця	Кожарівська вулиця
Кожем’ятська вулиця	Кожемʼятська вулиця
Козарівська вулиця	Козарівська вулиця
Козачанська вулиця	Козачанська вулиця
Козинська вулиця	Козинська вулиця
Козирівська вулиця	Козирівська вулиця
Козюлінська вулиця	Козюлінська вулиця
Козятинська вулиця	Козятинська вулиця
Кокандська вулиця	Кокандська вулиця
Коксохімівська вулиця	Коксохімівська вулиця
Кокчетавська вулиця	Кокчетавська вулиця
Колбудівська вулиця	Колбудівська вулиця
Колесниківська вулиця	Колесниківська вулиця
Колеусівська вулиця	Колеусівська вулиця
Колісниченківська вулиця	Колісниченківська вулиця
Колодійська вулиця	Колодійська вулиця
Колоднянська вулиця	Колоднянська вулиця
Коломенська вулиця	Коломенська вулиця
Коломийська вулиця	Коломийська вулиця
Коломийцевська вулиця	Коломийцевська вулиця
Коломичівська вулиця	Коломичівська вулиця
Коломінська вулиця	Коломінська вулиця
Коломоївська вулиця	Коломоївська вулиця
Колонківська вулиця	Колонківська вулиця
Колонтаївська вулиця	Колонтаївська вулиця
Колтівська вулиця	Колтівська вулиця
Кольцовська вулиця	Кольцовська вулиця
Командирська вулиця	Командирська вулиця
Комарівська вулиця	Комарівська вулиця
Комарнівська вулиця	Комарнівська вулиця
Комаровська вулиця	Комаровська вулиця
Комбайнерська вулиця	Комбайнерська вулиця
Комбайнівська вулиця	Комбайнівська вулиця
Комбідівська вулиця	Комбідівська вулиця
Комбінатівська вулиця	Комбінатівська вулиця
Комбінатська вулиця	Комбінатська вулиця
Комендантська вулиця	Комендантська вулиця
Коминярська вулиця	Коминярська вулиця
Комишанська вулиця	Комишанська вулиця
Комишнянська вулиця	Комишнянська вулиця
Комінтернівська вулиця	Комінтернівська вулиця
Комісарівська вулиця	Комісарівська вулиця
Комітетська вулиця	Комітетська вулиця
Компанійська вулиця	Компанійська вулиця
Комсомольська вулиця	Комсомольська вулиця
Комсомольська площа	Комсомольська площа
Комсомольська-І вулиця	Комсомольська-І вулиця
Комсомольська-ІІ вулиця	Комсомольська-ІІ вулиця
Комунарівська вулиця	Комунарівська вулиця
Комунарська вулиця	Комунарська вулиця
Конаївська вулиця	Конаївська вулиця
Конармійська вулиця	Конармійська вулиця
Конградська вулиця	Конградська вулиця
Кондукторська вулиця	Кондукторська вулиця
Кононівська вулиця	Кононівська вулиця
Коноплянська вулиця	Коноплянська вулиця
Конотопська вулиця	Конотопська вулиця
Константинівська вулиця	Константинівська вулиця
Константська вулиця	Константська вулиця
Конструкторська вулиця	Конструкторська вулиця
Консульська вулиця	Консульська вулиця
Конторська вулиця	Конторська вулиця
Контотопська вулиця	Контотопська вулиця
Концівська вулиця	Концівська вулиця
Конюхівська вулиця	Конюхівська вулиця
Конюшківська вулиця	Конюшківська вулиця
Коняєвська вулиця	Коняєвська вулиця
Копайгородська вулиця	Копайгородська вулиця
Копанська вулиця	Копанська вулиця
Копачівська вулиця	Копачівська вулиця
Коперновська вулиця	Коперновська вулиця
Копилівська вулиця	Копилівська вулиця
Копиловська вулиця	Копиловська вулиця
Корваллівська вулиця	Корваллівська вулиця
Корделівська вулиця	Корделівська вулиця
Кордишівська вулиця	Кордишівська вулиця
Корейська вулиця	Корейська вулиця
Коржівська вулиця	Коржівська вулиця
Корзунівська вулиця	Корзунівська вулиця
Користівська вулиця	Користівська вулиця
Коритинська вулиця	Коритинська вулиця
Коритнянська вулиця	Коритнянська вулиця
Корнинська вулиця	Корнинська вулиця
Коробінська вулиця	Коробінська вулиця
Коровійська вулиця	Коровійська вулиця
Корогодська вулиця	Корогодська вулиця
Короленківська вулиця	Короленківська вулиця
Королівська вулиця	Королівська вулиця
Коропівська вулиця	Коропівська вулиця
Коростельська вулиця	Коростельська вулиця
Коростенська вулиця	Коростенська вулиця
Коростишівська вулиця	Коростишівська вулиця
Корсівська вулиця	Корсівська вулиця
Корсунівська вулиця	Корсунівська вулиця
Корсунська вулиця	Корсунська вулиця
Корсунь-Шевченківська вулиця	Корсунь-Шевченківська вулиця
Корсуньська вулиця	Корсуньська вулиця
Корчагінська вулиця	Корчагінська вулиця
Корчаківська вулиця	Корчаківська вулиця
Корчинська вулиця	Корчинська вулиця
Корчуватська вулиця	Корчуватська вулиця
Косарівська вулиця	Косарівська вулиця
Косачівська вулиця	Косачівська вулиця
Косенківська вулиця	Косенківська вулиця
Косинська вулиця	Косинська вулиця
Косівська вулиця	Косівська вулиця
Косівщинська вулиця	Косівщинська вулиця
Косіївська вулиця	Косіївська вулиця
Космодем'янська вулиця	Космодемʼянська вулиця
Космодем’янська вулиця	Космодемʼянська вулиця
Косогорська вулиця	Косогорська вулиця
Косомольська вулиця	Косомольська вулиця
Костанайська вулиця	Костанайська вулиця
Костомарівська вулиця	Костомарівська вулиця
Костопалівська вулиця	Костопалівська вулиця
Костопільська вулиця	Костопільська вулиця
Костромська вулиця	Костромська вулиця
Костянтинівська вулиця	Костянтинівська вулиця
Косянська вулиця	Косянська вулиця
Котелевська вулиця	Котелевська вулиця
Котелківська вулиця	Котелківська вулиця
Котельниківська вулиця	Котельниківська вулиця
Котиківська вулиця	Котиківська вулиця
Котівська вулиця	Котівська вулиця
Котковська вулиця	Котковська вулиця
Котласька вулиця	Котласька вулиця
Котлеєвська вулиця	Котлеєвська вулиця
Котлярська вулиця	Котлярська вулиця
Коханівська вулиця	Коханівська вулиця
Кохнівська вулиця	Кохнівська вулиця
Коцарська вулиця	Коцарська вулиця
Кочанівська вулиця	Кочанівська вулиця
Кочегарська вулиця	Кочегарська вулиця
Кочетокська вулиця	Кочетокська вулиця
Кочубеївська вулиця	Кочубеївська вулиця
Кошівська вулиця	Кошівська вулиця
Краївська вулиця	Краївська вулиця
Краківська вулиця	Краківська вулиця
Крамаренківська вулиця	Крамаренківська вулиця
Краматорська вулиця	Краматорська вулиця
Крамчанинівська вулиця	Крамчанинівська вулиця
Красилівська вулиця	Красилівська вулиця
Красівська вулиця	Красівська вулиця
Красненьківська вулиця	Красненьківська вулиця
Краснівська вулиця	Краснівська вулиця
Красноармійська вулиця	Красноармійська вулиця
Краснобірська вулиця	Краснобірська вулиця
Красноводська вулиця	Красноводська вулиця
Красногвардійська вулиця	Красногвардійська вулиця
Красногірська вулиця	Красногірська вулиця
Красногорівська вулиця	Красногорівська вулиця
Красногорська вулиця	Красногорська вулиця
Красноградська вулиця	Красноградська вулиця
Краснодарська вулиця	Краснодарська вулиця
Краснодонська вулиця	Краснодонська вулиця
Краснозаводська вулиця	Краснозаводська вулиця
Краснознаменська вулиця	Краснознаменська вулиця
Краснознамʼянська вулиця	Краснознамʼянська вулиця
Красноїльська вулиця	Красноїльська вулиця
Краснокутська вулиця	Краснокутська вулиця
Краснолиманська вулиця	Краснолиманська вулиця
Красноокнянська вулиця	Красноокнянська вулиця
Краснооктябрська вулиця	Краснооктябрська вулиця
Краснооктябрьська вулиця	Краснооктябрьська вулиця
Краснопартизанська вулиця	Краснопартизанська вулиця
Красноперекопська вулиця	Красноперекопська вулиця
Краснопільська вулиця	Краснопільська вулиця
Краснопольська вулиця	Краснопольська вулиця
Краснопресненська вулиця	Краснопресненська вулиця
Краснопролетарська вулиця	Краснопролетарська вулиця
Краснорічинська вулиця	Краснорічинська вулиця
Красносельська вулиця	Красносельська вулиця
Красносільська вулиця	Красносільська вулиця
Краснослобідська вулиця	Краснослобідська вулиця
Красносоколянська вулиця	Красносоколянська вулиця
Красносулинська вулиця	Красносулинська вулиця
Красноуральська вулиця	Красноуральська вулиця
Красноуфимська вулиця	Красноуфимська вулиця
Краснофлотська вулиця	Краснофлотська вулиця
Красночечелівська вулиця	Красночечелівська вулиця
Красноярська вулиця	Красноярська вулиця
Краснянська вулиця	Краснянська вулиця
Кременівська вулиця	Кременівська вулиця
Кременська вулиця	Кременська вулиця
Кремінська вулиця	Кремінська вулиця
Кремлівська вулиця	Кремлівська вулиця
Кресівська вулиця	Кресівська вулиця
Крехівська вулиця	Крехівська вулиця
Кривалівська вулиця	Кривалівська вулиця
Кривбасівська вулиця	Кривбасівська вулиця
Кривобалківська вулиця	Кривобалківська вулиця
Кривогірська вулиця	Кривогірська вулиця
Кривогреблянська вулиця	Кривогреблянська вулиця
Кривоконівська вулиця	Кривоконівська вулиця
Кривоносівська вулиця	Кривоносівська вулиця
Кривосільська вулиця	Кривосільська вулиця
Кривулевська вулиця	Кривулевська вулиця
Кривушанська вулиця	Кривушанська вулиця
Кривчанська вулиця	Кривчанська вулиця
Крилівська вулиця	Крилівська вулиця
Криловська вулиця	Криловська вулиця
Кримська вулиця	Кримська вулиця
Криничанська вулиця	Криничанська вулиця
Кринська вулиця	Кринська вулиця
Кристинопільська вулиця	Кристинопільська вулиця
Кровинківська вулиця	Кровинківська вулиця
Кромська вулиця	Кромська вулиця
Кронштадська вулиця	Кронштадська вулиця
Кронштадтська вулиця	Кронштадтська вулиця
Кропив’янська вулиця	Кропивʼянська вулиця
Кропоткінська вулиця	Кропоткінська вулиця
Кроснівська вулиця	Кроснівська вулиця
Крохмалівська вулиця	Крохмалівська вулиця
Крошенська вулиця	Крошенська вулиця
Крошенська набережна	Крошенська набережна
Кругівська вулиця	Кругівська вулиця
Круглоуніверситетська вулиця	Круглоуніверситетська вулиця
Круп’ярська вулиця	Крупʼярська вулиця
Крупська вулиця	Крупська вулиця
Крутівська вулиця	Крутівська вулиця
Крутобережанська вулиця	Крутобережанська вулиця
Крутогірська вулиця	Крутогірська вулиця
Крутоярівська вулиця	Крутоярівська вулиця
Крутоярська вулиця	Крутоярська вулиця
Крюківська вулиця	Крюківська вулиця
Ксеніївська вулиця	Ксеніївська вулиця
Кубанська вулиця	Кубанська вулиця
Кубинська вулиця	Кубинська вулиця
Кудинська вулиця	Кудинська вулиця
Кудлаївська вулиця	Кудлаївська вулиця
Кудревська вулиця	Кудревська вулиця
Кудрявська вулиця	Кудрявська вулиця
Кузбасівська вулиця	Кузбасівська вулиця
Кузбаська вулиця	Кузбаська вулиця
Кузьминська вулиця	Кузьминська вулиця
Кукезівська вулиця	Кукезівська вулиця
Куклівська вулиця	Куклівська вулиця
Кукуянська вулиця	Кукуянська вулиця
Кулебівська вулиця	Кулебівська вулиця
Кулебiвська вулиця	Кулебiвська вулиця
Куликівська вулиця	Куликівська вулиця
Куликівська екостежка	Куликівська екостежка
Куликовська вулиця	Куликовська вулиця
Кулиничівська вулиця	Кулиничівська вулиця
Кулинівська вулиця	Кулинівська вулиця
Куличанська вулиця	Куличанська вулиця
Кулишівська вулиця	Кулишівська вулиця
Куліковська вулиця	Куліковська вулиця
Кулішівська вулиця	Кулішівська вулиця
Кульпарківська вулиця	Кульпарківська вулиця
Культкомівська вулиця	Культкомівська вулиця
Кунашівська вулиця	Кунашівська вулиця
Куп'янська вулиця	Купʼянська вулиця
Куп’янська вулиця	Купʼянська вулиця
Купальська вулиця	Купальська вулиця
Купичвільська вулиця	Купичвільська вулиця
Купріївська вулиця	Купріївська вулиця
Купріянівська вулиця	Купріянівська вулиця
Курахівська вулиця	Курахівська вулиця
Курганівська вулиця	Курганівська вулиця
Курганська вулиця	Курганська вулиця
Куренівська вулиця	Куренівська вулиця
Курилівська вулиця	Курилівська вулиця
Курильська вулиця	Курильська вулиця
Куріханівська вулиця	Куріханівська вулиця
Курсантська вулиця	Курсантська вулиця
Курська вулиця	Курська вулиця
Куртівська вулиця	Куртівська вулиця
Куруківська вулиця	Куруківська вулиця
Куряжанська вулиця	Куряжанська вулиця
Куряжська вулиця	Куряжська вулиця
Кустанайська вулиця	Кустанайська вулиця
Кустовська вулиця	Кустовська вулиця
Кусторянська вулиця	Кусторянська вулиця
Кустунайська вулиця	Кустунайська вулиця
Кутаїська вулиця	Кутаїська вулиця
Кутівська вулиця	Кутівська вулиця
Куткірська вулиця	Куткірська вулиця
Кутська вулиця	Кутська вулиця
Кутузовська вулиця	Кутузовська вулиця
Кутянська вулиця	Кутянська вулиця
Куусінська вулиця	Куусінська вулиця
Кухарська вулиця	Кухарська вулиця
Кучанська вулиця	Кучанська вулиця
Кучугурська вулиця	Кучугурська вулиця
Кучуринська вулиця	Кучуринська вулиця
Кушнарівська вулиця	Кушнарівська вулиця
Кушнірська вулиця	Кушнірська вулиця
Кущівська вулиця	Кущівська вулиця
Кущiвська вулиця	Кущiвська вулиця
Куютинська вулиця	Куютинська вулиця
Лавківська вулиця	Лавківська вулиця
Лаврська вулиця	Лаврська вулиця
Лавчанська вулиця	Лавчанська вулиця
Лагодинська вулиця	Лагодинська вулиця
Ладанська вулиця	Ладанська вулиця
Ладичинська вулиця	Ладичинська вулиця
Ладожська вулиця	Ладожська вулиця
Лазаревська вулиця	Лазаревська вулиця
Лазарєвська вулиця	Лазарєвська вулиця
Лазарівська вулиця	Лазарівська вулиця
Лазівська вулиця	Лазівська вулиця
Лазориківська вулиця	Лазориківська вулиця
Лазянська вулиця	Лазянська вулиця
Ламбертівська вулиця	Ламбертівська вулиця
Ланжеронівська вулиця	Ланжеронівська вулиця
Ланівська вулиця	Ланівська вулиця
Лапинська вулиця	Лапинська вулиця
Лаптенківська вулиця	Лаптенківська вулиця
Лапутьківська вулиця	Лапутьківська вулиця
Латвійська вулиця	Латвійська вулиця
Латиська вулиця	Латиська вулиця
Лауреатська вулиця	Лауреатська вулиця
Лахтинська вулиця	Лахтинська вулиця
Лебединська вулиця	Лебединська вулиця
Лев’ятинська вулиця	Левʼятинська вулиця
Левадівська вулиця	Левадівська вулиця
Левадійська вулиця	Левадійська вулиця
Левандівська вулиця	Левандівська вулиця
Левандовська вулиця	Левандовська вулиця
Левендалівська вулиця	Левендалівська вулиця
Легпромівська вулиця	Легпромівська вулиця
Лезнівська вулиця	Лезнівська вулиця
Лейтенантська вулиця	Лейтенантська вулиця
Лелеківська вулиця	Лелеківська вулиця
Лелехівська вулиця	Лелехівська вулиця
Лелітська вулиця	Лелітська вулиця
Лелюківська вулиця	Лелюківська вулиця
Лемківська вулиця	Лемківська вулиця
Ленінабадська вулиця	Ленінабадська вулиця
Ленінгардська вулиця	Ленінгардська вулиця
Ленінградська вулиця	Ленінградська вулиця
Ленінградська площа	Ленінградська площа
Леніногірська вулиця	Леніногірська вулиця
Леніногорська вулиця	Леніногорська вулиця
Ленінопольська вулиця	Ленінопольська вулиця
Ленінська вулиця	Ленінська вулиця
Ленківська вулиця	Ленківська вулиця
Ленкоранська вулиця	Ленкоранська вулиця
Ленська вулиця	Ленська вулиця
Ленська вулицяц	Ленська вулицяц
Леонівська вулиця	Леонівська вулиця
Леонідівська вулиця	Леонідівська вулиця
Леонтіївська вулиця	Леонтіївська вулиця
Лепехівська вулиця	Лепехівська вулиця
Лермонтовська вулиця	Лермонтовська вулиця
Леськівська вулиця	Леськівська вулиця
Летичівська вулиця	Летичівська вулиця
Лєзнівська вулиця	Лєзнівська вулиця
Лєніногорська вулиця	Лєніногорська вулиця
Либідська вулиця	Либідська вулиця
Либідська площа	Либідська площа
Ливарська вулиця	Ливарська вулиця
Лижв’ярська вулиця	Лижвʼярська вулиця
Лиманська вулиця	Лиманська вулиця
Линівська вулиця	Линівська вулиця
Лип'янська вулиця	Липʼянська вулиця
Лип’янська вулиця	Липʼянська вулиця
Липанська дорога	Липанська дорога
Липівська вулиця	Липівська вулиця
Липівцівська школа	Липівцівська школа
Липканська вулиця	Липканська вулиця
Липлянська вулиця	Липлянська вулиця
Липниківська вулиця	Липниківська вулиця
Липнянська вулиця	Липнянська вулиця
Липська вулиця	Липська вулиця
Липцівська вулиця	Липцівська вулиця
Лисаківська вулиця	Лисаківська вулиця
Лисенівська вулиця	Лисенівська вулиця
Лисичанська вулиця	Лисичанська вулиця
Лисківська вулиця	Лисківська вулиця
Лисовська вулиця	Лисовська вулиця
Лисогірська вулиця	Лисогірська вулиця
Лисогорська вулиця	Лисогорська вулиця
Лисянська вулиця	Лисянська вулиця
Литвинівська вулиця	Литвинівська вулиця
Литовська вулиця	Литовська вулиця
Лихівська вулиця	Лихівська вулиця
Лицарська вулиця	Лицарська вулиця
Личаківська вулиця	Личаківська вулиця
Личанська вулиця	Личанська вулиця
Лібавська вулиця	Лібавська вулиця
Лібентальська вулиця	Лібентальська вулиця
Лівенська вулиця	Лівенська вулиця
Лідавська вулиця	Лідавська вулиця
Лідіївська вулиця	Лідіївська вулиця
Лієпайська вулиця	Лієпайська вулиця
Лізянська вулиця	Лізянська вулиця
Лікарська вулиця	Лікарська вулиця
Ліманська вулиця	Ліманська вулиця
Лінська вулиця	Лінська вулиця
Ліньовська вулиця	Ліньовська вулиця
Ліпінська вулиця	Ліпінська вулиця
Лісківська вулиця	Лісківська вулиця
Ліснянська вулиця	Ліснянська вулиця
Лісовинівська вулиця	Лісовинівська вулиця
Лісоводська вулиця	Лісоводська вулиця
Лісовська вулиця	Лісовська вулиця
Лісогірська вулиця	Лісогірська вулиця
Лісогорська вулиця	Лісогорська вулиця
Лісогредська вулиця	Лісогредська вулиця
Лісозаводська вулиця	Лісозаводська вулиця
Лісопарківська вулиця	Лісопарківська вулиця
Ліська вулиця	Ліська вулиця
Літинська вулиця	Літинська вулиця
Літківська вулиця	Літківська вулиця
Літовська вулиця	Літовська вулиця
Ліцейська вулиця	Ліцейська вулиця
Лішнянська вулиця	Лішнянська вулиця
Ліщинівська вулиця	Ліщинівська вулиця
Ліщинська вулиця	Ліщинська вулиця
Лобачинська вулиця	Лобачинська вулиця
Логанська вулиця	Логанська вулиця
Лодомирська вулиця	Лодомирська вулиця
Лозівська вулиця	Лозівська вулиця
Лозоватська вулиця	Лозоватська вулиця
Лозовеньківська вулиця	Лозовеньківська вулиця
Лозовська вулиця	Лозовська вулиця
Лозуватська вулиця	Лозуватська вулиця
Лозянська вулиця	Лозянська вулиця
Ломаківська вулиця	Ломаківська вулиця
Лондонська вулиця	Лондонська вулиця
Лопанська вулиця	Лопанська вулиця
Лопанська набережна	Лопанська набережна
Лопатинська вулиця	Лопатинська вулиця
Лопатівська головна	Лопатівська головна
Лосівська вулиця	Лосівська вулиця
Лоскутівська вулиця	Лоскутівська вулиця
Лосятинська вулиця	Лосятинська вулиця
Лоцківська вулиця	Лоцківська вулиця
Лоцманська вулиця	Лоцманська вулиця
Лошнівська вулиця	Лошнівська вулиця
Луб'янська вулиця	Лубʼянська вулиця
Лубенська вулиця	Лубенська вулиця
Лубеньська вулиця	Лубеньська вулиця
Лубянська вулиця	Лубянська вулиця
Луганська вулиця	Луганська вулиця
Лугинівська вулиця	Лугинівська вулиця
Лугинська вулиця	Лугинська вулиця
Лугівська вулиця	Лугівська вулиця
Лугівська́ вулиця	Лугівська́ вулиця
Луговська вулиця	Луговська вулиця
Лужанська вулиця	Лужанська вулиця
Лузанівська вулиця	Лузанівська вулиця
Лук’янівська вулиця	Лукʼянівська вулиця
Лук’янівська площа	Лукʼянівська площа
Лукашівська вулиця	Лукашівська вулиця
Луківська вулиця	Луківська вулиця
Лутеньська вулиця	Лутеньська вулиця
Лутугінська вулиця	Лутугінська вулиця
Лухтівська вулиця	Лухтівська вулиця
Лучанська вулиця	Лучанська вулиця
Лучинківська вулиця	Лучинківська вулиця
Лучівська вулиця	Лучівська вулиця
Львівська вулиця	Львівська вулиця
Львівська площа	Львівська площа
Льговська вулиця	Льговська вулиця
Льонарська вулиця	Льонарська вулиця
Льонозаводська вулиця	Льонозаводська вулиця
Льонокомбінатівська вулиця	Льонокомбінатівська вулиця
Любавинська вулиця	Любавинська вулиця
Любарська вулиця	Любарська вулиця
Любачівська вулиця	Любачівська вулиця
Любашівська вулиця	Любашівська вулиця
Любешівська вулиця	Любешівська вулиця
Любимівська вулиця	Любимівська вулиця
Любительська вулиця	Любительська вулиця
Любінська вулиця	Любінська вулиця
Люблінська вулиця	Люблінська вулиця
Люблянська вулиця	Люблянська вулиця
Любомирська вулиця	Любомирська вулиця
Люборадська вулиця	Люборадська вулиця
Люботинська вулиця	Люботинська вулиця
Люсинська вулиця	Люсинська вулиця
Люстдорфська дорога	Люстдорфська дорога
Лютеранська вулиця	Лютеранська вулиця
Лютівська вулиця	Лютівська вулиця
Ля-Сейнська вулиця	Ля-Сейнська вулиця
Лядівська вулиця	Лядівська вулиця
Ляшівська вулиця	Ляшівська вулиця
М’ясоєдовська вулиця	Мʼясоєдовська вулиця
М’ятинська вулиця	Мʼятинська вулиця
Мавринська вулиця	Мавринська вулиця
Магаданська вулиця	Магаданська вулиця
Магалянська вулиця	Магалянська вулиця
Магдалинівська вулиця	Магдалинівська вулиця
Магістратська вулиця	Магістратська вулиця
Магнітогорська вулиця	Магнітогорська вулиця
Магурянська вулиця	Магурянська вулиця
Маґістратська вулиця	Маґістратська вулиця
Маджарянська вулиця	Маджарянська вулиця
Мадридська вулиця	Мадридська вулиця
Мазурівська вулиця	Мазурівська вулиця
Майданівська вулиця	Майданівська вулиця
Майданська вулиця	Майданська вулиця
Майкопська вулиця	Майкопська вулиця
Майнівська вулиця	Майнівська вулиця
Майстерська вулиця	Майстерська вулиця
Майська вулиця	Майська вулиця
Макарівська вулиця	Макарівська вулиця
Макаровська вулиця	Макаровська вулиця
Макеєвська вулиця	Макеєвська вулиця
Маківська вулиця	Маківська вулиця
Макіївська вулиця	Макіївська вулиця
Маковійська вулиця	Маковійська вулиця
Маковська вулиця	Маковська вулиця
Максимильянівська вулиця	Максимильянівська вулиця
Максимівська вулиця	Максимівська вулиця
Максиміліанівська вулиця	Максиміліанівська вулиця
Маланівська вулиця	Маланівська вулиця
Малаховська вулиця	Малаховська вулиця
Малехівська вулиця	Малехівська вулиця
Малинівська вулиця	Малинівська вулиця
Малинська вулиця	Малинська вулиця
Малишківська вулиця	Малишківська вулиця
Малівська вулиця	Малівська вулиця
Малко-Тирнівська вулиця	Малко-Тирнівська вулиця
Малоазовська вулиця	Малоазовська вулиця
Малоархангельська вулиця	Малоархангельська вулиця
Малобудищанська вулиця	Малобудищанська вулиця
Малоголосківська вулиця	Малоголосківська вулиця
Малогончарівська вулиця	Малогончарівська вулиця
Малогорошківська вулиця	Малогорошківська вулиця
Малоджанкойська вулиця	Малоджанкойська вулиця
Малодобронська вулиця	Малодобронська вулиця
Маложитинська вулиця	Маложитинська вулиця
Маложитомирська вулиця	Маложитомирська вулиця
Малокиївська вулиця	Малокиївська вулиця
Малокитаївська вулиця	Малокитаївська вулиця
Малокринківська вулиця	Малокринківська вулиця
Малоліщанська вулиця	Малоліщанська вулиця
Маломіська вулиця	Маломіська вулиця
Маломосковська вулиця	Маломосковська вулиця
Малоносівська вулиця	Малоносівська вулиця
Малоолександрівська вулиця	Малоолександрівська вулиця
Малоомелянівська вулиця	Малоомелянівська вулиця
Малопанасівська вулиця	Малопанасівська вулиця
Малоподвірська вулиця	Малоподвірська вулиця
Малопрохожанська вулиця	Малопрохожанська вулиця
Малорівненська вулиця	Малорівненська вулиця
Малоросійська вулиця	Малоросійська вулиця
Малорудчанська вулиця	Малорудчанська вулиця
Малоужанська вулиця	Малоужанська вулиця
Мальківська вулиця	Мальківська вулиця
Мальованська набережна	Мальованська набережна
Мальтійська вулиця	Мальтійська вулиця
Малютянська вулиця	Малютянська вулиця
Мамаївська вулиця	Мамаївська вулиця
Мангубінська вулиця	Мангубінська вулиця
Мандражинська вулиця	Мандражинська вулиця
Мандриківська вулиця	Мандриківська вулиця
Манісманівська вулиця	Манісманівська вулиця
Манченківська вулиця	Манченківська вулиця
Маньківська вулиця	Маньківська вулиця
Мар'ївська вулиця	Марʼївська вулиця
Мар'їнська вулиця	Марʼїнська вулиця
Мар'янівська вулиця	Марʼянівська вулиця
Мар’ївська вулиця	Марʼївська вулиця
Мар’їнська вулиця	Марʼїнська вулиця
Мар’янівська вулиця	Марʼянівська вулиця
Маразлієвська вулиця	Маразлієвська вулиця
Маразліївська вулиця	Маразліївська вулиця
Марамороська вулиця	Марамороська вулиця
Марамуреська вулиця	Марамуреська вулиця
Марганцевська вулиця	Марганцевська вулиця
Маримонська вулиця	Маримонська вулиця
Маричанська вулиця	Маричанська вулиця
Маріїнська вулиця	Маріїнська вулиця
Марійська вулиця	Марійська вулиця
Маріупільська вулиця	Маріупільська вулиця
Маріупольська вулиця	Маріупольська вулиця
Марківська вулиця	Марківська вулиця
Марксистська вулиця	Марксистська вулиця
Марленівська вулиця	Марленівська вулиця
Марсельська вулиця	Марсельська вулиця
Мартенівська вулиця	Мартенівська вулиця
Мартовська вулиця	Мартовська вулиця
Марфинська вулиця	Марфинська вулиця
Мархалівська вулиця	Мархалівська вулиця
Маршальська вулиця	Маршальська вулиця
Масанівська вулиця	Масанівська вулиця
Маслівська вулиця	Маслівська вулиця
Маслозаводська вулиця	Маслозаводська вулиця
Масонська вулиця	Масонська вулиця
Матвіївська вулиця	Матвіївська вулиця
Материнська вулиця	Материнська вулиця
Матросівська вулиця	Матросівська вулиця
Матроська вулиця	Матроська вулиця
Матусівська вулиця	Матусівська вулиця
Махачкалинська вулиця	Махачкалинська вулиця
Махнівська вулиця	Махнівська вулиця
Мачеретівська вулиця	Мачеретівська вулиця
Машиністівська вулиця	Машиністівська вулиця
Машівська вулиця	Машівська вулиця
Машчорметівська вулиця	Машчорметівська вулиця
Маяківська вулиця	Маяківська вулиця
Маячківська вулиця	Маячківська вулиця
Мгарська вулиця	Мгарська вулиця
Меблярська вулиця	Меблярська вулиця
Мегедівська вулиця	Мегедівська вулиця
Медведєвська вулиця	Медведєвська вулиця
Медвежанська вулиця	Медвежанська вулиця
Медвинська вулиця	Медвинська вулиця
Меделівська вулиця	Меделівська вулиця
Меджибіжська вулиця	Меджибіжська вулиця
Медицинська вулиця	Медицинська вулиця
Медівська вулиця	Медівська вулиця
Медпунктівська вулиця	Медпунктівська вулиця
Межибрідська вулиця	Межибрідська вулиця
Меживодівська вулиця	Меживодівська вулиця
Межигірська вулиця	Межигірська вулиця
Мезинівська вулиця	Мезинівська вулиця
Мелітопілська вулиця	Мелітопілська вулиця
Мелітопольська вулиця	Мелітопольська вулиця
Мельниківська вулиця	Мельниківська вулиця
Мемельська вулиця	Мемельська вулиця
Меннонітська вулиця	Меннонітська вулиця
Менонітська вулиця	Менонітська вулиця
Мереф'янська вулиця	Мерефʼянська вулиця
Мереф’янська вулиця	Мерефʼянська вулиця
Мерефянська вулиця	Мерефянська вулиця
Мерчанська вулиця	Мерчанська вулиця
Метробудівська вулиця	Метробудівська вулиця
Метрополітенівська вулиця	Метрополітенівська вулиця
Метростроївська вулиця	Метростроївська вулиця
Мефодіївська вулиця	Мефодіївська вулиця
Механізаторська вулиця	Механізаторська вулиця
Мжанська вулиця	Мжанська вулиця
Мигалівська вулиця	Мигалівська вулиця
Миженська вулиця	Миженська вулиця
Микитинська вулиця	Микитинська вулиця
Микільська вулиця	Микільська вулиця
Микільсько-Борщагівська вулиця	Микільсько-Борщагівська вулиця
Микільсько-Слобідська вулиця	Микільсько-Слобідська вулиця
Микільсько-Хутірська вулиця	Микільсько-Хутірська вулиця
Миколаївська вулиця	Миколаївська вулиця
Миколаївська дорога	Миколаївська дорога
Миколо-Можайська вулиця	Миколо-Можайська вулиця
Микська вулиця	Микська вулиця
Микулинська вулиця	Микулинська вулиця
Милолюбівська вулиця	Милолюбівська вулиця
Милорадівська вулиця	Милорадівська вулиця
Милославська вулиця	Милославська вулиця
Милуська вулиця	Милуська вулиця
Милярська вулиця	Милярська вулиця
Милятинська вулиця	Милятинська вулиця
Минаєвська вулиця	Минаєвська вулиця
Минайська вулиця	Минайська вулиця
Минківська вулиця	Минківська вулиця
Минська вулиця	Минська вулиця
Миргородська вулиця	Миргородська вулиця
Мирівська вулиця	Мирівська вулиця
Мирненська вулиця	Мирненська вулиця
Мирогощанська вулиця	Мирогощанська вулиця
Миролюбівська вулиця	Миролюбівська вулиця
Миронівська вулиця	Миронівська вулиця
Миронянська вулиця	Миронянська вулиця
Миропільська вулиця	Миропільська вулиця
Мирославська вулиця	Мирославська вулиця
Мирська вулиця	Мирська вулиця
Мисайлівська вулиця	Мисайлівська вулиця
Мисливська вулиця	Мисливська вулиця
Митищенська вулиця	Митищенська вулиця
Митищинська вулиця	Митищинська вулиця
Митрополитська вулиця	Митрополитська вулиця
Митрофанівська вулиця	Митрофанівська вулиця
Михайлівська вулиця	Михайлівська вулиця
Михайлівська площа	Михайлівська площа
Михайлофедорівська вулиця	Михайлофедорівська вулиця
Михайлiвська вулиця	Михайлiвська вулиця
Михаська вулиця	Михаська вулиця
Михельська вулиця	Михельська вулиця
Міаська вулиця	Міаська вулиця
Мідногорська вулиця	Мідногорська вулиця
Мідянська вулиця	Мідянська вулиця
Міжгірська вулиця	Міжгірська вулиця
Міжфермівська вулиця	Міжфермівська вулиця
Міланська вулиця	Міланська вулиця
Міліївська вулиця	Міліївська вулиця
Міліцейська вулиця	Міліцейська вулиця
Міллерівська вулиця	Міллерівська вулиця
Міловська вулиця	Міловська вулиця
Мінаївська вулиця	Мінаївська вулиця
Мінераловодська вулиця	Мінераловодська вулиця
Мінзаводська вулиця	Мінзаводська вулиця
Мінська вулиця	Мінська вулиця
Мінська площа	Мінська площа
Мінусинська вулиця	Мінусинська вулиця
Міська алея	Міська алея
Міська вулиця	Міська вулиця
Міськомлинянська вулиця	Міськомлинянська вулиця
Міськрадівська вулиця	Міськрадівська вулиця
Міуська вулиця	Міуська вулиця
Мічуринська вулиця	Мічуринська вулиця
Мічурінська вулиця	Мічурінська вулиця
Міщанська вулиця	Міщанська вулиця
Міщенковська вулиця	Міщенковська вулиця
Млинарська вулиця	Млинарська вулиця
Млинівська вулиця	Млинівська вулиця
Млинківська вулиця	Млинківська вулиця
Млинська вулиця	Млинська вулиця
Мліївська вулиця	Мліївська вулиця
Мовчанівська вулиця	Мовчанівська вулиця
Могилевська вулиця	Могилевська вулиця
Могилівська вулиця	Могилівська вулиця
Могілевська вулиця	Могілевська вулиця
Модавська вулиця	Модавська вулиця
Модрівська вулиця	Модрівська вулиця
Можайська вулиця	Можайська вулиця
Мозирська вулиця	Мозирська вулиця
Мойсеївська вулиця	Мойсеївська вулиця
Моквинська вулиця	Моквинська вулиця
Мокляківська вулиця	Мокляківська вулиця
Мокрянська вулиця	Мокрянська вулиця
Молдавська вулиця	Молдавська вулиця
Молдовська вулиця	Молдовська вулиця
Молоданівська вулиця	Молоданівська вулиця
Молодівська вулиця	Молодівська вулиця
Молодіївська вулиця	Молодіївська вулиця
Молодійська вулиця	Молодійська вулиця
Молодогвардійська вулиця	Молодогвардійська вулиця
Моложанська вулиця	Моложанська вулиця
Молокарська вулиця	Молокарська вулиця
Молочанська вулиця	Молочанська вулиця
Молочарська вулиця	Молочарська вулиця
Молченська вулиця	Молченська вулиця
Монастираська вулиця	Монастираська вулиця
Монастирська вулиця	Монастирська вулиця
Монашинська вулиця	Монашинська вулиця
Монгольська вулиця	Монгольська вулиця
Монкутська вулиця	Монкутська вулиця
Мономахівська вулиця	Мономахівська вулиця
Мопрівська вулиця	Мопрівська вулиця
Мопровська вулиця	Мопровська вулиця
Мордовська вулиця	Мордовська вулиця
Морозівська вулиця	Морозівська вулиця
Морська вулиця	Морська вулиця
Морфлотська вулиця	Морфлотська вулиця
Моршанська вулиця	Моршанська вулиця
Моршинська вулиця	Моршинська вулиця
Морщенська вулиця	Морщенська вулиця
Морянська вулиця	Морянська вулиця
Москалівська вулиця	Москалівська вулиця
Московська вулиця	Московська вулиця
Московська площа	Московська площа
Моспинська вулиця	Моспинська вулиця
Мостиська вулиця	Мостиська вулиця
Мостищанська вулиця	Мостищанська вулиця
Мостовська вулиця	Мостовська вулиця
Мотижинська вулиця	Мотижинська вулиця
Мотовилівська вулиця	Мотовилівська вулиця
Мотовилiвська вулиця	Мотовилiвська вулиця
Мотронівська вулиця	Мотронівська вулиця
Мотронінська вулиця	Мотронінська вулиця
Мохначанська вулиця	Мохначанська вулиця
Мочарська вулиця	Мочарська вулиця
Мочолівська вулиця	Мочолівська вулиця
Мошинська вулиця	Мошинська вулиця
Мошківська вулиця	Мошківська вулиця
Мошногірська вулиця	Мошногірська вулиця
Мстиславська вулиця	Мстиславська вулиця
Мудрівська вулиця	Мудрівська вулиця
Мудрьонівська вулиця	Мудрьонівська вулиця
Мужайська вулиця	Мужайська вулиця
Музичанська вулиця	Музичанська вулиця
Музівська вулиця	Музівська вулиця
Мукачевська вулиця	Мукачевська вулиця
Мукачівська вулиця	Мукачівська вулиця
Мулярська вулиця	Мулярська вулиця
Муравська вулиця	Муравська вулиця
Муралівська вулиця	Муралівська вулиця
Мурманська вулиця	Мурманська вулиця
Муромська вулиця	Муромська вулиця
Мушкетівська вулиця	Мушкетівська вулиця
Мценська вулиця	Мценська вулиця
Мюдовська вулиця	Мюдовська вулиця
Набережно-Дніпровська вулиця	Набережно-Дніпровська вулиця
Набережно-Корчуватська вулиця	Набережно-Корчуватська вулиця
Набережно-Печерська дорога	Набережно-Печерська дорога
Набережно-Рибальська дорога	Набережно-Рибальська дорога
Набережньо-Сеймська вулиця	Набережньо-Сеймська вулиця
Набоківська вулиця	Набоківська вулиця
Навальська вулиця	Навальська вулиця
Наваринська вулиця	Наваринська вулиця
Наварійська вулиця	Наварійська вулиця
Нагартавська вулиця	Нагартавська вулиця
Нагорянська вулиця	Нагорянська вулиця
Надбалківська вулиця	Надбалківська вулиця
Надбужанська вулиця	Надбужанська вулиця
Надвірнянська вулиця	Надвірнянська вулиця
Надворсклянська вулиця	Надворсклянська вулиця
Наддніпрянська вулиця	Наддніпрянська вулиця
Наддністрянська вулиця	Наддністрянська вулиця
Надеждівська вулиця	Надеждівська вулиця
Надєждинська вулиця	Надєждинська вулиця
Надзаводська вулиця	Надзаводська вулиця
Надзбручанська вулиця	Надзбручанська вулиця
Надіждівська вулиця	Надіждівська вулиця
Надіївська вулиця	Надіївська вулиця
Надкодимська вулиця	Надкодимська вулиця
Надлиманська вулиця	Надлиманська вулиця
Надпрутська вулиця	Надпрутська вулиця
Надрічанська вулиця	Надрічанська вулиця
Надсеретська вулиця	Надсеретська вулиця
Надслучанська вулиця	Надслучанська вулиця
Надстирянська вулиця	Надстирянська вулиця
Надточаївська вулиця	Надточаївська вулиця
Надточиївська вулиця	Надточиївська вулиця
Надхівська вулиця	Надхівська вулиця
Назарівська вулиця	Назарівська вулиця
Наїздівська вулиця	Наїздівська вулиця
Наменська вулиця	Наменська вулиця
Нанківська вулиця	Нанківська вулиця
Нараївська вулиця	Нараївська вулиця
Нарбутівська вулиця	Нарбутівська вулиця
Нарбутівська вулицяь	Нарбутівська вулицяь
Нарвська вулиця	Нарвська вулиця
Нариманівська вулиця	Нариманівська вулиця
Наримська вулиця	Наримська вулиця
Наринська вулиця	Наринська вулиця
Народичівська вулиця	Народичівська вулиця
Народовольська вулиця	Народовольська вулиця
Нарофоминська вулиця	Нарофоминська вулиця
Нарофомінська вулиця	Нарофомінська вулиця
Нарпитівська вулиця	Нарпитівська вулиця
Наталівська вулиця	Наталівська вулиця
Натальївська дорога	Натальївська дорога
Натанівська вулиця	Натанівська вулиця
Наумівська вулиця	Наумівська вулиця
Нахімовська вулиця	Нахімовська вулиця
Нахічеванська вулиця	Нахічеванська вулиця
Небилівська вулиця	Небилівська вулиця
Небоженківська вулиця	Небоженківська вулиця
Невельська вулиця	Невельська вулиця
Невинномиська вулиця	Невинномиська вулиця
Невирівська вулиця	Невирівська вулиця
Невська вулиця	Невська вулиця
Недайводська вулиця	Недайводська вулиця
Недогарська вулиця	Недогарська вулиця
Недрянська вулиця	Недрянська вулиця
Нежинська вулиця	Нежинська вулиця
Некрасівська вулиця	Некрасівська вулиця
Неманська вулиця	Неманська вулиця
Немирівська вулиця	Немирівська вулиця
Немишлянська вулиця	Немишлянська вулиця
Немишлянська набережна	Немишлянська набережна
Неопалимівська вулиця	Неопалимівська вулиця
Непедівська вулиця	Непедівська вулиця
Нересенська вулиця	Нересенська вулиця
Нерубайська вулиця	Нерубайська вулиця
Нерченська вулиця	Нерченська вулиця
Нескучанська вулиця	Нескучанська вулиця
Нетеченська вулиця	Нетеченська вулиця
Нетеченська набережна	Нетеченська набережна
Нетечинська вулиця	Нетечинська вулиця
Нетіченська вулиця	Нетіченська вулиця
Нетішинська вулиця	Нетішинська вулиця
Нечаївська вулиця	Нечаївська вулиця
Нечвалівська вулиця	Нечвалівська вулиця
Нечволодівська вулиця	Нечволодівська вулиця
Нивська вулиця	Нивська вулиця
Нижегородська вулиця	Нижегородська вулиця
Нижнє-Устрікська вулиця	Нижнє-Устрікська вулиця
Нижньо-Хлипнівська вулиця	Нижньо-Хлипнівська вулиця
Нижньоамурська вулиця	Нижньоамурська вулиця
Нижньоангарська вулиця	Нижньоангарська вулиця
Нижньовартівська вулиця	Нижньовартівська вулиця
Нижньовоскресенська вулиця	Нижньовоскресенська вулиця
Нижньогірська вулиця	Нижньогірська вулиця
Нижньогородська вулиця	Нижньогородська вулиця
Нижньодніпровська вулиця	Нижньодніпровська вулиця
Нижньодністровська вулиця	Нижньодністровська вулиця
Нижньокринська вулиця	Нижньокринська вулиця
Нижньокурганська вулиця	Нижньокурганська вулиця
Нижньолепехівська вулиця	Нижньолепехівська вулиця
Нижньомаріупольська вулиця	Нижньомаріупольська вулиця
Нижньомлинська вулиця	Нижньомлинська вулиця
Нижньоновгородська вулиця	Нижньоновгородська вулиця
Нижньосироватська вулиця	Нижньосироватська вулиця
Нижньотагільська вулиця	Нижньотагільська вулиця
Нижньоудинська вулиця	Нижньоудинська вулиця
Нижньофабриканська вулиця	Нижньофабриканська вулиця
Нижньохолодногірська вулиця	Нижньохолодногірська вулиця
Нижньоюрківська вулиця	Нижньоюрківська вулиця
Нижньоярська вулиця	Нижньоярська вулиця
Нижнянська вулиця	Нижнянська вулиця
Низівська вулиця	Низівська вулиця
Низовська вулиця	Низовська вулиця
Никодимівська вулиця	Никодимівська вулиця
Никонівська вулиця	Никонівська вулиця
Нібулонівська вулиця	Нібулонівська вулиця
Нібурівська вулиця	Нібурівська вулиця
Ніжанська вулиця	Ніжанська вулиця
Ніжатинська вулиця	Ніжатинська вулиця
Ніженська вулиця	Ніженська вулиця
Ніжинозерська вулиця	Ніжинозерська вулиця
Ніжинська вулиця	Ніжинська вулиця
Ніжньотагільська вулиця	Ніжньотагільська вулиця
Нікітовська вулиця	Нікітовська вулиця
Ніколокозельська вулиця	Ніколокозельська вулиця
Нікольська вулиця	Нікольська вулиця
Нікополь-Маріупольська вулиця	Нікополь-Маріупольська вулиця
Нікопольська вулиця	Нікопольська вулиця
Німанська вулиця	Німанська вулиця
Ніреська вулиця	Ніреська вулиця
Нобелівська вулиця	Нобелівська вулиця
Новаківська вулиця	Новаківська вулиця
Новаторська вулиця	Новаторська вулиця
Новгород-Сіверська вулиця	Новгород-Сіверська вулиця
Новгородська вулиця	Новгородська вулиця
Ново-Віринська вулиця	Ново-Віринська вулиця
Ново-Заводська вулиця	Ново-Заводська вулиця
Ново-Ірпінська вулиця	Ново-Ірпінська вулиця
Ново-Київська вулиця	Ново-Київська вулиця
Ново-Оскольська вулиця	Ново-Оскольська вулиця
Ново-Пролетарська вулиця	Ново-Пролетарська вулиця
Ново-Румянцевська вулиця	Ново-Румянцевська вулиця
Ново-Червоноармійська вулиця	Ново-Червоноармійська вулиця
Ново-Яблунська вулиця	Ново-Яблунська вулиця
Новоазовська вулиця	Новоазовська вулиця
Новобаварська вулиця	Новобаварська вулиця
Новобакинська вулиця	Новобакинська вулиця
Новобарівська вулиця	Новобарівська вулиця
Новобіляєвська вулиця	Новобіляєвська вулиця
Новобілярська вулиця	Новобілярська вулиця
Новобогданівська вулиця	Новобогданівська вулиця
Новоборівська вулиця	Новоборівська вулиця
Новобродівська вулиця	Новобродівська вулиця
Нововільська вулиця	Нововільська вулиця
Нововолинська вулиця	Нововолинська вулиця
Нововолодимирська вулиця	Нововолодимирська вулиця
Новогеоргіївська вулиця	Новогеоргіївська вулиця
Новогоголівська вулиця	Новогоголівська вулиця
Новогорянська вулиця	Новогорянська вулиця
Новоград-Волинська вулиця	Новоград-Волинська вулиця
Новоградська вулиця	Новоградська вулиця
Новогродівська вулиця	Новогродівська вулиця
Новогромадська вулиця	Новогромадська вулиця
Новогрузчанська вулиця	Новогрузчанська вулиця
Новогрушівська вулиця	Новогрушівська вулиця
Новодаргомижська вулиця	Новодаргомижська вулиця
Новодвірська вулиця	Новодвірська вулиця
Новодеповськая вулиця	Новодеповськая вулиця
Новодзержинська вулиця	Новодзержинська вулиця
Новодиканська вулиця	Новодиканська вулиця
Новодністровська вулиця	Новодністровська вулиця
Новодобропільська вулиця	Новодобропільська вулиця
Новодоманинська вулиця	Новодоманинська вулиця
Новодружинська вулиця	Новодружинська вулиця
Новожанівська вулиця	Новожанівська вулиця
Новожучківська вулиця	Новожучківська вулиця
Новозабарська вулиця	Новозабарська вулиця
Новозаводська вулиця	Новозаводська вулиця
Новозіньківська вулиця	Новозіньківська вулиця
Новознесенська вулиця	Новознесенська вулиця
Новоіванівська вулиця	Новоіванівська вулиця
Новоінгульська вулиця	Новоінгульська вулиця
Новокаховська вулиця	Новокаховська вулиця
Новокерченська вулиця	Новокерченська вулиця
Новокиївська вулиця	Новокиївська вулиця
Новокисилівська вулиця	Новокисилівська вулиця
Новокілійська вулиця	Новокілійська вулиця
Новоковальська вулиця	Новоковальська вулиця
Новоковельська вулиця	Новоковельська вулиця
Новокомсомольська вулиця	Новокомсомольська вулиця
Новокорчуватська вулиця	Новокорчуватська вулиця
Новокостянтинівська вулиця	Новокостянтинівська вулиця
Новокотівська вулиця	Новокотівська вулиця
Новокримська вулиця	Новокримська вулиця
Новолагерська вулиця	Новолагерська вулиця
Новолепехівська вулиця	Новолепехівська вулиця
Новолуганська вулиця	Новолуганська вулиця
Новомайданська вулиця	Новомайданська вулиця
Новомакарівська вулиця	Новомакарівська вулиця
Новомар'янівська вулиця	Новомарʼянівська вулиця
Новомарківська вулиця	Новомарківська вулиця
Новомаячківська вулиця	Новомаячківська вулиця
Новомерефянська вулиця	Новомерефянська вулиця
Новомиколаївська вулиця	Новомиколаївська вулиця
Новомирська вулиця	Новомирська вулиця
Новомістенська вулиця	Новомістенська вулиця
Новоміська вулиця	Новоміська вулиця
Новомосковська вулиця	Новомосковська вулиця
Новомосковська дорога	Новомосковська дорога
Новонерубайська вулиця	Новонерубайська вулиця
Новоодеська вулиця	Новоодеська вулиця
Новоолександрівська вулиця	Новоолександрівська вулиця
Новоолексіївська вулиця	Новоолексіївська вулиця
Новоолешківська вулиця	Новоолешківська вулиця
Новоорловська вулиця	Новоорловська вулиця
Новооскольська вулиця	Новооскольська вулиця
Новопавлівська вулиця	Новопавлівська вулиця
Новопартизанська вулиця	Новопартизанська вулиця
Новопетрівська вулиця	Новопетрівська вулиця
Новопирогівська вулиця	Новопирогівська вулиця
Новопироговська вулиця	Новопироговська вулиця
Новопідгорівська вулиця	Новопідгорівська вулиця
Новопільська вулиця	Новопільська вулиця
Новоподольська вулиця	Новоподольська вулиця
Новопокровська вулиця	Новопокровська вулиця
Новополонська вулиця	Новополонська вулиця
Новополтавська вулиця	Новополтавська вулиця
Новопомерчанська вулиця	Новопомерчанська вулиця
Новопоселенська вулиця	Новопоселенська вулиця
Новопречистенська вулиця	Новопречистенська вулиця
Новоприміська вулиця	Новоприміська вулиця
Новопролетарська вулиця	Новопролетарська вулиця
Новопсковська вулиця	Новопсковська вулиця
Новорозсошанська вулиця	Новорозсошанська вулиця
Новоросійська вулиця	Новоросійська вулиця
Новоросошанська вулиця	Новоросошанська вулиця
Новосамарська вулиця	Новосамарська вулиця
Новосвітська вулиця	Новосвітська вулиця
Новосевастопольська вулиця	Новосевастопольська вулиця
Новоселівська вулиця	Новоселівська вулиця
Новоселківська вулиця	Новоселківська вулиця
Новосельська вулиця	Новосельська вулиця
Новосеменівська вулиця	Новосеменівська вулиця
Новосибирська вулиця	Новосибирська вулиця
Новосибірська вулиця	Новосибірська вулиця
Новосільська вулиця	Новосільська вулиця
Новослав’янська вулиця	Новославʼянська вулиця
Новослобідська вулиця	Новослобідська вулиця
Новослободська вулиця	Новослободська вулиця
Новослов’янська вулиця	Новословʼянська вулиця
Новосодівська вулиця	Новосодівська вулиця
Новософіївська вулиця	Новософіївська вулиця
Новоспасівська вулиця	Новоспасівська вулиця
Новостаробільська вулиця	Новостаробільська вулиця
Новостроєнівська вулиця	Новостроєнівська вулиця
Новостроївська вулиця	Новостроївська вулиця
Новострумівська вулиця	Новострумівська вулиця
Новосiльська вулиця	Новосiльська вулиця
Новоукраїнська вулиця	Новоукраїнська вулиця
Новоуманська вулиця	Новоуманська вулиця
Новофермівська вулиця	Новофермівська вулиця
Новофрунзенська вулиця	Новофрунзенська вулиця
Новохарківська вулиця	Новохарківська вулиця
Новохатська вулиця	Новохатська вулиця
Новочеркаська вулиця	Новочеркаська вулиця
Новошарнівська вулиця	Новошарнівська вулиця
Новошахтарська вулиця	Новошахтарська вулиця
Новошахтинська вулиця	Новошахтинська вулиця
Новошевченківська вулиця	Новошевченківська вулиця
Новошишковська вулиця	Новошишковська вулиця
Новоясинуватська вулиця	Новоясинуватська вулиця
Ногайська вулиця	Ногайська вулиця
Ногинська вулиця	Ногинська вулиця
Норильська вулиця	Норильська вулиця
Норільська вулиця	Норільська вулиця
Носовградська вулиця	Носовградська вулиця
Ноябрська вулиця	Ноябрська вулиця
Нямеська вулиця	Нямеська вулиця
Обертинська вулиця	Обертинська вулиця
Обжарівська вулиця	Обжарівська вулиця
Обирська вулиця	Обирська вулиця
Обознівська вулиця	Обознівська вулиця
Оболонівська вулиця	Оболонівська вулиця
Оболонська вулиця	Оболонська вулиця
Оболонська набережна	Оболонська набережна
Оболонська площа	Оболонська площа
Оболоньська вулиця	Оболоньська вулиця
Обольська вулиця	Обольська вулиця
Оборонська вулиця	Оборонська вулиця
Обоянська вулиця	Обоянська вулиця
Обухівська вулиця	Обухівська вулиця
Оваднівська вулиця	Оваднівська вулиця
Овдіївська вулиця	Овдіївська вулиця
Овідіопольська вулиця	Овідіопольська вулиця
Овідіопольська дорога	Овідіопольська дорога
Овідіопольська дуга	Овідіопольська дуга
Овітянська вулиця	Овітянська вулиця
Овлочинська вулиця	Овлочинська вулиця
Огарівська вулиця	Огарівська вулиця
Огнівська вулиця	Огнівська вулиця
Одерадська вулиця	Одерадська вулиця
Одеська вулиця	Одеська вулиця
Одеська площа	Одеська площа
Одинківська вулиця	Одинківська вулиця
Однодворчеська вулиця	Однодворчеська вулиця
Одноребрівська вулиця	Одноребрівська вулиця
Озерцівська вулиця	Озерцівська вулиця
Озерянівська вулиця	Озерянівська вулиця
Озеряновська вулиця	Озеряновська вулиця
Озерянська вулиця	Озерянська вулиця
Озетівська вулиця	Озетівська вулиця
Океанівська вулиця	Океанівська вулиця
Океанська вулиця	Океанська вулиця
Окіпська вулиця	Окіпська вулиця
Околонська вулиця	Околонська вулиця
Окська вулиця	Окська вулиця
Октябрська вулиця	Октябрська вулиця
Октябрьська вулиця	Октябрьська вулиця
Октябрьськая вулиця	Октябрьськая вулиця
Окунинівська вулиця	Окунинівська вулиця
Олевська вулиця	Олевська вулиця
Олегівська вулиця	Олегівська вулиця
Олександрівська вулиця	Олександрівська вулиця
Олександріївська вулиця	Олександріївська вулиця
Олександрійська вулиця	Олександрійська вулиця
Олексинська вулиця	Олексинська вулиця
Олексіївська вулиця	Олексіївська вулиця
Олексіївська площа	Олексіївська площа
Оленівська вулиця	Оленівська вулиця
Оленінська вулиця	Оленінська вулиця
Олешківська вулиця	Олешківська вулиця
Олійняківська вулиця	Олійняківська вулиця
Олімпіадівська вулиця	Олімпіадівська вулиця
Олімпійська вулиця	Олімпійська вулиця
Ольвійська вулиця	Ольвійська вулиця
Ольвіопольська вулиця	Ольвіопольська вулиця
Ольгинська вулиця	Ольгинська вулиця
Ольгіївська вулиця	Ольгіївська вулиця
Ольгінська вулиця	Ольгінська вулиця
Олькуська вулиця	Олькуська вулиця
Ольхівська вулиця	Ольхівська вулиця
Ольховська вулиця	Ольховська вулиця
Ольшанська вулиця	Ольшанська вулиця
Омелютинська вулиця	Омелютинська вулиця
Омська вулиця	Омська вулиця
Оноківська вулиця	Оноківська вулиця
Онуфріївська вулиця	Онуфріївська вулиця
Опільська вулиця	Опільська вулиця
Опришківська вулиця	Опришківська вулиця
Оранська вулиця	Оранська вулиця
Оратівська вулиця	Оратівська вулиця
Орачівська вулиця	Орачівська вулиця
Організаторська вулиця	Організаторська вулиця
Орельська вулиця	Орельська вулиця
Орєхово-Зуєвська вулиця	Орєхово-Зуєвська вулиця
Орільська вулиця	Орільська вулиця
Оріхівська вулиця	Оріхівська вулиця
Оріхуватська вулиця	Оріхуватська вулиця
Орликівська вулиця	Орликівська вулиця
Орлівська вулиця	Орлівська вулиця
Орловська вулиця	Орловська вулиця
Орлянська вулиця	Орлянська вулиця
Орсівська вулиця	Орсівська вулиця
Орсовська вулиця	Орсовська вулиця
Орська вулиця	Орська вулиця
Оршанська вулиця	Оршанська вулиця
Оршинська вулиця	Оршинська вулиця
Оршівська вулиця	Оршівська вулиця
Осаківська вулиця	Осаківська вулиця
Освітянська вулиця	Освітянська вулиця
Осетинська вулиця	Осетинська вулиця
Осинівська вулиця	Осинівська вулиця
Оскільська вулиця	Оскільська вулиця
Оскольська вулиця	Оскольська вулиця
Осмолодська вулиця	Осмолодська вулиця
Основ'янська вулиця	Основʼянська вулиця
Основ’янська вулиця	Основʼянська вулиця
Основ’янська набережна	Основʼянська набережна
Основська вулиця	Основська вулиця
Осовська вулиця	Осовська вулиця
Осокорська вулиця	Осокорська вулиця
Остапенківська вулиця	Остапенківська вулиця
Остапівська вулиця	Остапівська вулиця
Осташівська вулиця	Осташівська вулиця
Остерська вулиця	Остерська вулиця
Остреченська вулиця	Остреченська вулиця
Остриківська вулиця	Остриківська вулиця
Острівська вулиця	Острівська вулиця
Остроградська вулиця	Остроградська вулиця
Остромирська вулиця	Остромирська вулиця
Острянська вулиця	Острянська вулиця
Отаманська вулиця	Отаманська вулиця
Отдихнянська вулиця	Отдихнянська вулиця
Офіцерська вулиця	Офіцерська вулиця
Офіцерська площа	Офіцерська площа
Охіньківська вулиця	Охіньківська вулиця
Охотська вулиця	Охотська вулиця
Охтинська вулиця	Охтинська вулиця
Охтирська вулиця	Охтирська вулиця
Очаківська вулиця	Очаківська вулиця
Очаківська площа	Очаківська площа
Очаковська вулиця	Очаковська вулиця
Очеретянська вулиця	Очеретянська вулиця
П'ятихатська вулиця	Пʼятихатська вулиця
П’ятигірська вулиця	Пʼятигірська вулиця
П’ятигорська вулиця	Пʼятигорська вулиця
П’ятихатська вулиця	Пʼятихатська вулиця
П’ятничанська вулиця	Пʼятничанська вулиця
П’ятовська вулиця	Пʼятовська вулиця
Павленківська вулиця	Павленківська вулиця
Павленківська площа	Павленківська площа
Павлівська вулиця	Павлівська вулиця
Павлівська гребля	Павлівська гребля
Павловська вулиця	Павловська вулиця
Павлоградська вулиця	Павлоградська вулиця
Павлодарська вулиця	Павлодарська вулиця
Павлокічкаська вулиця	Павлокічкаська вулиця
Павлокомська вулиця	Павлокомська вулиця
Паладська вулиця	Паладська вулиця
Палехська вулиця	Палехська вулиця
Паливодська вулиця	Паливодська вулиця
Паліївська вулиця	Паліївська вулиця
Памірська вулиця	Памірська вулиця
Панасівська вулиця	Панасівська вулиця
Паневежиська вулиця	Паневежиська вулиця
Паненська вулиця	Паненська вулиця
Панищівська вулиця	Панищівська вулиця
Панкеєвська вулиця	Панкеєвська вулиця
Панська вулиця	Панська вулиця
Пантаївська вулиця	Пантаївська вулиця
Пантелеймонівська вулиця	Пантелеймонівська вулиця
Панфіловська вулиця	Панфіловська вулиця
Паньківська вулиця	Паньківська вулиця
Папірянська вулиця	Папірянська вулиця
Параскеївська вулиця	Параскеївська вулиця
Парижська вулиця	Парижська вулиця
Паришівська вулиця	Паришівська вулиця
Паріївська вулиця	Паріївська вулиця
Парківська вулиця	Парківська вулиця
Парковська вулиця	Парковська вулиця
Парненська вулиця	Парненська вулиця
Парнівська вулиця	Парнівська вулиця
Парнянська вулиця	Парнянська вулиця
Партизанська (Сонячна)	Партизанська (Сонячна)
Партизанська вулиця	Партизанська вулиця
Пасажирська вулиця	Пасажирська вулиця
Пасічанська вулиця	Пасічанська вулиця
Пасківська вулиця	Пасківська вулиця
Пастерівська вулиця	Пастерівська вулиця
Патлаївська вулиця	Патлаївська вулиця
Паушівська вулиця	Паушівська вулиця
Пашинська вулиця	Пашинська вулиця
Пашківська вулиця	Пашківська вулиця
Пашутінська вулиця	Пашутінська вулиця
Пащенківська вулиця	Пащенківська вулиця
Певрянська вулиця	Певрянська вулиця
Пекарнянська вулиця	Пекарнянська вулиця
Пекарська вулиця	Пекарська вулиця
Пекурівська вулиця	Пекурівська вулиця
Пензенська вулиця	Пензенська вулиця
Пеньківська вулиця	Пеньківська вулиця
Первомайська вулиця	Первомайська вулиця
Первоуральська вулиця	Первоуральська вулиця
Перевідська вулиця	Перевідська вулиця
Переволошанська вулиця	Переволошанська вулиця
Перегонівська вулиця	Перегонівська вулиця
Передзаводська вулиця	Передзаводська вулиця
Передміська вулиця	Передміська вулиця
Передріївська вулиця	Передріївська вулиця
Перекіпська вулиця	Перекіпська вулиця
Перекопська вулиця	Перекопська вулиця
Перелістська вулиця	Перелістська вулиця
Переліщанська вулиця	Переліщанська вулиця
Перемивська вулиця	Перемивська вулиця
Перемильська вулиця	Перемильська вулиця
Перемиська вулиця	Перемиська вулиця
Перемишльська вулиця	Перемишльська вулиця
Перемишлянська вулиця	Перемишлянська вулиця
Переможненська вулиця	Переможненська вулиця
Перенівська вулиця	Перенівська вулиця
Пересадівська вулиця	Пересадівська вулиця
Переселенська вулиця	Переселенська вулиця
Пересипська вулиця	Пересипська вулиця
Перещепінська вулиця	Перещепінська вулиця
Переяславська вулиця	Переяславська вулиця
Переяслівська вулиця	Переяслівська вулиця
Переясловська вулиця	Переясловська вулиця
Пермська вулиця	Пермська вулиця
Пертрівська вулиця	Пертрівська вулиця
Першогвардійська вулиця	Першогвардійська вулиця
Першомайська вулиця	Першомайська вулиця
Першотравенська вулиця	Першотравенська вулиця
Першоуральська вулиця	Першоуральська вулиця
Петергофська вулиця	Петергофська вулиця
Петренківська вулиця	Петренківська вулиця
Петриківська вулиця	Петриківська вулиця
Петрівська алея	Петрівська алея
Петрівська вулиця	Петрівська вулиця
Петро-Павлівська вулиця	Петро-Павлівська вулиця
Петровська вулиця	Петровська вулиця
Петроградська вулиця	Петроградська вулиця
Петрозаводська вулиця	Петрозаводська вулиця
Петропавлівська вулиця	Петропавлівська вулиця
Петропавлівська площа	Петропавлівська площа
Петропавловська вулиця	Петропавловська вулиця
Петрушківська вулиця	Петрушківська вулиця
Печерська вулиця	Печерська вулиця
Печерська вулицяк	Печерська вулицяк
Печерська площа	Печерська площа
Печорська вулиця	Печорська вулиця
Пивогірська вулиця	Пивогірська вулиця
Пилипівська вулиця	Пилипівська вулиця
Пилипінська вулиця	Пилипінська вулиця
Пильникарська вулиця	Пильникарська вулиця
Пильовська вулиця	Пильовська вулиця
Пинська вулиця	Пинська вулиця
Пиріжківська вулиця	Пиріжківська вулиця
Пирійська вулиця	Пирійська вулиця
Пирнівська вулиця	Пирнівська вулиця
Пирогівська вулиця	Пирогівська вулиця
Пироговська вулиця	Пироговська вулиця
Пирятинська вулиця	Пирятинська вулиця
Писарівська вулиця	Писарівська вулиця
Писарська вулиця	Писарська вулиця
Південмашівська вулиця	Південмашівська вулиця
Південнослов’янська вулиця	Південнословʼянська вулиця
Південноукраїнська вулиця	Південноукраїнська вулиця
Південношахтарська вулиця	Південношахтарська вулиця
Південо-Українська вулиця	Південо-Українська вулиця
Півненківська вулиця	Півненківська вулиця
Північно-Буковинська вулиця	Північно-Буковинська вулиця
Північнодвінська вулиця	Північнодвінська вулиця
Північноморська вулиця	Північноморська вулиця
Пігівська вулиця	Пігівська вулиця
Підварська вулиця	Підварська вулиця
Підвільшанська вулиця	Підвільшанська вулиця
Підгаївська провулок	Підгаївська провулок
Підгайська вулиця	Підгайська вулиця
Підгірнівська вулиця	Підгірнівська вулиця
Підгірська вулиця	Підгірська вулиця
Підгоранська вулиця	Підгоранська вулиця
Підгороднянська вулиця	Підгороднянська вулиця
Підгородська вулиця	Підгородська вулиця
Підгорянська вулиця	Підгорянська вулиця
Підградська вулиця	Підградська вулиця
Піддолинівська вулиця	Піддолинівська вулиця
Підковальська вулиця	Підковальська вулиця
Підкрайська вулиця	Підкрайська вулиця
Підлиманська вулиця	Підлиманська вулиця
Підлипівська вулиця	Підлипівська вулиця
Підліщанська вулиця	Підліщанська вулиця
Підлужинська вулиця	Підлужинська вулиця
Підміська вулиця	Підміська вулиця
Підмлинська вулиця	Підмлинська вулиця
Підмонастирська вулиця	Підмонастирська вулиця
Підопригорівська вулиця	Підопригорівська вулиця
Підпечарівська вулиця	Підпечарівська вулиця
Підрадьківська вулиця	Підрадьківська вулиця
Підтрощівська вулиця	Підтрощівська вулиця
Підчерленська вулиця	Підчерленська вулиця
Пікельська вулиця	Пікельська вулиця
Пілотська вулиця	Пілотська вулиця
Пінська вулиця	Пінська вулиця
Піонерська вулиця	Піонерська вулиця
Піонерська площа	Піонерська площа
Піонерськая вулиця	Піонерськая вулиця
Пісківська вулиця	Пісківська вулиця
Пісочанська вулиця	Пісочанська вулиця
Пісочинська вулиця	Пісочинська вулиця
Пітерська вулиця	Пітерська вулиця
Піхотинська вулиця	Піхотинська вулиця
Пічугінська вулиця	Пічугінська вулиця
Пішонівська вулиця	Пішонівська вулиця
Піщанівська вулиця	Піщанівська вулиця
Піщанобрідська вулиця	Піщанобрідська вулиця
Піщанська вулиця	Піщанська вулиця
Планерська вулиця	Планерська вулиця
Пластівська вулиця	Пластівська вулиця
Пластунівська вулиця	Пластунівська вулиця
Пластунська вулиця	Пластунська вулиця
Платонівська вулиця	Платонівська вулиця
Плебанівська вулиця	Плебанівська вулиця
Плевненська вулиця	Плевненська вулиця
Плеханівська вулиця	Плеханівська вулиця
Плєщєєвська вулиця	Плєщєєвська вулиця
Плитавська вулиця	Плитавська вулиця
Пліщинська вулиця	Пліщинська вулиця
Пловдивська вулиця	Пловдивська вулиця
Плосківська вулиця	Плосківська вулиця
Площа Слобожанська	Площа Слобожанська
Плютовська вулиця	Плютовська вулиця
Побєдовська вулиця	Побєдовська вулиця
Побужанська вулиця	Побужанська вулиця
Побужська вулиця	Побужська вулиця
Повітрофлотська вулиця	Повітрофлотська вулиця
Повітрянофлотська вулиця	Повітрянофлотська вулиця
Повстанська вулиця	Повстанська вулиця
Повчанська вулиця	Повчанська вулиця
Погоринська вулиця	Погоринська вулиця
Погорільська вулиця	Погорільська вулиця
Погребська вулиця	Погребська вулиця
Подборівська вулиця	Подборівська вулиця
Подільська вулиця	Подільська вулиця
Подолівська вулиця	Подолівська вулиця
Подольська вулиця	Подольська вулиця
Подолянська вулиця	Подолянська вулиця
Подомерська вулиця	Подомерська вулиця
Подорожненська вулиця	Подорожненська вулиця
Подусівська вулиця	Подусівська вулиця
Познанська вулиця	Познанська вулиця
Позняківська вулиця	Позняківська вулиця
Покотилівська вулиця	Покотилівська вулиця
Покрівська вулиця	Покрівська вулиця
Покроввська вулиця	Покроввська вулиця
Покровська (Шевченка)	Покровська (Шевченка)
Покровська вулиця	Покровська вулиця
Покровська Вулиця	Покровська Вулиця
Покровська площа	Покровська площа
Покутська вулиця	Покутська вулиця
Покутянська вулиця	Покутянська вулиця
Полеводчеська вулиця	Полеводчеська вулиця
Полеська вулиця	Полеська вулиця
Полівська вулиця	Полівська вулиця
Полігонівська вулиця	Полігонівська вулиця
Полігонська вулиця	Полігонська вулиця
Полідарівська вулиця	Полідарівська вулиця
Поліська вулиця	Поліська вулиця
Політвіддільська вулиця	Політвіддільська вулиця
Поліцейська вулиця	Поліцейська вулиця
Полов’янська вулиця	Половʼянська вулиця
Половиківська вулиця	Половиківська вулиця
Поломська вулиця	Поломська вулиця
Полонинська вулиця	Полонинська вулиця
Полонківська вулиця	Полонківська вулиця
Полонська вулиця	Полонська вулиця
Полски-Тримбешська вулиця	Полски-Тримбешська вулиця
Полтавська вулиця	Полтавська вулиця
Полуянівська вулиця	Полуянівська вулиця
Польська вулиця	Польська вулиця
Полянська вулиця	Полянська вулиця
Полiська вулиця	Полiська вулиця
Поморська вулиця	Поморська вулиця
Поморянська вулиця	Поморянська вулиця
Пономаренківська вулиця	Пономаренківська вулиця
Пономарівська вулиця	Пономарівська вулиця
Понорська вулиця	Понорська вулиця
Понятівська вулиця	Понятівська вулиця
Понятовська вулиця	Понятовська вулиця
Попаснянська вулиця	Попаснянська вулиця
Попільнянська вулиця	Попільнянська вулиця
Порічанська вулиця	Порічанська вулиця
Поронівська вулиця	Поронівська вулиця
Порт-Артурська вулиця	Порт-Артурська вулиця
Портовська вулиця	Портовська вулиця
Португальська вулиця	Португальська вулиця
Поршянська вулиця	Поршянська вулиця
Посівкомівська вулиця	Посівкомівська вулиця
Посольська вулиця	Посольська вулиця
Пост-Волинська вулиця	Пост-Волинська вулиця
Пост-Острівська вулиця	Пост-Острівська вулиця
Постройкомівська вулиця	Постройкомівська вулиця
Посульська вулиця	Посульська вулиця
Посуньківська вулиця	Посуньківська вулиця
Поташнянська вулиця	Поташнянська вулиця
Потіївська вулиця	Потіївська вулиця
Потійська вулиця	Потійська вулиця
Потоківська вулиця	Потоківська вулиця
Поточанська вулиця	Поточанська вулиця
Потьомкінська вулиця	Потьомкінська вулиця
Похівська вулиця	Похівська вулиця
Почавївська вулиця	Почавївська вулиця
Почаївська вулиця	Почаївська вулиця
Почайнинська вулиця	Почайнинська вулиця
Правдинська вулиця	Правдинська вулиця
Праслов’янська вулиця	Прасловʼянська вулиця
Предеснянська вулиця	Предеснянська вулиця
Предславинська вулиця	Предславинська вулиця
Прейльська вулиця	Прейльська вулиця
Преображенівська вулиця	Преображенівська вулиця
Преображенська вулиця	Преображенська вулиця
Пресовська вулиця	Пресовська вулиця
Пречистенська вулиця	Пречистенська вулиця
Приазовська вулиця	Приазовська вулиця
Приамурська вулиця	Приамурська вулиця
Прибалтійська вулиця	Прибалтійська вулиця
Прибужська вулиця	Прибужська вулиця
Привільнянська вулиця	Привільнянська вулиця
Привольнянська вулиця	Привольнянська вулиця
Приворсклянська вулиця	Приворсклянська вулиця
Пригірська вулиця	Пригірська вулиця
Пригородська вулиця	Пригородська вулиця
Придеснянська вулиця	Придеснянська вулиця
Придніпровська вулиця	Придніпровська вулиця
Придністровська вулиця	Придністровська вулиця
Придністровська вулицяь	Придністровська вулицяь
Придністрянська вулиця	Придністрянська вулиця
Придунайська вулиця	Придунайська вулиця
Призаводська вулиця	Призаводська вулиця
Приінгульська вулиця	Приінгульська вулиця
Прикам’янська вулиця	Прикамʼянська вулиця
Прикарпатська вулиця	Прикарпатська вулиця
Прилиманська вулиця	Прилиманська вулиця
Примерівська вулиця	Примерівська вулиця
Приміська вулиця	Приміська вулиця
Приморська вулиця	Приморська вулиця
Приморська площа	Приморська площа
Приорільська вулиця	Приорільська вулиця
Прип’ятська вулиця	Припʼятська вулиця
Припрутська вулиця	Припрутська вулиця
Припсільська вулиця	Припсільська вулиця
Присамарська вулиця	Присамарська вулиця
Присеймівська вулиця	Присеймівська вулиця
Прислучанська вулиця	Прислучанська вулиця
Притисько-Микільська вулиця	Притисько-Микільська вулиця
Притисянська вулиця	Притисянська вулиця
Притясминська вулиця	Притясминська вулиця
Приудайська вулиця	Приудайська вулиця
Прифермерська вулиця	Прифермерська вулиця
Прифермівська вулиця	Прифермівська вулиця
Прифермська вулиця	Прифермська вулиця
Приходська вулиця	Приходська вулиця
Приходьківська вулиця	Приходьківська вулиця
Прицівська вулиця	Прицівська вулиця
Пришибська площа	Пришибська площа
Пріорська вулиця	Пріорська вулиця
Пріхнівська вулиця	Пріхнівська вулиця
Пробитовська вулиця	Пробитовська вулиця
Провадійська вулиця	Провадійська вулиця
Провіантська вулиця	Провіантська вулиця
провулок Погорілівська	провулок Погорілівська
Прогінська вулиця	Прогінська вулиця
Прогонянська вулиця	Прогонянська вулиця
Прогресівська вулиця	Прогресівська вулиця
Прокопівська вулиця	Прокопівська вулиця
пролетарська вулиця	пролетарська вулиця
Пролетарська вулиця	Пролетарська вулиця
Промінська вулиця	Промінська вулиця
Прорубська вулиця	Прорубська вулиця
Просвітянська вулиця	Просвітянська вулиця
Проскурівська вулиця	Проскурівська вулиця
Протонівська вулиця	Протонівська вулиця
Протопівська вулиця	Протопівська вулиця
Професорська вулиця	Професорська вулиця
Прохідська вулиця	Прохідська вулиця
Проходська вулиця	Проходська вулиця
Прохорівська вулиця	Прохорівська вулиця
Прохоровська вулиця	Прохоровська вулиця
Процівська вулиця	Процівська вулиця
Пруднівська вулиця	Пруднівська вулиця
Прутська вулиця	Прутська вулиця
Пряшівська вулиця	Пряшівська вулиця
Пряшівська-бічна вулиця	Пряшівська-бічна вулиця
Псільська вулиця	Псільська вулиця
Псковська вулиця	Псковська вулиця
Пугачівська вулиця	Пугачівська вулиця
Пулавська вулиця	Пулавська вулиця
Пулківська вулиця	Пулківська вулиця
Пулковська вулиця	Пулковська вулиця
Пулковська набережна	Пулковська набережна
Пустоварівська вулиця	Пустоварівська вулиця
Пустомитівська вулиця	Пустомитівська вулиця
Путейська вулиця	Путейська вулиця
Путивельська вулиця	Путивельська вулиця
Путивльська вулиця	Путивльська вулиця
Путилівська вулиця	Путилівська вулиця
Путильська вулиця	Путильська вулиця
Путійська вулиця	Путійська вулиця
Путрівська вулиця	Путрівська вулиця
Пухівська вулиця	Пухівська вулиця
Пушкарівська вулиця	Пушкарівська вулиця
Пушкарська вулиця	Пушкарська вулиця
Пушкінська вулиця	Пушкінська вулиця
Пшениківська вулиця	Пшениківська вулиця
Пыонерська вулиця	Пыонерська вулиця
Пятихатська вулиця	Пятихатська вулиця
Рабкопівська вулиця	Рабкопівська вулиця
Рабкорівська вулиця	Рабкорівська вулиця
Рабкоровська вулиця	Рабкоровська вулиця
Рабфаківська вулиця	Рабфаківська вулиця
Рабфаковська вулиця	Рабфаковська вулиця
Равська вулиця	Равська вулиця
Радванська вулиця	Радванська вулиця
Радгоспівська вулиця	Радгоспівська вулиця
Радехівська вулиця	Радехівська вулиця
Радивилівська вулиця	Радивилівська вулиця
Радивілівська вулиця	Радивілівська вулиця
Радилівська вулиця	Радилівська вулиця
Радіозаводська вулиця	Радіозаводська вулиця
Раднаркомівська вулиця	Раднаркомівська вулиця
Раднянська вулиця	Раднянська вулиця
Радомишльська вулиця	Радомишльська вулиця
Радомлянська вулиця	Радомлянська вулиця
Радосинська вулиця	Радосинська вулиця
Радоцинська вулиця	Радоцинська вулиця
Радсадівська вулиця	Радсадівська вулиця
Радстепівська вулиця	Радстепівська вулиця
Радунська вулиця	Радунська вулиця
Радчанська вулиця	Радчанська вулиця
Радьківська вулиця	Радьківська вулиця
Радянська вулиця	Радянська вулиця
Радянська площа	Радянська площа
Радянська dekbwz	Радянська dekbwz
Разумовська вулиця	Разумовська вулиця
Раївська вулиця	Раївська вулиця
Райгородська вулиця	Райгородська вулиця
Райкомівська вулиця	Райкомівська вулиця
Райоленівська вулиця	Райоленівська вулиця
Райська вулиця	Райська вулиця
Раківська вулиця	Раківська вулиця
Ракоська вулиця	Ракоська вулиця
Раменська вулиця	Раменська вулиця
Расвєтівська вулиця	Расвєтівська вулиця
Ратаївська вулиця	Ратаївська вулиця
Ратенська вулиця	Ратенська вулиця
Ратівська вулиця	Ратівська вулиця
Раточинська вулиця	Раточинська вулиця
Рафалівська вулиця	Рафалівська вулиця
Рахівська вулиця	Рахівська вулиця
Рахманівська вулиця	Рахманівська вулиця
Рахнівська вулиця	Рахнівська вулиця
Рацівська вулиця	Рацівська вулиця
Рашківська вулиця	Рашківська вулиця
Ревівська вулиця	Ревівська вулиця
Ревкомівська вулиця	Ревкомівська вулиця
Ревушківська вулиця	Ревушківська вулиця
Ревчанська вулиця	Ревчанська вулиця
Редькінська вулиця	Редькінська вулиця
Редьчинська вулиця	Редьчинська вулиця
Реєстраторська вулиця	Реєстраторська вулиця
Рейдовська вулиця	Рейдовська вулиця
Рейнська вулиця	Рейнська вулиця
Рейтарська вулиця	Рейтарська вулиця
Ремзаводська вулиця	Ремзаводська вулиця
Рентгенівська вулиця	Рентгенівська вулиця
Репегівська вулиця	Репегівська вулиця
Репринська вулиця	Репринська вулиця
Республіканська вулиця	Республіканська вулиця
Решетилівська вулиця	Решетилівська вулиця
Решкутянська вулиця	Решкутянська вулиця
Ржевська вулиця	Ржевська вулиця
Ржищівська вулиця	Ржищівська вулиця
Рибалківська вулиця	Рибалківська вулиця
Рибальська вулиця	Рибальська вулиця
Рибарська вулиця	Рибарська вулиця
Рибасівська вулиця	Рибасівська вулиця
Рибінська вулиця	Рибінська вулиця
Рибпортовська вулиця	Рибпортовська вулиця
Рибчанська вулиця	Рибчанська вулиця
Рижанівська вулиця	Рижанівська вулиця
Рижівська вулиця	Рижівська вулиця
Рижовська вулиця	Рижовська вулиця
Риківська вулиця	Риківська вулиця
Римарська вулиця	Римарська вулиця
Римбовська вулиця	Римбовська вулиця
Римська вулиця	Римська вулиця
Ричагівська вулиця	Ричагівська вулиця
Ришельєвська вулиця	Ришельєвська вулиця
Рівненська вулиця	Рівненська вулиця
Рівнянська вулиця	Рівнянська вулиця
Рівська вулиця	Рівська вулиця
Рідкодубська вулиця	Рідкодубська вулиця
Рідодубська вулиця	Рідодубська вулиця
Різовська вулиця	Різовська вулиця
Різьбярська вулиця	Різьбярська вулиця
Ріпкинська вулиця	Ріпкинська вулиця
Ріпківська вулиця	Ріпківська вулиця
Ріплянська вулиця	Ріплянська вулиця
Річанська вулиця	Річанська вулиця
Річинська вулиця	Річинська вулиця
Рішельєвська вулиця	Рішельєвська вулиця
Робітничо-Селянська вулиця	Робітничо-Селянська вулиця
Робкорівська вулиця	Робкорівська вулиця
Робкоровська вулиця	Робкоровська вулиця
Ровенська вулиця	Ровенська вулиця
Ровеньківська вулиця	Ровеньківська вулиця
Ровжанська вулиця	Ровжанська вулиця
Роганська вулиця	Роганська вулиця
Рогатинська вулиця	Рогатинська вулиця
Рогачівська вулиця	Рогачівська вулиця
Рогівська вулиця	Рогівська вулиця
Рогізнянська вулиця	Рогізнянська вулиця
Рогнединська вулиця	Рогнединська вулиця
Рогнідинська вулиця	Рогнідинська вулиця
Рогозівська вулиця	Рогозівська вулиця
Родаковська вулиця	Родаковська вулиця
Роденська вулиця	Роденська вулиця
Родинська вулиця	Родинська вулиця
Родінська вулиця	Родінська вулиця
Рожанська вулиця	Рожанська вулиця
Рождественська вулиця	Рождественська вулиця
Рожищанська вулиця	Рожищанська вулиця
Рожищенська вулиця	Рожищенська вулиця
Рожівська вулиця	Рожівська вулиця
Рожнянська вулиця	Рожнянська вулиця
Розважівська вулиця	Розважівська вулиця
Роздолівська вулиця	Роздолівська вулиця
Роздольська вулиця	Роздольська вулиця
Розжалівська вулиця	Розжалівська вулиця
Розівська вулиця	Розівська вулиця
Розкидайлівська вулиця	Розкидайлівська вулиця
Розсохівська вулиця	Розсохівська вулиця
Розсоховатська вулиця	Розсоховатська вулиця
Розсошанська вулиця	Розсошанська вулиця
Розумівська вулиця	Розумівська вулиця
Рокитненська вулиця	Рокитненська вулиця
Рокитнянська вулиця	Рокитнянська вулиця
Рокитянська вулиця	Рокитянська вулиця
Роксоланівська вулиця	Роксоланівська вулиця
Романівська вулиця	Романівська вулиця
Романківська вулиця	Романківська вулиця
Роменська вулиця	Роменська вулиця
Ромоданівська вулиця	Ромоданівська вулиця
Ромська вулиця	Ромська вулиця
Росавська вулиця	Росавська вулиця
Росвигівська вулиця	Росвигівська вулиця
Російська вулиця	Російська вулиця
Росохівська вулиця	Росохівська вулиця
Россошанська вулиця	Россошанська вулиця
Ростовська вулиця	Ростовська вулиця
Ротківська вулиця	Ротківська вулиця
Ротондівська вулиця	Ротондівська вулиця
Рошинська вулиця	Рошинська вулиця
Рошівська вулиця	Рошівська вулиця
Рощинська вулиця	Рощинська вулиця
Рощінська вулиця	Рощінська вулиця
Рубанівська вулиця	Рубанівська вулиця
Рубанська вулиця	Рубанська вулиця
Рубежівська вулиця	Рубежівська вулиця
Рубіжанська вулиця	Рубіжанська вулиця
Рубцовська вулиця	Рубцовська вулиця
Рудаївська вулиця	Рудаївська вулиця
Рудаківська вулиця	Рудаківська вулиця
Руданська вулиця	Руданська вулиця
Рудиківська вулиця	Рудиківська вулиця
Рудинська вулиця	Рудинська вулиця
Рудківська вулиця	Рудківська вулиця
Рудненська вулиця	Рудненська вулиця
Рудниківська вулиця	Рудниківська вулиця
Руднівська вулиця	Руднівська вулиця
Руднянська вулиця	Руднянська вулиця
Рудучанська вулиця	Рудучанська вулиця
Рудяківська вулиця	Рудяківська вулиця
Рудянська вулиця	Рудянська вулиця
Ружинська вулиця	Ружинська вулиця
Ружичнянська вулиця	Ружичнянська вулиця
Рулівська вулиця	Рулівська вулиця
Румунська вулиця	Румунська вулиця
Русанівська вулиця	Русанівська вулиця
Русанівська набережна	Русанівська набережна
Русовичівська вулиця	Русовичівська вулиця
Руставська вулиця	Руставська вулиця
Руська вулиця	Руська вулиця
Рухівська вулиця	Рухівська вулиця
Рышельєвська вулиця	Рышельєвська вулиця
Рябушанська вулиця	Рябушанська вулиця
Рядянська вулиця	Рядянська вулиця
Рязанська вулиця	Рязанська вулиця
Ряснянська вулиця	Ряснянська вулиця
Ряшівська вулиця	Ряшівська вулиця
Сабурівська вулиця	Сабурівська вулиця
Сабурівська набережна	Сабурівська набережна
Савинська вулиця	Савинська вулиця
Савонівська вулиця	Савонівська вулиця
Савранська вулиця	Савранська вулиця
Садгірська вулиця	Садгірська вулиця
Садиковська вулиця	Садиковська вулиця
Садиська вулиця	Садиська вулиця
Садівська вулиця	Садівська вулиця
Садківська вулиця	Садківська вулиця
Садова (правутенська)	Садова (правутенська)
Садово-Монастирська вулиця	Садово-Монастирська вулиця
Саксаганська вулиця	Саксаганська вулиця
Саксонська вулиця	Саксонська вулиця
Салдобоська вулиця	Салдобоська вулиця
Салівська вулиця	Салівська вулиця
Салтиківська вулиця	Салтиківська вулиця
Салтівська вулиця	Салтівська вулиця
Сальвівська вулиця	Сальвівська вулиця
Сальська вулиця	Сальська вулиця
Самаркандська вулиця	Самаркандська вулиця
Самарська вулиця	Самарська вулиця
Самбірська вулиця	Самбірська вулиця
Самбірська-Бічна вулиця	Самбірська-Бічна вулиця
Самойлівська вулиця	Самойлівська вулиця
Саморянська вулиця	Саморянська вулиця
Самсонівська вулиця	Самсонівська вулиця
Самусівська вулиця	Самусівська вулиця
Санаторська вулиця	Санаторська вулиця
Сандомирська вулиця	Сандомирська вулиця
Санжарівська вулиця	Санжарівська вулиця
Сапалаївська вулиця	Сапалаївська вулиця
Саперно-Слобідська вулиця	Саперно-Слобідська вулиця
Саранська вулиця	Саранська вулиця
Саратівська вулиця	Саратівська вулиця
Саратовська вулиця	Саратовська вулиця
Саржинська вулиця	Саржинська вулиця
Сарматська вулиця	Сарматська вулиця
Сарнавська вулиця	Сарнавська вулиця
Сарненська вулиця	Сарненська вулиця
Сасівська вулиця	Сасівська вулиця
Сатумарська вулиця	Сатумарська вулиця
Саур-Могилянська вулиця	Саур-Могилянська вулиця
Саф’янська вулиця	Сафʼянська вулиця
Сафронівська вулиця	Сафронівська вулиця
Сахалінська вулиця	Сахалінська вулиця
Сахновщанська вулиця	Сахновщанська вулиця
Сахновщинська вулиця	Сахновщинська вулиця
Сахравська вулиця	Сахравська вулиця
Сачанівська вулиця	Сачанівська вулиця
Саянська вулиця	Саянська вулиця
Св'ято-Димитрівська вулиця	Свʼято-Димитрівська вулиця
Свалявська вулиця	Свалявська вулиця
Сваромська вулиця	Сваромська вулиця
Сватівська вулиця	Сватівська вулиця
Свемовська вулиця	Свемовська вулиця
Свєтська вулиця	Свєтська вулиця
Свирська вулиця	Свирська вулиця
Свисівська вулиця	Свисівська вулиця
Свірська вулиця	Свірська вулиця
Світавська вулиця	Світавська вулиця
Світанківська вулиця	Світанківська вулиця
Світинська вулиця	Світинська вулиця
Світланівська вулиця	Світланівська вулиця
Світловодська вулиця	Світловодська вулиця
Світлогірська вулиця	Світлогірська вулиця
Світлогорська вулиця	Світлогорська вулиця
Світлоградська вулиця	Світлоградська вулиця
Світлодарська вулиця	Світлодарська вулиця
Світлоярська вулиця	Світлоярська вулиця
Світська вулиця	Світська вулиця
Свіштовська вулиця	Свіштовська вулиця
Свободянська вулиця	Свободянська вулиця
Святилівська вулиця	Святилівська вулиця
Святительська вулиця	Святительська вулиця
Святищенська вулиця	Святищенська вулиця
Свято-Андріївська вулиця	Свято-Андріївська вулиця
Свято-Воздвиженська вулиця	Свято-Воздвиженська вулиця
Свято-Воскресенська вулиця	Свято-Воскресенська вулиця
Свято-Георгіївська вулиця	Свято-Георгіївська вулиця
Свято-Духівська площа	Свято-Духівська площа
Свято-Іллінська вулиця	Свято-Іллінська вулиця
Свято-Іллінська площа	Свято-Іллінська площа
Свято-Ільїнська вулиця	Свято-Ільїнська вулиця
Свято-Казанська вулиця	Свято-Казанська вулиця
Свято-Макаріївська вулиця	Свято-Макаріївська вулиця
Свято-Микільська вулиця	Свято-Микільська вулиця
Свято-Миколаєвська вулиця	Свято-Миколаєвська вулиця
Свято-Миколаївська вулиця	Свято-Миколаївська вулиця
Свято-Михайлівська вулиця	Свято-Михайлівська вулиця
Свято-Нікольська вулиця	Свято-Нікольська вулиця
Свято-Переображенська вулиця	Свято-Переображенська вулиця
Свято-Покровська вулиця	Свято-Покровська вулиця
Свято-Преображенська вулиця	Свято-Преображенська вулиця
Свято-Успенська вулиця	Свято-Успенська вулиця
Свято-Флоріанівська вулиця	Свято-Флоріанівська вулиця
Святоандріївська вулиця	Святоандріївська вулиця
Святовознесенська вулиця	Святовознесенська вулиця
Святоволодимирівська вулиця	Святоволодимирівська вулиця
Святогеоргіївська вулиця	Святогеоргіївська вулиця
Святогірська вулиця	Святогірська вулиця
Святогорівська вулиця	Святогорівська вулиця
Святодимитріївська вулиця	Святодимитріївська вулиця
Святодухівська вулиця	Святодухівська вулиця
Святоіллінська вулиця	Святоіллінська вулиця
Святомиколаївська вулиця	Святомиколаївська вулиця
Святомихайлівська вулиця	Святомихайлівська вулиця
Святопокровська вулиця	Святопокровська вулиця
Святославівська вулиця	Святославівська вулиця
Святославська вулиця	Святославська вулиця
Святошинська вулиця	Святошинська вулиця
Святошинська площа	Святошинська площа
Святоюрівська вулиця	Святоюрівська вулиця
Святоюріївська вулиця	Святоюріївська вулиця
Святоюрська вулиця	Святоюрська вулиця
Свяченівська вулиця	Свяченівська вулиця
Севанська вулиця	Севанська вулиця
Севастопільська вулиця	Севастопільська вулиця
Севастопольська вулиця	Севастопольська вулиця
Севастопольська площа	Севастопольська площа
Север’янівська вулиця	Северʼянівська вулиця
Северинівська вулиця	Северинівська вулиця
Северодвинська вулиця	Северодвинська вулиця
Севлюська вулиця	Севлюська вулиця
Севська вулиця	Севська вулиця
Сегедська вулиця	Сегедська вулиця
Седнівська вулиця	Седнівська вулиця
Сеймська вулиця	Сеймська вулиця
Секунська вулиця	Секунська вулиця
Селезнівська вулиця	Селезнівська вулиця
Селезньовська вулиця	Селезньовська вулиця
Селидівська вулиця	Селидівська вулиця
Селиська вулиця	Селиська вулиця
Селищанська вулиця	Селищанська вулиця
Селькоровська вулиця	Селькоровська вулиця
Селянська вулиця	Селянська вулиця
Селятинська вулиця	Селятинська вулиця
Семаківська вулиця	Семаківська вулиця
Семенівська вулиця	Семенівська вулиця
Семеніївська вулиця	Семеніївська вулиця
Семеніська вулиця	Семеніська вулиця
Семиградська вулиця	Семиградська вулиця
Семидубська вулиця	Семидубська вулиця
Семипалатинська вулиця	Семипалатинська вулиця
Семікінська вулиця	Семікінська вулиця
Семінарська вулиця	Семінарська вулиця
Семіходська вулиця	Семіходська вулиця
Сеневська вулиця	Сеневська вулиця
Сенівська вулиця	Сенівська вулиця
Сеноманська вулиця	Сеноманська вулиця
Сент-Етьєнівська вулиця	Сент-Етьєнівська вулиця
Сенчанська вулиця	Сенчанська вулиця
Сеньківська вулиця	Сеньківська вулиця
Серафимівська вулиця	Серафимівська вулиця
Сербська вулиця	Сербська вулиця
Серверинівська вулиця	Серверинівська вулиця
Сергіївська вулиця	Сергіївська вулиця
Сердитянська вулиця	Сердитянська вулиця
Середівська вулиця	Середівська вулиця
Середньоазіатська вулиця	Середньоазіатська вулиця
Середньоруденська дорога	Середньоруденська дорога
Середньоуральська вулиця	Середньоуральська вулиця
Середньофонтанська вулиця	Середньофонтанська вулиця
Середнянська вулиця	Середнянська вулиця
Сержантська вулиця	Сержантська вулиця
Сериківська вулиця	Сериківська вулиця
Сернянська вулиця	Сернянська вулиця
Серпухівська вулиця	Серпухівська вулиця
Серпуховська вулиця	Серпуховська вулиця
Сєверська вулиця	Сєверська вулиця
Сєвєродвінська вулиця	Сєвєродвінська вулиця
Сєвєрокримська вулиця	Сєвєрокримська вулиця
Сєвєроуральська вулиця	Сєвєроуральська вулиця
Сибірська вулиця	Сибірська вулиця
Сиваська вулиця	Сиваська вулиця
Сивашська вулиця	Сивашська вулиця
Сигавчанська вулиця	Сигавчанська вулиця
Сигнаївська вулиця	Сигнаївська вулиця
Сидоренківська вулиця	Сидоренківська вулиця
Сизранська вулиця	Сизранська вулиця
Сиктивкарська вулиця	Сиктивкарська вулиця
Симбірська вулиця	Симбірська вулиця
Симиренківська вулиця	Симиренківська вулиця
Симферопольська вулиця	Симферопольська вулиця
Синевирська Поляна	Синевирська Поляна
Синельниківська вулиця	Синельниківська вулиця
Синігівська вулиця	Синігівська вулиця
Синьківська вулиця	Синьківська вулиця
Синьоводська вулиця	Синьоводська вулиця
Синьогірська вулиця	Синьогірська вулиця
Синявська вулиця	Синявська вулиця
Синяківська вулиця	Синяківська вулиця
Ситарівська вулиця	Ситарівська вулиця
Ситихівська вулиця	Ситихівська вулиця
Ситниківська вулиця	Ситниківська вулиця
Ситняківська вулиця	Ситняківська вулиця
Сихівська вулиця	Сихівська вулиця
Сіверська вулиця	Сіверська вулиця
Сіверянська вулиця	Сіверянська вулиця
Сівківська вулиця	Сівківська вулиця
Сігетська вулиця	Сігетська вулиця
Сільбудівська вулиця	Сільбудівська вулиця
Сільзаводська вулиця	Сільзаводська вулиця
Сількорівська вулиця	Сількорівська вулиця
Сільрадська вулиця	Сільрадська вулиця
Сільскогосподарська вулиця	Сільскогосподарська вулиця
Сільська вулиця	Сільська вулиця
Сільськогосподарська вул	Сільськогосподарська вул
Сільськогосподарська вулиця	Сільськогосподарська вулиця
Сімська вулиця	Сімська вулиця
Сімферопольська вулиця	Сімферопольська вулиця
Сіретська вулиця	Сіретська вулиця
Сіриківська вулиця	Сіриківська вулиця
Сірноводська вулиця	Сірноводська вулиця
Сітарська вулиця	Сітарська вулиця
Січеславська вулиця	Січеславська вулиця
Сіянська вулиця	Сіянська вулиця
Скадовська вулиця	Скадовська вулиця
Скаливатська вулиця	Скаливатська вулиця
Скандинавська вулиця	Скандинавська вулиця
Сквирська вулиця	Сквирська вулиця
Скеліватська вулиця	Скеліватська вулиця
Скиданівська вулиця	Скиданівська вулиця
Скіфська вулиця	Скіфська вулиця
Складська вулиця	Складська вулиця
Склозаводська вулиця	Склозаводська вулиця
Скнилівська вулиця	Скнилівська вулиця
Скобелевська вулиця	Скобелевська вулиця
Сковородинівська вулиця	Сковородинівська вулиця
Сколівська вулиця	Сколівська вулиця
Скородненська вулиця	Скородненська вулиця
Скригалівська вулиця	Скригалівська вулиця
Скринниківська вулиця	Скринниківська вулиця
Скубіївська вулиця	Скубіївська вулиця
Скуртянська вулиця	Скуртянська вулиця
Славгородська вулиця	Славгородська вулиця
Славградська вулиця	Славградська вулиця
Славутська вулиця	Славутська вулиця
Славянська вулиця	Славянська вулиця
Славʼянська вулиця	Славʼянська вулиця
Слівенська вулиця	Слівенська вулиця
Слобідська вулиця	Слобідська вулиця
Слобідська провулок	Слобідська провулок
Слобідська-Пушкіна вулиця	Слобідська-Пушкіна вулиця
Слободська вулиця	Слободська вулиця
Слободянська вулиця	Слободянська вулиця
Слобожанська вулиця	Слобожанська вулиця
Слобожанська площа	Слобожанська площа
Слобiдська вулиця	Слобiдська вулиця
Слов'нська вулиця	Словʼнська вулиця
Слов'янська вулиця	Словʼянська вулиця
Слов‘янська вулиця	Слов‘янська вулиця
Слов’яногірська вулиця	Словʼяногірська вулиця
Слов’янська вулиця	Словʼянська вулиця
Словечанська вулиця	Словечанська вулиця
Словянська вулиця	Словянська вулиця
Словʼянська вулиця	Словʼянська вулиця
Словʼянська набережна	Словʼянська набережна
Слуківська вулиця	Слуківська вулиця
Слюсарська вулиця	Слюсарська вулиця
Смиківська вулиця	Смиківська вулиця
Смілянська вулиця	Смілянська вулиця
Смірновська вулиця	Смірновська вулиця
Смолдирівська вулиця	Смолдирівська вулиця
Смоленська вулиця	Смоленська вулиця
Смолківська вулиця	Смолківська вулиця
Смоляно-Ракитянська вулиця	Смоляно-Ракитянська вулиця
Смолянська вулиця	Смолянська вулиця
Сморжівська вулиця	Сморжівська вулиця
Смородянська вулиця	Смородянська вулиця
Снайперська вулиця	Снайперська вулиця
Снігурівська вулиця	Снігурівська вулиця
Сніжківська вулиця	Сніжківська вулиця
Сніжнянська вулиця	Сніжнянська вулиця
Снітинська вулиця	Снітинська вулиця
Сновська вулиця	Сновська вулиця
Снопківська вулиця	Снопківська вулиця
Снятинська вулиця	Снятинська вулиця
Соболівська вулиця	Соболівська вулиця
Соборно-Миколаївська площа	Соборно-Миколаївська площа
Собятинська вулиця	Собятинська вулиця
Советська вулиця	Советська вулиця
Совєтська вулиця	Совєтська вулиця
Совівська вулиця	Совівська вулиця
Совська вулиця	Совська вулиця
Содівська вулиця	Содівська вулиця
Сокальська вулиця	Сокальська вулиця
Сокирянська вулиця	Сокирянська вулиця
Сокільська вулиця	Сокільська вулиця
Соколинська вулиця	Соколинська вулиця
Соколівська вулиця	Соколівська вулиця
Соколовська вулиця	Соколовська вулиця
Сокольська вулиця	Сокольська вулиця
Солдатська вулиця	Солдатська вулиця
Соледарська вулиця	Соледарська вулиця
Солікамська вулиця	Солікамська вулиця
Солов'євська вулиця	Соловʼєвська вулиця
Солов'ївська вулиця	Соловʼївська вулиця
Солов'янівська вулиця	Соловʼянівська вулиця
Солов'янська вулиця	Соловʼянська вулиця
Солом'янська вулиця	Соломʼянська вулиця
Солом’янська вулиця	Соломʼянська вулиця
Солом’янська площа	Соломʼянська площа
Соломʼянська вулиця	Соломʼянська вулиця
Солонянська вулиця	Солонянська вулиця
Солотвинська вулиця	Солотвинська вулиця
Сользаводська вулиця	Сользаводська вулиця
Сомботгейська вулиця	Сомботгейська вулиця
Сомівська вулиця	Сомівська вулиця
Сонячногірська вулиця	Сонячногірська вулиця
Сормівська вулиця	Сормівська вулиця
Сормовська вулиця	Сормовська вулиця
Сороківська вулиця	Сороківська вулиця
Сорокопенська криниця	Сорокопенська криниця
Сорочинська вулиця	Сорочинська вулиця
Соснівська вулиця	Соснівська вулиця
Сосновська вулиця	Сосновська вулиця
Сотниківська вулиця	Сотниківська вулиця
Софіївська вул.	Софіївська вул.
Софіївська вулиця	Софіївська вулиця
Софійська вулиця	Софійська вулиця
Софїївська вулиця	Софїївська вулиця
Сочинська вулиця	Сочинська вулиця
Сошеньська вулиця	Сошеньська вулиця
Сошиновська вулиця	Сошиновська вулиця
Спартаківська вулиця	Спартаківська вулиця
Спартаковська вулиця	Спартаковська вулиця
Спасівська вулиця	Спасівська вулиця
Спасо-Преображенська вулиця	Спасо-Преображенська вулиця
Спасська вулиця	Спасська вулиця
Спаська вулиця	Спаська вулиця
Спиридонівська вулиця	Спиридонівська вулиця
Спорітінська вулиця	Спорітінська вулиця
Срийська вулиця	Срийська вулиця
Сріблянська вулиця	Сріблянська вулиця
Срібнокільська вулиця	Срібнокільська вулиця
Стависька вулиця	Стависька вулиця
Ставищанська вулиця	Ставищанська вулиця
Ставківська вулиця	Ставківська вулиця
Ставрівська вулиця	Ставрівська вулиця
Ставропігійська вулиця	Ставропігійська вулиця
Ставропільська вулиця	Ставропільська вулиця
Ставропольська вулиця	Ставропольська вулиця
Ставчанська вулиця	Ставчанська вулиця
Стадіонівська вулиця	Стадіонівська вулиця
Стаєчненська вулиця	Стаєчненська вулиця
Сталеварівська вулиця	Сталеварівська вулиця
Станіславська вулиця	Станіславська вулиця
Становищанська вулиця	Становищанська вулиця
Стариківська вулиця	Стариківська вулиця
Старівська вулиця	Старівська вулиця
Старо-Григорівська вулиця	Старо-Григорівська вулиця
Старо-Житомирська вулиця	Старо-Житомирська вулиця
Старо-Кримська вулиця	Старо-Кримська вулиця
Старо-Рафалівська вулиця	Старо-Рафалівська вулиця
Старо-Яблунська вулиця	Старо-Яблунська вулиця
Старобанська вулиця	Старобанська вулиця
Старобасанська вулиця	Старобасанська вулиця
Старобельська вулиця	Старобельська вулиця
Старобешівська вулиця	Старобешівська вулиця
Старобєльська вулиця	Старобєльська вулиця
Старобілоуська вулиця	Старобілоуська вулиця
Старобільська вулиця	Старобільська вулиця
Старобориспільська вулиця	Старобориспільська вулиця
Староборщівська вулиця	Староборщівська вулиця
Старобрідська вулиця	Старобрідська вулиця
Староверещаківська вулиця	Староверещаківська вулиця
Старовитківська вулиця	Старовитківська вулиця
Старовільська вулиця	Старовільська вулиця
Старогородська вулиця	Старогородська вулиця
Старогрубнянська вулиця	Старогрубнянська вулиця
Стародніпровська вулиця	Стародніпровська вулиця
Стародоманинська вулиця	Стародоманинська вулиця
Стародубовська вулиця	Стародубовська вулиця
Стародубська вулиця	Стародубська вулиця
Староєврейська вулиця	Староєврейська вулиця
Старозаводська вулиця	Старозаводська вулиця
Старознесенська вулиця	Старознесенська вулиця
Староігренська вулиця	Староігренська вулиця
Старокандибівська вулиця	Старокандибівська вулиця
Старокиївська вулиця	Старокиївська вулиця
Старокиївська дорога	Старокиївська дорога
Старокілійська вулиця	Старокілійська вулиця
Старокінська вулиця	Старокінська вулиця
Староковальська вулиця	Староковальська вулиця
Старокостянтинівська вулиця	Старокостянтинівська вулиця
Старокотелевська вулиця	Старокотелевська вулиця
Старокримська вулиця	Старокримська вулиця
Старокунашівська вулиця	Старокунашівська вулиця
Старолюбовнянська вулиця	Старолюбовнянська вулиця
Старомалооснов’янська вулиця	Старомалоосновʼянська вулиця
Старомикитинська вулиця	Старомикитинська вулиця
Старомихайлівська вулиця	Старомихайлівська вулиця
Староміська вулиця	Староміська вулиця
Старомлинська вулиця	Старомлинська вулиця
Старомостівська вулиця	Старомостівська вулиця
Старонетішинська вулиця	Старонетішинська вулиця
Староніжинська вулиця	Староніжинська вулиця
Старонікольська вулиця	Старонікольська вулиця
Старообухівська вулиця	Старообухівська вулиця
Старообухівська траса	Старообухівська траса
Староодесянська вулиця	Староодесянська вулиця
Старооскольська вулиця	Старооскольська вулиця
Старопетрівська вулиця	Старопетрівська вулиця
Старопортофранківська вулиця	Старопортофранківська вулиця
Старопортрофранківська вулиця	Старопортрофранківська вулиця
Старопосадська вулиця	Старопосадська вулиця
Старопутивльська вулиця	Старопутивльська вулиця
Староріченська вулиця	Староріченська вулиця
Староруслянська вулиця	Староруслянська вулиця
Староруська вулиця	Староруська вулиця
Старосанжарська вулиця	Старосанжарська вулиця
Старосвітська вулиця	Старосвітська вулиця
Староселівська вулиця	Староселівська вулиця
Старосільська вулиця	Старосільська вулиця
Старософіївська вулиця	Старософіївська вулиця
Старостинська вулиця	Старостинська вулиця
Старостриженська вулиця	Старостриженська вулиця
Староукраїнська вулиця	Староукраїнська вулиця
Старочуднівська вулиця	Старочуднівська вулиця
Старошишківська вулиця	Старошишківська вулиця
Старошулявська вулиця	Старошулявська вулиця
Стаханівська вулиця	Стаханівська вулиця
Стахановська вулиця	Стахановська вулиця
Сташківська вулиця	Сташківська вулиця
Стеблівська вулиця	Стеблівська вулиця
Стеблівська ГЕС	Стеблівська ГЕС
Стебліївська вулиця	Стебліївська вулиця
Степаненківська вулиця	Степаненківська вулиця
Степанівська вулиця	Степанівська вулиця
Степанська вулиця	Степанська вулиця
Степногірська вулиця	Степногірська вулиця
Степурянська вулиця	Степурянська вулиця
Стерлітамакська вулиця	Стерлітамакська вулиця
Стефанівська вулиця	Стефанівська вулиця
Стецівська вулиця	Стецівська вулиця
Стецьківська вулиця	Стецьківська вулиця
Стечанська вулиця	Стечанська вулиця
Стиртенська вулиця	Стиртенська вулиця
Стовпинська вулиця	Стовпинська вулиця
Стодільська вулиця	Стодільська вулиця
Столінська вулиця	Столінська вулиця
Сторожівська вулиця	Сторожівська вулиця
Стоянівська вулиця	Стоянівська вулиця
Стоянська вулиця	Стоянська вулиця
Страклівська вулиця	Страклівська вулиця
Стремигородська вулиця	Стремигородська вулиця
Стрижавська вулиця	Стрижавська вулиця
Стрижигородська вулиця	Стрижигородська вулиця
Стрийська вулиця	Стрийська вулиця
Стримбівська вулиця	Стримбівська вулиця
Стрійська вулиця	Стрійська вулиця
Стрітенська вулиця	Стрітенська вулиця
Стріховська вулиця	Стріховська вулиця
Струнківська вулиця	Струнківська вулиця
Струтинська вулиця	Струтинська вулиця
Студениківська вулиця	Студениківська вулиця
Студентська вулиця	Студентська вулиця
Студентська набережна	Студентська набережна
Суботівська вулиця	Суботівська вулиця
Суворівська алея	Суворівська алея
Суворівська вулиця	Суворівська вулиця
Суворовська вулиця	Суворовська вулиця
Сугокліївська вулиця	Сугокліївська вулиця
Судилівська вулиця	Судилівська вулиця
Судилківська вулиця	Судилківська вулиця
Суднозаводська вулиця	Суднозаводська вулиця
Суздальська вулиця	Суздальська вулиця
Сукурівська вулиця	Сукурівська вулиця
Сулимівська вулиця	Сулимівська вулиця
Сулинська дамба	Сулинська дамба
Сульжинівська вулиця	Сульжинівська вулиця
Сульська вулиця	Сульська вулиця
Сумгаїтська вулиця	Сумгаїтська вулиця
Сумська вулиця	Сумська вулиця
Сунківська вулиця	Сунківська вулиця
Супрунівська вулиця	Супрунівська вулиця
Сургутська вулиця	Сургутська вулиця
Сурська вулиця	Сурська вулиця
Сурсько-Литовська вулиця	Сурсько-Литовська вулиця
Сурянська вулиця	Сурянська вулиця
Сухарівська вулиця	Сухарівська вулиця
Сухачівська вулиця	Сухачівська вулиця
Сухинівська вулиця	Сухинівська вулиця
Сухобалківська вулиця	Сухобалківська вулиця
Суховільська вулиця	Суховільська вулиця
Суховольська вулиця	Суховольська вулиця
Суходільська вулиця	Суходільська вулиця
Суходольська вулиця	Суходольська вулиця
Сухоіванівська вулиця	Сухоіванівська вулиця
Сухолінська вулиця	Сухолінська вулиця
Сухорабівська вулиця	Сухорабівська вулиця
Сухоярська вулиця	Сухоярська вулиця
Сухумська вулиця	Сухумська вулиця
Сучавська вулиця	Сучавська вулиця
Сущенська вулиця	Сущенська вулиця
Східівська вулиця	Східівська вулиця
Східно-Шевченківська вулиця	Східно-Шевченківська вулиця
Східнослов’янська вулиця	Східнословʼянська вулиця
Сянська вулиця	Сянська вулиця
Сiльська вулиця	Сiльська вулиця
Табурищанська вулиця	Табурищанська вулиця
Таванська вулиця	Таванська вулиця
Таврійська вулиця	Таврійська вулиця
Таврічеська вулиця	Таврічеська вулиця
Таврiйська вулиця	Таврiйська вулиця
Таганрогська вулиця	Таганрогська вулиця
Таганрожська вулиця	Таганрожська вулиця
Таганська вулиця	Таганська вулиця
Тагільська вулиця	Тагільська вулиця
Таджикська вулиця	Таджикська вулиця
Таїровська вулиця	Таїровська вулиця
Таймирська вулиця	Таймирська вулиця
Тайшетська вулиця	Тайшетська вулиця
Талінська вулиця	Талінська вулиця
Талліннська вулиця	Талліннська вулиця
Таллінська вулиця	Таллінська вулиця
Тальнівська вулиця	Тальнівська вулиця
Тальська вулиця	Тальська вулиця
Таманська вулиця	Таманська вулиця
Тамбовська вулиця	Тамбовська вулиця
Тарапаківська вулиця	Тарапаківська вулиця
Тарасівська вулиця	Тарасівська вулиця
Тарасівська дорога	Тарасівська дорога
Таращанська вулиця	Таращанська вулиця
Таромська вулиця	Таромська вулиця
Тартаківська вулиця	Тартаківська вулиця
Тарутинська вулиця	Тарутинська вулиця
Тарутінська вулиця	Тарутінська вулиця
Татарбунарська вулиця	Татарбунарська вулиця
Татаринська вулиця	Татаринська вулиця
Татарнівська вулиця	Татарнівська вулиця
Татарська вулиця	Татарська вулиця
Тахіатаська вулиця	Тахіатаська вулиця
Тахтаулівська вулиця	Тахтаулівська вулиця
Ташкентська вулиця	Ташкентська вулиця
Тбіліська вулиця	Тбіліська вулиця
Тверська вулиця	Тверська вулиця
Тегеранська вулиця	Тегеранська вулиця
Теківська вулиця	Теківська вулиця
Теклівська вулиця	Теклівська вулиця
Телешівська вулиця	Телешівська вулиця
Темпівська вулиця	Темпівська вулиця
Теплогірська вулиця	Теплогірська вулиця
Тереблянська вулиця	Тереблянська вулиця
Теребовлянська вулиця	Теребовлянська вулиця
Теремківська вулиця	Теремківська вулиця
Теремнівська вулиця	Теремнівська вулиця
Теремська вулиця	Теремська вулиця
Тереньківська вулиця	Тереньківська вулиця
Тересівська вулиця	Тересівська вулиця
Терешківська вулиця	Терешківська вулиця
Терещенківська вулиця	Терещенківська вулиця
Терихівська вулиця	Терихівська вулиця
Тернавська вулиця	Тернавська вулиця
Тернівська вулиця	Тернівська вулиця
Тернопільська вулиця	Тернопільська вулиця
Тернулівська вулиця	Тернулівська вулиця
Терпулівська вулиця	Терпулівська вулиця
Терська вулиця	Терська вулиця
Терчинська вулиця	Терчинська вулиця
Теслугівська вулиця	Теслугівська вулиця
Теслярська вулиця	Теслярська вулиця
Тетерівська вулиця	Тетерівська вулиця
Тетіївська вулиця	Тетіївська вулиця
Технікумівська вулиця	Технікумівська вулиця
Технікумська вулиця	Технікумська вулиця
Тецівська вулиця	Тецівська вулиця
Тибетська вулиця	Тибетська вулиця
Тиверська вулиця	Тиверська вулиця
Тилігульська вулиця	Тилігульська вулиця
Тимофіївська вулиця	Тимофіївська вулиця
Тимурівська вулиця	Тимурівська вулиця
Тимченківська вулиця	Тимченківська вулиця
Тиннівська вулиця	Тиннівська вулиця
Тираспільська вулиця	Тираспільська вулиця
Тираспольська вулиц	Тираспольська вулиц
Тираспольська вулиця	Тираспольська вулиця
Тираспольська площа	Тираспольська площа
Тисівська вулиця	Тисівська вулиця
Тисянська вулиця	Тисянська вулиця
Титарська вулиця	Титарська вулиця
Тиханська вулиця	Тиханська вулиця
Тихвинська вулиця	Тихвинська вулиця
Тихвінська вулиця	Тихвінська вулиця
Тиходонська вулиця	Тиходонська вулиця
Тихоокеанська вулиця	Тихоокеанська вулиця
Тихоріченська вулиця	Тихоріченська вулиця
Тіверська вулиця	Тіверська вулиця
Тімертауська вулиця	Тімертауська вулиця
Тіснинська вулиця	Тіснинська вулиця
Ткалівська вулиця	Ткалівська вулиця
Ткачевська вулиця	Ткачевська вулиця
Ткаченківська вулиця	Ткаченківська вулиця
Тобольська вулиця	Тобольська вулиця
Товариська вулиця	Товариська вулиця
Товмоченська вулиця	Товмоченська вулиця
Товстоліська вулиця	Товстоліська вулиця
Тожівська вулиця	Тожівська вулиця
Токарівська вулиця	Токарівська вулиця
Токарська вулиця	Токарська вулиця
Толочанська вулиця	Толочанська вулиця
Томаковська вулиця	Томаковська вулиця
Томашевська вулиця	Томашевська вулиця
Томашівська вулиця	Томашівська вулиця
Томашпільська вулиця	Томашпільська вулиця
Томилівська вулиця	Томилівська вулиця
Томська вулиця	Томська вулиця
Тополівська вулиця	Тополівська вулиця
Тополянська вулиця	Тополянська вулиця
Топорівська вулиця	Топорівська вулиця
Торгівська вулиця	Торгівська вулиця
Торгмашівська вулиця	Торгмашівська вулиця
Тормаська вулиця	Тормаська вулиця
Тороківська вулиця	Тороківська вулиця
Торська вулиця	Торська вулиця
Торська площа	Торська площа
Торчинська вулиця	Торчинська вулиця
Трансківська вулиця	Трансківська вулиця
Трапезонська вулиця	Трапезонська вулиця
Трахтемирівська вулиця	Трахтемирівська вулиця
Траянвальська вулиця	Траянвальська вулиця
Требішовська вулиця	Требішовська вулиця
Требухівська вулиця	Требухівська вулиця
Тренченська вулиця	Тренченська вулиця
Тренчинська вулиця	Тренчинська вулиця
Трестівська вулиця	Трестівська вулиця
Трестівська площа	Трестівська площа
Третя Заярська	Третя Заярська
Третяківська вулиця	Третяківська вулиця
Трибушанська вулиця	Трибушанська вулиця
Тринітарська вулиця	Тринітарська вулиця
Трипільська вулиця	Трипільська вулиця
Троїтська вулиця	Троїтська вулиця
Трохимівська вулиця	Трохимівська вулиця
Троянівська вулиця	Троянівська вулиця
Троянівська дорога	Троянівська дорога
Трубайлівська вулиця	Трубайлівська вулиця
Трубіжська вулиця	Трубіжська вулиця
Трудівська вулиця	Трудівська вулиця
Труханівська вулиця	Труханівська вулиця
Трушівська вулиця	Трушівська вулиця
Трьохсвятительська вулиця	Трьохсвятительська вулиця
Трьохсвятська вулиця	Трьохсвятська вулиця
Тувинська вулиця	Тувинська вулиця
Тувінська вулиця	Тувінська вулиця
Тудинська вулиця	Тудинська вулиця
Тулинська вул.	Тулинська вул.
Туличівська вулиця	Туличівська вулиця
Тульська вулиця	Тульська вулиця
Тульчинська вулиця	Тульчинська вулиця
Тульчіанівська вулиця	Тульчіанівська вулиця
Тунгуська вулиця	Тунгуська вулиця
Тур’янська вулиця	Турʼянська вулиця
Туранська вулиця	Туранська вулиця
Турбаєвська вулиця	Турбаєвська вулиця
Турбаївська вулиця	Турбаївська вулиця
Тургайська вулиця	Тургайська вулиця
Тургенєвська вулиця	Тургенєвська вулиця
Тургенівська вулиця	Тургенівська вулиця
Туринська вулиця	Туринська вулиця
Туристська вулиця	Туристська вулиця
Турівська вулиця	Турівська вулиця
Туріянська вулиця	Туріянська вулиця
Туркестанська вулиця	Туркестанська вулиця
Туркменська вулиця	Туркменська вулиця
Турунська вулиця	Турунська вулиця
Туруханська вулиця	Туруханська вулиця
Турянська вулиця	Турянська вулиця
Тустанська вулиця	Тустанська вулиця
Тутаївська вулиця	Тутаївська вулиця
Тушинська вулиця	Тушинська вулиця
Тьовшажанська вулиця	Тьовшажанська вулиця
Тюдівська вулиця	Тюдівська вулиця
Тюменська вулиця	Тюменська вулиця
Тюрінська вулиця	Тюрінська вулиця
Тягинська вулиця	Тягинська вулиця
Тяжилівська вулиця	Тяжилівська вулиця
Тянь-Шанська вулиця	Тянь-Шанська вулиця
Тясминська вулиця	Тясминська вулиця
Тячівська вулиця	Тячівська вулиця
Ублянська вулиця	Ублянська вулиця
Уваровська вулиця	Уваровська вулиця
Увислянська вулиця	Увислянська вулиця
Угнівська вулиця	Угнівська вулиця
Угорська вулиця	Угорська вулиця
Угочанська вулиця	Угочанська вулиця
Угроїдська вулиця	Угроїдська вулиця
Удайська вулиця	Удайська вулиця
Удайцівська вулиця	Удайцівська вулиця
Удигейська вулиця	Удигейська вулиця
Удитинська вулиця	Удитинська вулиця
Удмуртська вулиця	Удмуртська вулиця
Удодівська вулиця	Удодівська вулиця
Удянська вулиця	Удянська вулиця
Ужанська вулиця	Ужанська вулиця
Ужанська набережна	Ужанська набережна
Ужачинська вулиця	Ужачинська вулиця
Ужгородська вулиця	Ужгородська вулиця
Ужгородська набережна	Ужгородська набережна
Узбекистанська вулиця	Узбекистанська вулиця
Узинська вулиця	Узинська вулиця
Укмергеська вулиця	Укмергеська вулиця
Українківська вулиця	Українківська вулиця
Українська вулиця	Українська вулиця
Українська площа	Українська площа
Уланська вулиця	Уланська вулиця
Уланська площа	Уланська площа
Ульцинська вулиця	Ульцинська вулиця
Ульянівська вулиця	Ульянівська вулиця
Ульяновська вулиця	Ульяновська вулиця
Улʼянівська вулиця	Улʼянівська вулиця
Уманська вулиця	Уманська вулиця
Унавська вулиця	Унавська вулиця
Унгенська вулиця	Унгенська вулиця
Університетська вулиця	Університетська вулиця
Уральська вулиця	Уральська вулиця
Ургальська вулиця	Ургальська вулиця
Уренгойська вулиця	Уренгойська вулиця
Уржумська вулиця	Уржумська вулиця
Урзуфська вулиця	Урзуфська вулиця
Урлівська вулиця	Урлівська вулиця
Урсолівська вулиця	Урсолівська вулиця
Урус-Мартанівська вулиця	Урус-Мартанівська вулиця
Урюпинська вулиця	Урюпинська вулиця
Урюпінська вулиця	Урюпінська вулиця
Усатівська вулиця	Усатівська вулиця
Усівська вулиця	Усівська вулиця
Усіковська вулиця	Усіковська вулиця
Усольська вулиця	Усольська вулиця
Успенська вулиця	Успенська вулиця
Успенська площа	Успенська площа
Уссурійська вулиця	Уссурійська вулиця
Устимівська вулиця	Устимівська вулиця
Устинська вулиця	Устинська вулиця
Усть-Каменогірська вулиця	Усть-Каменогірська вулиця
Усть-Каменогорська вулиця	Усть-Каменогорська вулиця
Усурійська вулиця	Усурійська вулиця
Уфимська вулиця	Уфимська вулиця
Уфімська вулиця	Уфімська вулиця
Уханівська вулиця	Уханівська вулиця
Учительська вулиця	Учительська вулиця
Учнівська алея	Учнівська алея
Учнівська вулиця	Учнівська вулиця
Ущилівська вулиця	Ущилівська вулиця
Фабрично-Заводська вулиця	Фабрично-Заводська вулиця
Фалєєвська вулиця	Фалєєвська вулиця
Фальківська вулиця	Фальківська вулиця
Фанагорійська вулиця	Фанагорійська вулиця
Фарзаводська вулиця	Фарзаводська вулиця
Фастівська вулиця	Фастівська вулиця
Фастовська вулиця	Фастовська вулиця
Февральська вулиця	Февральська вулиця
Федорівська вулиця	Федорівська вулиця
Федосіївська вулиця	Федосіївська вулиця
Фельдшерська вулиця	Фельдшерська вулиця
Фельштинська вулиця	Фельштинська вулиця
Феодосіївська вулиця	Феодосіївська вулиця
Феодосійська вулиця	Феодосійська вулиця
Феофанівська вулиця	Феофанівська вулиця
Ферганська вулиця	Ферганська вулиця
Фермерська вулиця	Фермерська вулиця
Фермівська вулиця	Фермівська вулиця
Фесенківська вулиця	Фесенківська вулиця
Філімонівська вулиця	Філімонівська вулиця
Філософська алея	Філософська алея
Філософська вулиця	Філософська вулиця
Фінляндська вулиця	Фінляндська вулиця
Фінська вулиця	Фінська вулиця
Флоренська вулиця	Флоренська вулиця
Флотська вулиця	Флотська вулиця
Фльорівська вулиця	Фльорівська вулиця
Фонтанська дорога	Фонтанська дорога
Форштадтська вулиця	Форштадтська вулиця
Франківська вулиця	Франківська вулиця
Францисканська вулиця	Францисканська вулиця
Фридрихівська вулиця	Фридрихівська вулиця
Фрідєшівська вулиця	Фрідєшівська вулиця
Фролівська вулиця	Фролівська вулиця
Фрометівська вулиця	Фрометівська вулиця
Фрунзенська вулиця	Фрунзенська вулиця
Фундукліївська вулиця	Фундукліївська вулиця
Фурдилівська вулиця	Фурдилівська вулиця
Фурманівська вулиця	Фурманівська вулиця
Фурманська вулиця	Фурманська вулиця
Фурсівська вулиця	Фурсівська вулиця
Фурштадська вулиця	Фурштадська вулиця
Хабарівська вулиця	Хабарівська вулиця
Хабаровська вулиця	Хабаровська вулиця
Хабарська вулиця	Хабарська вулиця
Хаджибеївська вулиця	Хаджибеївська вулиця
Хаджибейська вулиця	Хаджибейська вулиця
Хаджибейська дорога	Хаджибейська дорога
Хайфонська вулиця	Хайфонська вулиця
Хакаська вулиця	Хакаська вулиця
Халимонівська вулиця	Халимонівська вулиця
Халхінгольська вулиця	Халхінгольська вулиця
Ханойська вулиця	Ханойська вулиця
Харківська вулиця	Харківська вулиця
Харківська набережна	Харківська набережна
Харківська площа	Харківська площа
Харлампіївська вулиця	Харлампіївська вулиця
Харцизська вулиця	Харцизська вулиця
Харьківська вулиця	Харьківська вулиця
Хасанівська вулиця	Хасанівська вулиця
Хасановська вулиця	Хасановська вулиця
Хасанська вулиця	Хасанська вулиця
Хатянівська вулиця	Хатянівська вулиця
Хацапетівська вулиця	Хацапетівська вулиця
Хворостянська вулиця	Хворостянська вулиця
Хемзівська вулиця	Хемзівська вулиця
Херсонська вулиця	Херсонська вулиця
Хизовська вулиця	Хизовська вулиця
Хирівська вулиця	Хирівська вулиця
Хитрунівська вулиця	Хитрунівська вулиця
Хичівська вулиця	Хичівська вулиця
Хібінська вулиця	Хібінська вулиця
Хлібодарська вулиця	Хлібодарська вулиця
Хлібозаводська вулиця	Хлібозаводська вулиця
Хлібопекарська вулиця	Хлібопекарська вулиця
Хліборобська вулиця	Хліборобська вулиця
Хмелівська вулиця	Хмелівська вулиця
Хмелянська вулиця	Хмелянська вулиця
Хмелярська вулиця	Хмелярська вулиця
Ходаківська вулиця	Ходаківська вулиця
Ходоранська вулиця	Ходоранська вулиця
Ходорівська вулиця	Ходорівська вулиця
Ходосівська вулиця	Ходосівська вулиця
Холмківська вулиця	Холмківська вулиця
Холмогоровська вулиця	Холмогоровська вулиця
Холмогорська вулиця	Холмогорська вулиця
Холмська вулиця	Холмська вулиця
Холмська площа	Холмська площа
Холоднівська вулиця	Холоднівська вулиця
Холодногірська вулиця	Холодногірська вулиця
Холодногірська площа	Холодногірська площа
Холодноярська вулиця	Холодноярська вулиця
Холопичівська вулиця	Холопичівська вулиця
Хомичівська вулиця	Хомичівська вулиця
Хомівська вулиця	Хомівська вулиця
Хомутовська вулиця	Хомутовська вулиця
Хомутянська вулиця	Хомутянська вулиця
Хоперська вулиця	Хоперська вулиця
Хорватська вулиця	Хорватська вулиця
Хорезмська вулиця	Хорезмська вулиця
Хорлівська вулиця	Хорлівська вулиця
Хорольська вулиця	Хорольська вулиця
Хоростківська вулиця	Хоростківська вулиця
Хортівська вулиця	Хортівська вулиця
Хостинська вулиця	Хостинська вулиця
Хотешівська вулиця	Хотешівська вулиця
Хотимирська вулиця	Хотимирська вулиця
Хотимська вулиця	Хотимська вулиця
Хотинська вулиця	Хотинська вулиця
Хотівська вулиця	Хотівська вулиця
Хотічинська вулиця	Хотічинська вулиця
Хотомлянська вулиця	Хотомлянська вулиця
Хотянівська вулиця	Хотянівська вулиця
Хохломська вулиця	Хохломська вулиця
Храпачанська вулиця	Храпачанська вулиця
Хресто-Воздвиженська вулиця	Хресто-Воздвиженська вулиця
Хрестовоздвиженська вулиця	Хрестовоздвиженська вулиця
Хрещатинська вулиця	Хрещатинська вулиця
Хриплинська вулиця	Хриплинська вулиця
Христичівська вулиця	Христичівська вулиця
Християнська вулиця	Християнська вулиця
Христофорівська вулиця	Христофорівська вулиця
Хромейська вулиця	Хромейська вулиця
Хустська вулиця	Хустська вулиця
Хутірська вулиця	Хутірська вулиця
Хуторська вулиця	Хуторська вулиця
Хуторянська вулиця	Хуторянська вулиця
Царичанська вулиця	Царичанська вулиця
Царська вулиця	Царська вулиця
Цвітківська вулиця	Цвітківська вулиця
Цебриківська вулиця	Цебриківська вулиця
Цегельно-Заводська вулиця	Цегельно-Заводська вулиця
Цегельнозаводська вулиця	Цегельнозаводська вулиця
Цеглянська вулиця	Цеглянська вулиця
Цегольнянська вулиця	Цегольнянська вулиця
Цемеська вулиця	Цемеська вулиця
Центральна (Ленінська)	Центральна (Ленінська)
Центрально-Міська вулиця	Центрально-Міська вулиця
Центральнозаводська вулиця	Центральнозаводська вулиця
Цепківська вулиця	Цепківська вулиця
Церковянська вулиця	Церковянська вулиця
Цехівська вулиця	Цехівська вулиця
Цецинська вулиця	Цецинська вулиця
Циберманівська вулиця	Циберманівська вулиця
Цибулівська вулиця	Цибулівська вулиця
Цибульська вулиця	Цибульська вулиця
Циганівська вулиця	Циганівська вулиця
Циганська вулиця	Циганська вулиця
Циглерівська вулиця	Циглерівська вулиця
Циківська вулиця	Циківська вулиця
Цимбалівська вулиця	Цимбалівська вулиця
Цимлянська вулиця	Цимлянська вулиця
Цирська вулиця	Цирська вулиця
Цитівська вулиця	Цитівська вулиця
Цілиноградська вулиця	Цілиноградська вулиця
Цукрозаводська вулиця	Цукрозаводська вулиця
Цусімська вулиця	Цусімська вулиця
Цюрупинська вулиця	Цюрупинська вулиця
Чабанівська вулиця	Чабанівська вулиця
Чагрівська дорога	Чагрівська дорога
Чайківська вулиця	Чайківська вулиця
Чайковська вулиця	Чайковська вулиця
Чалунівська вулиця	Чалунівська вулиця
Чапаєвська вулиця	Чапаєвська вулиця
Чапельська вулиця	Чапельська вулиця
Чаплинська вулиця	Чаплинська вулиця
Чаплищанська вулиця	Чаплищанська вулиця
Чапліївська вулиця	Чапліївська вулиця
Часов-Ярська вулиця	Часов-Ярська вулиця
Часов'ярська вулиця	Часовʼярська вулиця
Чебоксарська вулиця	Чебоксарська вулиця
Челябінська вулиця	Челябінська вулиця
Чемпіонська вулиця	Чемпіонська вулиця
Червінська вулиця	Червінська вулиця
Червонівська вулиця	Червонівська вулиця
Червоно-Армійська вулиця	Червоно-Армійська вулиця
Червоноармійська вулиця	Червоноармійська вулиця
Червоноармiйська вулиця	Червоноармiйська вулиця
Червонобаварська вулиця	Червонобаварська вулиця
Червонобогатирська вулиця	Червонобогатирська вулиця
Червоногвардійська вулиця	Червоногвардійська вулиця
Червоногірська вулиця	Червоногірська вулиця
Червоногородська вулиця	Червоногородська вулиця
Червоноградська вулиця	Червоноградська вулиця
Червонозаводська вулиця	Червонозаводська вулиця
Червонозірська вулиця	Червонозірська вулиця
Червонозорівська вулиця	Червонозорівська вулиця
Червонозорянська вулиця	Червонозорянська вулиця
Червонолиманська вулиця	Червонолиманська вулиця
Червононоармійська вулиця	Червононоармійська вулиця
Червонопартизанська вулиця	Червонопартизанська вулиця
Червонопільська вулиця	Червонопільська вулиця
Червонополянська вулиця	Червонополянська вулиця
Червонопостівська вулиця	Червонопостівська вулиця
Червонопресненська вулиця	Червонопресненська вулиця
Червоноранківська вулиця	Червоноранківська вулиця
Червоносільська вулиця	Червоносільська вулиця
Червоностудентська вулиця	Червоностудентська вулиця
Червонофлотська вулиця	Червонофлотська вулиця
Червонохолмська вулиця	Червонохолмська вулиця
Червонохрестівська вулиця	Червонохрестівська вулиця
Червонохутірська вулиця	Червонохутірська вулиця
Червонянська вулиця	Червонянська вулиця
Чередниченківська вулиця	Чередниченківська вулиця
Черемоська вулиця	Черемоська вулиця
Черемошська вулиця	Черемошська вулиця
Черемхівська вулиця	Черемхівська вулиця
Черепівська вулиця	Черепівська вулиця
Черетейська вулиця	Черетейська вулиця
Черкаська вулиця	Черкаська вулиця
Черкаська дамба	Черкаська дамба
Черлянська вулиця	Черлянська вулиця
Черненська вулиця	Черненська вулиця
Чернечанська вулиця	Чернечанська вулиця
Чернигівська вулиця	Чернигівська вулиця
Чернинська вулиця	Чернинська вулиця
Чернинська дорога	Чернинська дорога
Черничківська вулиця	Черничківська вулиця
Чернишевська вулиця	Чернишевська вулиця
Чернігівська вулиця	Чернігівська вулиця
Чернігівська площа	Чернігівська площа
Черніївська вулиця	Черніївська вулиця
Черновська вулиця	Черновська вулиця
Черноморська вулиця	Черноморська вулиця
Черняківська вулиця	Черняківська вулиця
Чернятинська вулиця	Чернятинська вулиця
Черняхівська вулиця	Черняхівська вулиця
Черняховська вулиця	Черняховська вулиця
Чесанівська вулиця	Чесанівська вулиця
Чеська вулиця	Чеська вулиця
Чечелівська вулиця	Чечелівська вулиця
Чеченська вулиця	Чеченська вулиця
Чиатурська вулиця	Чиатурська вулиця
Чигиринська вулиця	Чигиринська вулиця
Чизайська вулиця	Чизайська вулиця
Чинадіївська вулиця	Чинадіївська вулиця
Чистоводська вулиця	Чистоводська вулиця
Чистоклітівська вулиця	Чистоклітівська вулиця
Чистопільська вулиця	Чистопільська вулиця
Чистопольська вулиця	Чистопольська вулиця
Чистяківська вулиця	Чистяківська вулиця
Читинська вулиця	Читинська вулиця
Чіатурська вулиця	Чіатурська вулиця
Чізайська вулиця	Чізайська вулиця
Чмелівська вулиця	Чмелівська вулиця
Чоботарська вулиця	Чоботарська вулиця
Чолівська вулиця	Чолівська вулиця
Чонгарська вулиця	Чонгарська вулиця
Чонгорська вулиця	Чонгорська вулиця
Чонкашська вулиця	Чонкашська вулиця
Чопівська вулиця	Чопівська вулиця
Чопська вулиця	Чопська вулиця
Чорнобаївська вулиця	Чорнобаївська вулиця
Чорнобаївська дорога	Чорнобаївська дорога
Чорнобаївська площа	Чорнобаївська площа
Чорнобильська вулиця	Чорнобильська вулиця
Чорновірська вулиця	Чорновірська вулиця
Чорногірська вулиця	Чорногірська вулиця
Чорноглазівська вулиця	Чорноглазівська вулиця
Чорногорівська вулиця	Чорногорівська вулиця
Чорногорська вулиця	Чорногорська вулиця
Чорногорянська вулиця	Чорногорянська вулиця
Чорногузівська вулиця	Чорногузівська вулиця
Чорноліська вулиця	Чорноліська вулиця
Чорноморівська вулиця	Чорноморівська вулиця
Чорноморська вулиця	Чорноморська вулиця
Чорноморська дорога	Чорноморська дорога
Чорноострівська вулиця	Чорноострівська вулиця
Чорнухинська вулиця	Чорнухинська вулиця
Чортківська вулиця	Чортківська вулиця
Чорторийська вулиця	Чорторийська вулиця
Чубаївська вулиця	Чубаївська вулиця
Чубарівська вулиця	Чубарівська вулиця
Чуваська вулиця	Чуваська вулиця
Чугуєвська вулиця	Чугуєвська вулиця
Чугуївська вулиця	Чугуївська вулиця
Чудейська вулиця	Чудейська вулиця
Чуднівська вулиця	Чуднівська вулиця
Чудська вулиця	Чудська вулиця
Чуїшанська вулиця	Чуїшанська вулиця
Чуйківська вулиця	Чуйківська вулиця
Чукотська вулиця	Чукотська вулиця
Чумаківська вулиця	Чумаківська вулиця
Чуніхінська вулиця	Чуніхінська вулиця
Чуперносівська вулиця	Чуперносівська вулиця
Чурилівська вулиця	Чурилівська вулиця
Чусовська вулиця	Чусовська вулиця
Чутівська вулиця	Чутівська вулиця
Чiгiрiнська вулиця	Чiгiрiнська вулиця
Шабельківська вулиця	Шабельківська вулиця
Шаболатська вулиця	Шаболатська вулиця
Шабська вулиця	Шабська вулиця
Шадринська вулиця	Шадринська вулиця
Шамівська вулиця	Шамівська вулиця
Шамраївська вулиця	Шамраївська вулиця
Шаргородська вулиця	Шаргородська вулиця
Шаріська вулиця	Шаріська вулиця
Шатилівська вулиця	Шатилівська вулиця
Шатрищанська вулиця	Шатрищанська вулиця
Шатурівська вулиця	Шатурівська вулиця
Шатурська вулиця	Шатурська вулиця
Шауляйська вулиця	Шауляйська вулиця
Шахівська вулиця	Шахівська вулиця
Шахтарська вулиця	Шахтарська вулиця
Шахтарська площа	Шахтарська площа
Шахтинська вулиця	Шахтинська вулиця
Шахтянська вулиця	Шахтянська вулиця
Шаянська вулиця	Шаянська вулиця
Швабівська вулиця	Швабівська вулиця
Швабська вулиця	Швабська вулиця
Шведська вулиця	Шведська вулиця
Швейцарська вулиця	Швейцарська вулиця
Шебелінська вулиця	Шебелінська вулиця
Шевська вулиця	Шевська вулиця
Шевченківська вулиця	Шевченківська вулиця
Шекерогринівська вулиця	Шекерогринівська вулиця
Шекінська вулиця	Шекінська вулиця
Шелелівська вулиця	Шелелівська вулиця
Шелестівська вулиця	Шелестівська вулиця
Шепарівська вулиця	Шепарівська вулиця
Шепелівська вулиця	Шепелівська вулиця
Шепетівська вулиця	Шепетівська вулиця
Шервудська вулиця	Шервудська вулиця
Шереметьєвська вулиця	Шереметьєвська вулиця
Шефська вулиця	Шефська вулиця
Шилівська вулиця	Шилівська вулиця
Шинкарська вулиця	Шинкарська вулиця
Шипинська вулиця	Шипинська вулиця
Широківська вулиця	Широківська вулиця
Широколанівська вулиця	Широколанівська вулиця
Широкомагерська вулиця	Широкомагерська вулиця
Шишкарівська вулиця	Шишкарівська вулиця
Шишківська вулиця	Шишківська вулиця
Шиянська вулиця	Шиянська вулиця
Шкіперська вулиця	Шкіперська вулиця
Шкурпелівська вулиця	Шкурпелівська вулиця
Шляхетська вулиця	Шляхетська вулиця
Шляхівська вулиця	Шляхівська вулиця
Шмаківська вулиця	Шмаківська вулиця
Шмаковська вулиця	Шмаковська вулиця
Шнурковська вулиця	Шнурковська вулиця
Шнурянська вулиця	Шнурянська вулиця
Шодуарівська вулиця	Шодуарівська вулиця
Шондолівська вулиця	Шондолівська вулиця
Шорниківська вулиця	Шорниківська вулиця
Шостинська вулиця	Шостинська вулиця
Шосткинська вулиця	Шосткинська вулиця
Шосткінська вулиця	Шосткінська вулиця
Шоферська вулиця	Шоферська вулиця
Шохладська вулиця	Шохладська вулиця
Шпаковська вулиця	Шпаковська вулиця
Шпанівська вулиця	Шпанівська вулиця
Шполянська вулиця	Шполянська вулиця
Штейгерська вулиця	Штейгерська вулиця
Штепівська вулиця	Штепівська вулиця
Штерівська вулиця	Штерівська вулиця
Штурманська вулиця	Штурманська вулиця
Шудрівська вулиця	Шудрівська вулиця
Шуйська вулиця	Шуйська вулиця
Шулявська вулиця	Шулявська вулиця
Шуменська вулиця	Шуменська вулиця
Шумиловська вулиця	Шумиловська вулиця
Шумовська вулиця	Шумовська вулиця
Шумська вулиця	Шумська вулиця
Шутуська вулиця	Шутуська вулиця
Шушенська вулиця	Шушенська вулиця
Шушинська вулиця	Шушинська вулиця
Щаснівська вулиця	Щаснівська вулиця
Щебзаводська вулиця	Щебзаводська вулиця
Щегловська вулиця	Щегловська вулиця
Щедерівська вулиця	Щедерівська вулиця
Щедринська вулиця	Щедринська вулиця
Щемилівська вулиця	Щемилівська вулиця
Щепкінська вулиця	Щепкінська вулиця
Щербаковська вулиця	Щербаковська вулиця
Щербинівська вулиця	Щербинівська вулиця
Щербівська вулиця	Щербівська вулиця
Щигрівська вулиця	Щигрівська вулиця
Щоголівська вулиця	Щоголівська вулиця
Щолківська вулиця	Щолківська вулиця
Эсхарівська вулиця	Эсхарівська вулиця
Югоковська вулиця	Югоковська вулиця
Югославська вулиця	Югославська вулиця
Южанська вулиця	Южанська вулиця
Юзвинська вулиця	Юзвинська вулиця
Юзефпільська вулиця	Юзефпільська вулиця
Юзівська вулиця	Юзівська вулиця
Юліанська вулиця	Юліанська вулиця
Юліївська вулиця	Юліївська вулиця
Юловська вулиця	Юловська вулиця
Юнаківська вулиця	Юнаківська вулиця
Юнговська вулиця	Юнговська вулиця
Юнокомунарівська вулиця	Юнокомунарівська вулиця
Юпітерська вулиця	Юпітерська вулиця
Юр'ївська вулиця	Юрʼївська вулиця
Юр’ївська вулиця	Юрʼївська вулиця
Юрасівська вулиця	Юрасівська вулиця
Юрисівська вулиця	Юрисівська вулиця
Юрівська вулиця	Юрівська вулиця
Юріївська вулиця	Юріївська вулиця
Юрківська вулиця	Юрківська вулиця
Юрʼївська вулиця	Юрʼївська вулиця
Яблунівська вулиця	Яблунівська вулиця
Яблунська вулиця	Яблунська вулиця
Яворівська вулиця	Яворівська вулиця
Ягеллонська вулиця	Ягеллонська вулиця
Яготинська вулиця	Яготинська вулиця
Ядлівська вулиця	Ядлівська вулиця
Якимівська вулиця	Якимівська вулиця
Яківчанська вулиця	Яківчанська вулиця
Яковлівська вулиця	Яковлівська вулиця
Якубовська вулиця	Якубовська вулиця
Якутська вулиця	Якутська вулиця
Ялинівська вулиця	Ялинівська вулиця
Ялинська вулиця	Ялинська вулиця
Ялтинська вулиця	Ялтинська вулиця
Ямальська вулиця	Ямальська вулиця
Ямбольська вулиця	Ямбольська вулиця
Ямгорівська вулиця	Ямгорівська вулиця
Ямиська вулиця	Ямиська вулиця
Ямківська вулиця	Ямківська вулиця
Ямпільська вулиця	Ямпільська вулиця
Ямпольська вулиця	Ямпольська вулиця
Ямська вулиця	Ямська вулиця
Янівська вулиця	Янівська вулиця
Янісольська вулиця	Янісольська вулиця
Японська вулиця	Японська вулиця
Яранська вулиця	Яранська вулиця
Яризівська вулиця	Яризівська вулиця
Ярифонівська вулиця	Ярифонівська вулиця
Яричівська вулиця	Яричівська вулиця
Ярівська вулиця	Ярівська вулиця
Ярківська вулиця	Ярківська вулиця
Яровська вулиця	Яровська вулиця
Ярославська вулиця	Ярославська вулиця
Ярочинська вулиця	Ярочинська вулиця
Ярошенківська вулиця	Ярошенківська вулиця
Ярошівська вулиця	Ярошівська вулиця
Ярська вулиця	Ярська вулиця
Яруська вулиця	Яруська вулиця
Ярцевська вулиця	Ярцевська вулиця
Ясберенська вулиця	Ясберенська вулиця
Ясенівківська вулиця	Ясенівківська вулиця
Ясенівська вулиця	Ясенівська вулиця
Ясенська вулиця	Ясенська вулиця
Ясинуватська вулиця	Ясинуватська вулиця
Яслинська вулиця	Яслинська вулиця
Ясногірська вулиця	Ясногірська вулиця
Яснополянська вулиця	Яснополянська вулиця
Ясська вулиця	Ясська вулиця
Ястремська вулиця	Ястремська вулиця
Яструбівська вулиця	Яструбівська вулиця
Яськівська вулиця	Яськівська вулиця
Яхненківська вулиця	Яхненківська вулиця
Яхнянська вулиця	Яхнянська вулиця
Яцевська вулиця	Яцевська вулиця
Яцівська вулиця	Яцівська вулиця
Cлобожанська вулиця	Cлобожанська вулиця
Cнітинська вулиця	Cнітинська вулиця
Cтепанівська вулиця	Cтепанівська вулиця
Iсполкомовська вулиця	Iсполкомовська вулиця