Автоматний в’їзд	Автоматний вʼїзд
Автоматний проїзд	Автоматний проїзд
Авторемонтна вулиця	Авторемонтна вулиця
Авторемонтний провулок	Авторемонтний провулок
Автотранспортна вулиця	Автотранспортна вулиця
Агрегатна вулиця	Агрегатна вулиця
Аеропортна вулиця	Аеропортна вулиця
Аеропортний в’їзд	Аеропортний вʼїзд
Аеропортний провулок	Аеропортний провулок
Азотна вулиця	Азотна вулиця
Алітна вулиця	Алітна вулиця
Алфавітний провулок	Алфавітний провулок
Антрацитна вулиця	Антрацитна вулиця
Асфальтна вулиця	Асфальтна вулиця
Асфальтний провулок	Асфальтний провулок
Баластна вулиця	Баластна вулиця
Бісквітний провулок	Бісквітний провулок
Благовістна вулиця	Благовістна вулиця
Благодатна вулиця	Благодатна вулиця
Благодатний провулок	Благодатний провулок
Блакитна вулиця	Блакитна вулиця
Блакитний провулок	Блакитний провулок
Болотна вулиця	Болотна вулиця
Болотний провулок	Болотний провулок
Брикетна вулиця	Брикетна вулиця
Брикетний провулок	Брикетний провулок
Букетна вулиця	Букетна вулиця
в'їзд Транспортний ІІ	2-й Транспортний вʼїзд
Верстатна вулиця	Верстатна вулиця
Верстатний провулок	Верстатний провулок
Вертолітна вулиця	Вертолітна вулиця
Взлітна вулиця	Взлітна вулиця
Вилітна вулиця	Вилітна вулиця
Високовольтна вулиця	Високовольтна вулиця
Високовольтний провулок	Високовольтний провулок
Високовольтний проїзд	Високовольтний проїзд
Висотна вулиця	Висотна вулиця
Висотний провулок	Висотний провулок
Водлосвятний провулок	Водлосвятний провулок
Водовертна вулиця	Водовертна вулиця
Волостна вулиця	Волостна вулиця
Газетна вулиця	Газетна вулиця
Газетний провулок	Газетний провулок
Гарматна вулиця	Гарматна вулиця
Гарматний провулок	Гарматний провулок
Гатна вулиця	Гатна вулиця
Гіпрошахтна вулиця	Гіпрошахтна вулиця
Глиноцементна вулиця	Глиноцементна вулиця
Гранатна вулиця	Гранатна вулиця
Гранатний провулок	Гранатний провулок
Гранітна вулиця	Гранітна вулиця
Гранітний провулок	Гранітний провулок
Графітна вулиця	Графітна вулиця
Дебютна вулиця	Дебютна вулиця
Десантна вулиця	Десантна вулиця
Десантний бульвар	Десантний бульвар
Десантний провулок	Десантний провулок
Динамітна вулиця	Динамітна вулиця
Діамантна вулиця	Діамантна вулиця
Добробутна вулиця	Добробутна вулиця
Доломітна вулиця	Доломітна вулиця
Електроапаратна вулиця	Електроапаратна вулиця
Елітна вулиця	Елітна вулиця
Елітний в'їзд	Елітний вʼїзд
Елітний в’їзд	Елітний вʼїзд
Естафетна вулиця	Естафетна вулиця
Житний Яр	Житний Яр
Жовтоблакитна вулиця	Жовтоблакитна вулиця
Заболотна вулиця	Заболотна вулиця
Заболотний провулок	Заболотний провулок
Заветна вулиця	Заветна вулиця
Завєтний провулок	Завєтний провулок
Завітний провулок	Завітний провулок
Заповітна вулиця	Заповітна вулиця
Заповітний провулок	Заповітний провулок
Зенітна вулиця	Зенітна вулиця
Зенітний провулок	Зенітний провулок
Зенітний проїзд	Зенітний проїзд
Злітна вулиця	Злітна вулиця
Злітний провулок	Злітний провулок
Зльотна вулиця	Зльотна вулиця
Знатна вулиця	Знатна вулиця
ІІ-Високовольтна вулиця	2-га Високовольтна вулиця
Інтелігентний провулок	Інтелігентний провулок
Інтернатна вулиця	Інтернатна вулиця
Кагатна вулиця	Кагатна вулиця
Кагатний провулок	Кагатний провулок
Каретна вулиця	Каретна вулиця
Каретний провулок	Каретний провулок
Кварцитний провулок	Кварцитний провулок
Квітна вулиця	Квітна вулиця
Колоритна вулиця	Колоритна вулиця
Комбінатна вулиця	Комбінатна вулиця
Конопатна вулиця	Конопатна вулиця
Концертна вулиця	Концертна вулиця
Косокутний провулок	Косокутний провулок
Кредитний провулок	Кредитний провулок
Кулеметний провулок	Кулеметний провулок
Курортна вулиця	Курортна вулиця
Курортний провулок	Курортний провулок
Курортний провулокь	Курортний провулокь
Курортний проїзд	Курортний проїзд
Курортний проспект	Курортний проспект
Кутна вулиця	Кутна вулиця
Лазаретна вулиця	Лазаретна вулиця
Ландшафтна вулиця	Ландшафтна вулиця
Ландшафтний провулок	Ландшафтний провулок
Листопрокатна вулиця	Листопрокатна вулиця
Літна вулиця	Літна вулиця
Льотна вулиця	Льотна вулиця
Льотний провулок	Льотний провулок
М’ятна вулиця	Мʼятна вулиця
Магнітна вулиця	Магнітна вулиця
Маршрутна вулиця	Маршрутна вулиця
Метеоритна вулиця	Метеоритна вулиця
Метеоритний провулок	Метеоритний провулок
Мечетна вулиця	Мечетна вулиця
Митна вулиця	Митна вулиця
Митна площа	Митна площа
Митний провулок	Митний провулок
Митний термінал	Митний термінал
Міжболотна вулиця	Міжболотна вулиця
Міжпланетна вулиця	Міжпланетна вулиця
Мінометна вулиця	Мінометна вулиця
Монолітна вулиця	Монолітна вулиця
Монолітний провулок	Монолітний провулок
Мотоциклетний завод	Мотоциклетний завод
Мускатна вулиця	Мускатна вулиця
Надсеретна вулиця	Надсеретна вулиця
Новопроектна вулиця	Новопроектна вулиця
Новоракитна вулиця	Новоракитна вулиця
Новошахтна вулиця	Новошахтна вулиця
Озерно-болотна вулиця	Озерно-болотна вулиця
Оксамитний провулок	Оксамитний провулок
Опитна вулиця	Опитна вулиця
Орбітна вулиця	Орбітна вулиця
Орбітний провулок	Орбітний провулок
Очеретна вулиця	Очеретна вулиця
Очеретний вулиця	Очеретний вулиця
Очеретний провулок	Очеретний провулок
П'ятихатна вулиця	Пʼятихатна вулиця
П’ятикутний провулок	Пʼятикутний провулок
Пам’ятна вулиця	Памʼятна вулиця
Пам’ятний провулок	Памʼятний провулок
Пансіонатна вулиця	Пансіонатна вулиця
Папоротна вулиця	Папоротна вулиця
Парашутна вулиця	Парашутна вулиця
Парашутний провулок	Парашутний провулок
Парашутний проїзд	Парашутний проїзд
Парашютний провулок	Парашютний провулок
Первоцвітна вулиця	Первоцвітна вулиця
Передмістний провулок	Передмістний провулок
Перелітна вулиця	Перелітна вулиця
Південнопроектна вулиця	Південнопроектна вулиця
Пілотна вулиця	Пілотна вулиця
Піхотна вулиця	Піхотна вулиця
Піхотний провулок	Піхотний провулок
Планетна вулиця	Планетна вулиця
Поворотна вулиця	Поворотна вулиця
Поворотний провулок	Поворотний провулок
Приватна вулиця	Приватна вулиця
Привітна вулиця	Привітна вулиця
Привітний провулок	Привітний провулок
Привітний тупик	Привітний тупик
Проектна бічна вулиця	Проектна бічна вулиця
Проектна вулиця	Проектна вулиця
Проектна концесійна дорога	Проектна концесійна дорога
Проектний бульвар	Проектний бульвар
Проектний в’їзд	Проектний вʼїзд
Проектний провулок	Проектний провулок
Проєктна бічна вулиця	Проєктна бічна вулиця
Проєктна вулиця	Проєктна вулиця
Прокатна вулиця	Прокатна вулиця
Прокатний провулок	Прокатний провулок
Проспектна вулиця	Проспектна вулиця
Проспектний провулок	Проспектний провулок
Прямокутний провулок	Прямокутний провулок
Ракетна вулиця	Ракетна вулиця
Ракетний провулок	Ракетний провулок
Ракетний проїзд	Ракетний проїзд
Ракитна вулиця	Ракитна вулиця
Ракитний провулок	Ракитний провулок
Ранетна вулиця	Ранетна вулиця
Ратна вулиця	Ратна вулиця
Редутна вулиця	Редутна вулиця
Редутний провулок	Редутний провулок
Ремонтна вулиця	Ремонтна вулиця
Ремонтний провулок	Ремонтний провулок
Рокитна вулиця	Рокитна вулиця
Рокитний провулок	Рокитний провулок
Ротна вулиця	Ротна вулиця
Ротний провулок	Ротний провулок
Ртутна вулиця	Ртутна вулиця
Рудоремонтна вулиця	Рудоремонтна вулиця
Салютна вулиця	Салютна вулиця
Салютний провулок	Салютний провулок
Самоцвітна вулиця	Самоцвітна вулиця
Самоцітна вулиця	Самоцітна вулиця
Селікатна вулиця	Селікатна вулиця
Силікальцитний провулок	Силікальцитний провулок
Силікатна вулиця	Силікатна вулиця
Силікатний провулок	Силікатний провулок
Сілікатна вулиця	Сілікатна вулиця
Скітна вулиця	Скітна вулиця
Славетна вулиця	Славетна вулиця
Славетний провулок	Славетний провулок
Сталепрокатна вулиця	Сталепрокатна вулиця
Стандартна вулиця	Стандартна вулиця
Стандартний городок квартал	Стандартний городок квартал
Стандартний провулок	Стандартний провулок
Судноремонтний провулок	Судноремонтний провулок
Судоремонтна вулиця	Судоремонтна вулиця
Судоремонтний провулок	Судоремонтний провулок
Суперфосфатна вулиця	Суперфосфатна вулиця
Транзитна вулиця	Транзитна вулиця
Транзитний провулок	Транзитний провулок
Транзітна вулиця	Транзітна вулиця
транспортна бічна	транспортна бічна
Транспортна вулиця	Транспортна вулиця
Транспортна вулшиця	Транспортна вулшиця
Транспортний в'їзд	Транспортний вʼїзд
Транспортний в’їзд	Транспортний вʼїзд
Транспортний провулок	Транспортний провулок
Транспортний проїзд	Транспортний проїзд
Трикутна вулиця	Трикутна вулиця
Трикутний провулок	Трикутний провулок
Трубопрокатна вулиця	Трубопрокатна вулиця
Уютна вулиця	Уютна вулиця
Уютний провулок	Уютний провулок
Форпостна вулиця	Форпостна вулиця
Фосфоритна вулиця	Фосфоритна вулиця
Фрегатний провулок	Фрегатний провулок
Цвітна вулиця	Цвітна вулиця
Цвітний провулок	Цвітний провулок
Цементна вулиця	Цементна вулиця
Цементний провулок	Цементний провулок
Червонохрестна вулиця	Червонохрестна вулиця
Шамотна вулиця	Шамотна вулиця
Шахтна вулиця	Шахтна вулиця
Шахтний провулок	Шахтний провулок
Шдяхетний провулок	Шдяхетний провулок
Шляхетна вулиця	Шляхетна вулиця