Абрамцева вулиця	Абрамцева вулиця
Абрамцева провулок	Абрамцева провулок
Аличева вулиця	Аличева вулиця
Алябушева вулиця	Алябушева вулиця
Арсеничева вулиця	Арсеничева вулиця
Арсенічева вулиця	Арсенічева вулиця
Арсеньева вулиця	Арсеньева вулиця
Багачева вулиця	Багачева вулиця
Бакулева вулиця	Бакулева вулиця
Балашева вулиця	Балашева вулиця
Баренцева вулиця	Баренцева вулиця
Баришева вулиця	Баришева вулиця
Батищева вулиця	Батищева вулиця
Бахчева вулиця	Бахчева вулиця
Бежева вулиця	Бежева вулиця
Безпальчева вулиця	Безпальчева вулиця
Березнева вулиця	Березнева вулиця
Березневий провулок	Березневий провулок
Березневий проїзд	Березневий проїзд
Береневий провулок	Береневий провулок
Бєстужева вулиця	Бєстужева вулиця
Бійцева вулиця	Бійцева вулиця
Білозерцева провулок	Білозерцева провулок
Білоярцева вулиця	Білоярцева вулиця
Болдусева вулиця	Болдусева вулиця
Бородачева вулиця	Бородачева вулиця
Бровичева вулиця	Бровичева вулиця
Булкішева вулиця	Булкішева вулиця
Вахрушева вулиця	Вахрушева вулиця
Вашева вулиця	Вашева вулиця
Вашева провулок	Вашева провулок
Веденічева вулиця	Веденічева вулиця
Веденічева провулок	Веденічева провулок
Велика Кільцева вулиця	Велика Кільцева вулиця
Велика Кільцева дорога	Велика Кільцева дорога
Вереснева вулиця	Вереснева вулиця
Вереснева площа	Вереснева площа
Вересневий в'їзд	Вересневий вʼїзд
Вересневий провулок	Вересневий провулок
Вересневий проїзд	Вересневий проїзд
Вишева вулиця	Вишева вулиця
Вишнева (Жовтнева) вулиця	Вишнева (Жовтнева) вулиця
Вишнева вулиця	Вишнева вулиця
Вишнева долина вулиця	Вишнева долина вулиця
Вишневавулиця	Вишнева вулиця
Вишневий в'їзд	Вишневий вʼїзд
Вишневий в’їзд	Вишневий вʼїзд
Вишневий провулок	Вишневий провулок
Вишневий провулокц	Вишневий провулокц
Вишневий проїзд	Вишневий проїзд
Вишневий проспект	Вишневий проспект
Вишневий сад	Вишневий сад
Вишневий Сад проїзд	Вишневий Сад проїзд
Вишневий тупик	Вишневий тупик
Вишневий узвіз	Вишневий узвіз
Вічева вулиця	Вічева вулиця
Вічева площа	Вічева площа
Вічевий майдан	Вічевий майдан
Вічевий Майдан вулиця	Вічевий Майдан вулиця
Вічевий Майдан площа	Вічевий Майдан площа
Вогнева вулиця	Вогнева вулиця
Вогневий провулок	Вогневий провулок
Галафеева вулиця	Галафеева вулиця
Галузевий проїзд	Галузевий проїзд
Ганцева вулиця	Ганцева вулиця
Гацева вулиця	Гацева вулиця
Генерала Казарцева вулиця	Генерала Казарцева вулиця
Генерала Кунгурцева вулиця	Генерала Кунгурцева вулиця
Генерала Родімцева вулиця	Генерала Родімцева вулиця
Гетьманцева вулиця	Гетьманцева вулиця
Годуванцева вулиця	Годуванцева вулиця
Грачунева вулиця	Грачунева вулиця
Груднева вулиця	Груднева вулиця
Грудневий провулок	Грудневий провулок
Грушева вулиця	Грушева вулиця
Грушевий провулок	Грушевий провулок
Грушевий проїзд	Грушевий проїзд
Грушевий тупик	Грушевий тупик
Гулева вулиця	Гулева вулиця
Дадашева вулиця	Дадашева вулиця
Двірцева вулиця	Двірцева вулиця
Двірцева площа	Двірцева площа
Дворцева вулиця	Дворцева вулиця
Дежнева вулиця	Дежнева вулиця
Дикопольцева вулиця	Дикопольцева вулиця
Дойчева вулиця	Дойчева вулиця
Докучаева вулиця	Докучаева вулиця
Дощева вулиця	Дощева вулиця
Дранева вулиця	Дранева вулиця
Емалевий провулок	Емалевий провулок
Жовтева вулиця	Жовтева вулиця
Жовтнева вулиця	Жовтнева вулиця
Жовтнева площа	Жовтнева площа
Жовтневий в’їзд	Жовтневий вʼїзд
Жовтневий мікрорайон	Жовтневий мікрорайон
Жовтневий провулок	Жовтневий провулок
Жовтневий проїзд	Жовтневий проїзд
Жовтневий проспект	Жовтневий проспект
Жовтневий ghjdekjr	Жовтневий проспект
Жoвтнева вулиця	Жовтнева вулиця
Замісцева вулиця	Замісцева вулиця
Заоева вулиця	Заоева вулиця
Запорізьсталева вулиця	Запорізьсталева вулиця
Західно-кільцева вулиця	Західно-кільцева вулиця
Збіжева вулиця	Збіжева вулиця
Здвижевий провулок	Здвижевий провулок
Здоровцева вулиця	Здоровцева вулиця
Зінцева балка вулиця	Зінцева балка вулиця
Зінцевий спуск	Зінцевий спуск
Зорева вулиця	Зорева вулиця
Ігорева вулиця	Ігорева вулиця
Іі Першотравневий провулок	2-й Першотравневий провулок
ІІ Першотравневий провулок	2-й Першотравневий провулок
Іноземцева вулиця	Іноземцева вулиця
Казарцева вулиця	Казарцева вулиця
Калинева вулиця	Калинева вулиця
Камишева вулиця	Камишева вулиця
Каніщева вулиця	Каніщева вулиця
Кварцева вулиця	Кварцева вулиця
Квітенева вулиця	Квітенева вулиця
Квітнева вулиця	Квітнева вулиця
Квітневий провулок	Квітневий провулок
Квітневий проїзд	Квітневий проїзд
Квітневий проспект	Квітневий проспект
Квiтнева вулиця	Квітнева вулиця
Киснева вулиця	Киснева вулиця
Кільцева вулиця	Кільцева вулиця
Кільцева дорога	Кільцева дорога
Кільцевий провулок	Кільцевий провулок
Кільцевий проїзд	Кільцевий проїзд
Кільцевий шлях	Кільцевий шлях
Кінцева вулиця	Кінцева вулиця
Кінцевий провулок	Кінцевий провулок
Клементія Тімірязева вулиця	Клементія Тімірязева вулиця
Ключева вулиця	Ключева вулиця
Князева вулиця	Князева вулиця
Кобзарева вулиця	Кобзарева вулиця
Кобзаревий провулок	Кобзаревий провулок
Количева вулиця	Количева вулиця
Колокольцева вулиця	Колокольцева вулиця
Кольцева вулиця	Кольцева вулиця
Компанцева вулиця	Компанцева вулиця
Кондарева вулиця	Кондарева вулиця
Конева вулиця	Конева вулиця
Коняева вулиця	Коняева вулиця
Краснодонцева вулиця	Краснодонцева вулиця
Кременева вулиця	Кременева вулиця
Кремневий провулок	Кремневий провулок
Кришталева вулиця	Кришталева вулиця
Кришталевий провулок	Кришталевий провулок
Кувашева вулиця	Кувашева вулиця
Куйбашева вулиця	Куйбашева вулиця
Кульчева вулиця	Кульчева вулиця
Купилева вулиця	Купилева вулиця
Кухарева вулиця	Кухарева вулиця
Лаврищева вулиця	Лаврищева вулиця
Лавріщева вулиця	Лавріщева вулиця
Лазнева вулиця	Лазнева вулиця
Лазневий провулок	Лазневий провулок
Лемешева вулиця	Лемешева вулиця
Лемешева провулок	Лемешева провулок
Ливневий провулок	Ливневий провулок
Липнева вулиця	Липнева вулиця
Липнева площа	Липнева площа
Липневий провулок	Липневий провулок
Липневий проїзд	Липневий проїзд
Лучева вулиця	Лучева вулиця
Лютнева вулиця	Лютнева вулиця
Лютневий провулок	Лютневий провулок
Лютневий проїзд	Лютневий проїзд
Мала Кільцева вулиця	Мала Кільцева вулиця
Марганцева вулиця	Марганцева вулиця
Маресьева вулиця	Маресьева вулиця
Меблева вулиця	Меблева вулиця
Меблевий провулок	Меблевий провулок
Межева вулиця	Межева вулиця
Межевий провулок	Межевий провулок
Межевий проїзд	Межевий проїзд
Мікушева вулиця	Мікушева вулиця
Місцева вулиця	Місцева вулиця
Місцевий провулок	Місцевий провулок
Мукачева вулиця	Мукачева вулиця
Мякішева вулиця	Мякішева вулиця
Назарева вулиця	Назарева вулиця
Нікішева вулиця	Нікішева вулиця
Ніколаева вулиця	Ніколаева вулиця
Новодесятисажнева вулиця	Новодесятисажнева вулиця
Новожовтнева вулиця	Новожовтнева вулиця
Новосічнева вулиця	Новосічнева вулиця
Обочева вулиця	Обочева вулиця
Обручева вулиця	Обручева вулиця
Овочева вулиця	Овочева вулиця
Овочевий в'їзд	Овочевий вʼїзд
Овочевий провулок	Овочевий провулок
Овочевий проїзд	Овочевий проїзд
Огнева вулиця	Огнева вулиця
Оранжева вулиця	Оранжева вулиця
Переславцева вулиця	Переславцева вулиця
Першеравнева вулиця	Першеравнева вулиця
першотравнева вулиця	першотравнева вулиця
Першотравнева вулиця	Першотравнева вулиця
Першотравнева провулок	Першотравнева провулок
Першотравнева dekbwz	Першотравнева вулиця
Першотравневий в’їзд	Першотравневий вʼїзд
Першотравневий вулиця	Першотравневий вулиця
Першотравневий провулок	Першотравневий провулок
Першотравневий проїзд	Першотравневий проїзд
Першотравневий проспект	Першотравневий проспект
Першотравневий тупик	Першотравневий тупик
Першотрванева вулиця	Першотрванева вулиця
Південна кільцева вулиця	Південна кільцева вулиця
Південно-кільцева вулиця	Південно-кільцева вулиця
Південно-Кільцева вулиця	Південно-Кільцева вулиця
Північно-кільцева вулиця	Північно-кільцева вулиця
Північно-Кільцева вулиця	Північно-Кільцева вулиця
Плавнева вулиця	Плавнева вулиця
Плавневий провулок	Плавневий провулок
Покасева вулиця	Покасева вулиця
Покасевий провулок	Покасевий провулок
Покришева вулиця	Покришева вулиця
Покришева провулок	Покришева провулок
Полежаева вулиця	Полежаева вулиця
Полуднева вулиця	Полуднева вулиця
Помаранчева вулиця	Помаранчева вулиця
Помаранчевий провулок	Помаранчевий провулок
Потишева вулиця	Потишева вулиця
Променева вулиця	Променева вулиця
Променевий провулок	Променевий провулок
Промінева вулиця	Промінева вулиця
Пугачева вулиця	Пугачева вулиця
Путева вулиця	Путева вулиця
Путінцева вулиця	Путінцева вулиця
Равнялічева вулиця	Равнялічева вулиця
Радіщева вулиця	Радіщева вулиця
Радіщева провулок	Радіщева провулок
Рожева вулиця	Рожева вулиця
Рожевий провулок	Рожевий провулок
Рожевий проїзд	Рожевий проїзд
Росева вулиця	Росева вулиця
Рощева вулиця	Рощева вулиця
Руднева вулиця	Руднева вулиця
Рулевий провулок	Рулевий провулок
Рум’янцева вулиця	Румʼянцева вулиця
Рум’янцева провулок	Румʼянцева провулок
Сбежнева вулиця	Сбежнева вулиця
Светочева вулиця	Светочева вулиця
Сергеева - Ценского	Сергеева - Ценского
Серпнева вулиця	Серпнева вулиця
Серпневий провулок	Серпневий провулок
Сибірцева вулиця	Сибірцева вулиця
Сизранцева вулиця	Сизранцева вулиця
Сизранцева провулок	Сизранцева провулок
Симбірцева вулиця	Симбірцева вулиця
Сиренева вулиця	Сиренева вулиця
Січева вулиця	Січева вулиця
Січнева вулиця	Січнева вулиця
Січневий провулок	Січневий провулок
Скелева вулиця	Скелева вулиця
Скобєлева провулок	Скобєлева провулок
Сланцева вулиця	Сланцева вулиця
Слепнева вулиця	Слепнева вулиця
Сталева вулиця	Сталева вулиця
Сталевий провулок	Сталевий провулок
Стародесятисажнева вулиця	Стародесятисажнева вулиця
Староторцева вулиця	Староторцева вулиця
Сущева вулиця	Сущева вулиця
Східно-кільцева вулиця	Східно-Кільцева вулиця
Сiчнева вулиця	Січнева вулиця
Танева вулиця	Танева вулиця
Темерязева вулиця	Темерязева вулиця
Терпигорева вулиця	Терпигорева вулиця
Терпигорева провулок	Терпигорева провулок
Тетерева вулиця	Тетерева вулиця
Тимирязева вулиця	Тимирязева вулиця
Тимірязева вулиця	Тимірязева вулиця
Тімірязева вулиця	Тімірязева вулиця
Тімірязева провулок	Тімірязева провулок
Тополева вулиця	Тополева вулиця
Тополевий провулок	Тополевий провулок
Травнева вул.	Травнева вул.
Травнева вулиця	Травнева вулиця
Травневий в'їзд	Травневий вʼїзд
Травневий в’їзд	Травневий вʼїзд
Травневий провулок	Травневий провулок
Травневий проїзд	Травневий проїзд
Туполева вулиця	Туполева вулиця
Туполечева вулиця	Туполечева вулиця
Тургенева вулиця	Тургенева вулиця
Тхагушева вул.	вулиця Тхагушева
Ушева вулиця	Ушева вулиця
Федева вулиця	Федева вулиця
Францева вулиця	Францева вулиця
Хмелева вулиця	Хмелева вулиця
Ходарева вулиця	Ходарева вулиця
Хорошева провулок	Хорошева провулок
Хруничева вулиця	Хруничева вулиця
Хрунічева вулиця	Хрунічева вулиця
Чапаева вулиця	Чапаева вулиця
Чебишева вулиця	Чебишева вулиця
Чебишева провулок	Чебишева провулок
Чебрецева вулиця	Чебрецева вулиця
Червнева вулиця	Червнева вулиця
Червневий провулок	Червневий провулок
Червоножовтнева вулиця	Червоножовтнева вулиця
Червоножовтневий провулок	Червоножовтневий провулок
Червонотравнева вулиця	Червонотравнева вулиця
Черешнева вулиця	Черешнева вулиця
Черешневий провулок	Черешневий провулок
Шаховцева вулиця	Шаховцева вулиця
Шаховцева провулок	Шаховцева провулок
Штевнева вулиця	Штевнева вулиця
Штевнева провулок	Штевнева провулок
Щусева провулок	Щусева провулок
Юмашева вулиця	Юмашева вулиця
Яблуева вулиця	Яблунева вулиця
Яблунева вулиця	Яблунева вулиця
Яблуневий в'їзд	Яблуневий вʼїзд
Яблуневий мікрорайон	Яблуневий мікрорайон
Яблуневий провулок	Яблуневий провулок
Яблуневий проїзд	Яблуневий проїзд
Ялицевий провулок	Ялицевий провулок
Янцева вулиця	Янцева вулиця
Ясенева вулиця	Ясенева вулиця
Ясеневий провулок	Ясеневий провулок
Ясинева вулиця	Ясинева вулиця