Авіахімічна вулиця	Авіахімічна вулиця
Авіахімічний провулок	Авіахімічний провулок
Автоматична вулиця	Автоматична вулиця
Агрономічна вулиця	Агрономічна вулиця
Агрономічний провулок	Агрономічний провулок
Агротехнічна вулиця	Агротехнічна вулиця
Агротехнічний провулок	Агротехнічний провулок
Агрохімічна вулиця	Агрохімічна вулиця
Академічна вулиця	Академічна вулиця
Академічний провулок	Академічний провулок
Академічний проїзд	Академічний проїзд
Акадeмічна вулиця	Академічна вулиця
Антарктична вулиця	Антарктична вулиця
Антарктичний провулок	Антарктичний провулок
Антична вулиця	Антична вулиця
Аптечна вулиця	Аптечна вулиця
Аптечний провулок	Аптечний провулок
Арктична вулиця	Арктична вулиця
Арктичний провулок	Арктичний провулок
Ароматичний провулок	Ароматичний провулок
Арочна вулиця	Арочна вулиця
Арочна стежка	Арочна стежка
Арочний місток	Арочний місток
Археологічна вулиця	Археологічна вулиця
Археологічний провулок	Археологічний провулок
Археологічний проїзд	Археологічний проїзд
Астрономічна вулиця	Астрономічна вулиця
Астрономічний провулок	Астрономічний провулок
Атлантична вулиця	Атлантична вулиця
Атлетична вулиця	Атлетична вулиця
Байдарочний провулок	Байдарочний провулок
Байрачна вулиця	Байрачна вулиця
Балістична вулиця	Балістична вулиця
Балочна вулиця	Балочна вулиця
Балочний провулок	Балочний провулок
Барачна вулиця	Барачна вулиця
Барачний провулок	Барачний провулок
Безпечна вулиця	Безпечна вулиця
Бібліотечна вулиця	Бібліотечна вулиця
Бібліотечний провулок	Бібліотечний провулок
Білокринична вулиця	Білокринична вулиця
Біологічна вулиця	Біологічна вулиця
Біологічний в’їзд	Біологічний вʼїзд
Біологічний масив	Біологічний масив
Біологічний провулок	Біологічний провулок
Біохімічна вулиця	Біохімічна вулиця
Бічна Арктична вулиця	Бічна Арктична вулиця
Бічна вишнева вулиця	Бічна вишнева вулиця
Бічна вулиця	Бічна вулиця
Бічна дитяча вулиця	Бічна дитяча вулиця
Бічна Залізнична вулиця	Бічна Залізнична вулиця
Бічна зелена	Бічна зелена
Бічна Зелена	Бічна Зелена
Бічна Зелена вулиця	Бічна Зелена вулиця
Бічна Лісна вулиця	Бічна Лісна вулиця
Бічна Миру вулиця	Бічна Миру вулиця
Бічна привокзальної вулиця	Бічна привокзальної вулиця
Бічна Пригородна вулиця	Бічна Пригородна вулиця
Бічна Сонячна вулиця	Бічна Сонячна вулиця
Бічний провулок	Бічний провулок
Блочна вулиця	Блочна вулиця
Богородична вулиця	Богородична вулиця
Больнична вулиця	Больнична вулиця
Больничний провулок	Больничний провулок
Больнічна вулиця	Больнічна вулиця
Ботанічна вулиця	Ботанічна вулиця
Ботанічна площа	Ботанічна площа
Ботанічний провулок	Ботанічний провулок
Ботанічний проїзд	Ботанічний проїзд
Ботанічний Сад провулок	Ботанічний Сад провулок
Ботанічний тупик	Ботанічний тупик
Братів Бережницьких Бічна вулиця	Братів Бережницьких Бічна вулиця
Бруснична вулиця	Бруснична вулиця
Бутилочна вулиця	Бутилочна вулиця
Велика Північна вулиця	Велика Північна вулиця
Верхня Зарічна вулиця	Верхня Зарічна вулиця
Верхня Прирічна вулиця	Верхня Прирічна вулиця
Весела-Бічна вулиця	Весела-Бічна вулиця
Винична вулиця	Винична вулиця
Виставочна вулиця	Виставочна вулиця
Виставочний провулок	Виставочний провулок
Вічний провулок	Вічний провулок
Водокачна вулиця	Водокачна вулиця
Водокачний провулок	Водокачний провулок
Водостічна вулиця	Водостічна вулиця
Водостічний провулок	Водостічний провулок
Водосточна вулиця	Водосточна вулиця
Восточна вулиця	Восточна вулиця
Восточний провулок	Восточний провулок
Вузька Бічна вулиця	Вузька Бічна вулиця
вул. Бічна Лісна	Бічна Лісна вулиця
Галактична вулиця	Галактична вулиця
Гастрономічна вулиця	Гастрономічна вулиця
Гаубичний провулок	Гаубичний провулок
Гвоздична вулиця	Гвоздична вулиця
Гвоздичний провулок	Гвоздичний провулок
Генетична вулиця	Генетична вулиця
Географічна вулиця	Географічна вулиця
Географічний проїзд	Географічний проїзд
Геодезична вулиця	Геодезична вулиця
Геодезичний провулок	Геодезичний провулок
Геологічна вулиця	Геологічна вулиця
Геологічна пам'ятка природи місцевого значення	Геологічна памʼятка природи місцевого значення
Геологічний провулок	Геологічний провулок
Геофізиків бічна вулиця	Геофізиків бічна вулиця
Геофізична вулиця	Геофізична вулиця
Геохімічна вулиця	Геохімічна вулиця
Героїчна вулиця	Героїчна вулиця
Героїчний провулок	Героїчний провулок
Гишки Бічна вулиця	Гишки Бічна вулиця
Гідротехнічна вулиця	Гідротехнічна вулиця
Гімназична вулиця	Гімназична вулиця
Гімназичний провулок	Гімназичний провулок
Гімназичний проспект	Гімназичний проспект
Гірнична вулиця	Гірнична вулиця
Глибока бічна вулиця	Глибока бічна вулиця
Городня-Бічна вулиця	Городня-Бічна вулиця
Гранична Бічна вулиця	Гранична Бічна вулиця
Гранична вулиця	Гранична вулиця
Граничний провулок	Граничний провулок
Грідротехнічний проїзд	Грідротехнічний проїзд
Гучний провулок	Гучний провулок
Дальневосточна вулиця	Дальневосточна вулиця
Дальнєвосточна вулиця	Дальнєвосточна вулиця
Дачна вулиця	Дачна вулиця
Дачний провулок	Дачний провулок
Дачний проїзд	Дачний проїзд
Дачний тупик	Дачний тупик
Дачний узвіз	Дачний узвіз
Дворічна вулиця	Дворічна вулиця
Демократична вулиця	Демократична вулиця
Демократичний провулок	Демократичний провулок
Дендрологічний провулок	Дендрологічний провулок
Динамічна вулиця	Динамічна вулиця
Динамічний провулок	Динамічний провулок
Драматичний театр	Драматичний театр
Дружби бічна вулиця	Бічна вулиця Дружби
Екологічна вулиця	Екологічна вулиця
екологічна стежка	екологічна стежка
Екологічна стежка	Екологічна стежка
Екологічна стежка «Від Волині до Поділля»	Екологічна стежка «Від Волині до Поділля»
Екологічна стежка «Лісники»	Екологічна стежка «Лісники»
Екологічний маршрут	Екологічний маршрут
Екологiчна тропа	Екологічна тропа
Економічна вулиця	Економічна вулиця
Економічний провулок	Економічний провулок
Економічний проїзд	Економічний проїзд
Електрична вулиця	Електрична вулиця
Електричний в’їзд	Електричний вʼїзд
Електричний вїзд	Електричний вїзд
Електричний провулок	Електричний провулок
Електромеханічна вулиця	Електромеханічна вулиця
Електромеханічний провулок	Електромеханічний провулок
Електротехнічна вулиця	Електротехнічна вулиця
Енергетична Бічна вулиця	Енергетична Бічна вулиця
Енергетична вулиця	Енергетична вулиця
Енергетичний провулок	Енергетичний провулок
Єрична вулиця	Єрична вулиця
Живичний провулок	Живичний провулок
Задубична вулиця	Задубична вулиця
Закузнечна вулиця	Закузнечна вулиця
Закузнечний провулок	Закузнечний провулок
Залізнична бічна вулиця	Залізнична бічна вулиця
Залізнична Бічна вулиця	Залізнична Бічна вулиця
Залізнична вулиця	Залізнична вулиця
Залізнична-Бічна вулиця	Залізнична-Бічна вулиця
Залізничний в'їзд	Залізничний вʼїзд
Залізничний в’їзд	Залізничний вʼїзд
Залізничний вокзал	Залізничний вокзал
Залізничний квартал	Залізничний квартал
Залізничний міст вулиця	Залізничний міст вулиця
Залізничний провулок	Залізничний провулок
Залізничний проїзд	Залізничний проїзд
Залізнічна вулиця	Залізнічна вулиця
Залічзнична вулиця	Залічзнична вулиця
Залiзнична вулиця	Залізнична вулиця
Замоскворічна вулиця	Замоскворічна вулиця
Запотічна вулиця	Запотічна вулиця
Заречна вулиця	Заречна вулиця
Зарєчна вулиця	Зарєчна вулиця
Зарічна вулиця	Зарічна вулиця
Зарічна-Бічна вулиця	Зарічна-Бічна вулиця
Зарічний квартал	Зарічний квартал
Зарічний провулок	Зарічний провулок
Зарiчна вулиця	Зарічна вулиця
Заточна вулиця	Заточна вулиця
Збічна вулиця	Збічна вулиця
Звлізнична вулиця	Звлізнична вулиця
Зелена Бічна вулиця	Зелена Бічна вулиця
Зелена-Бічна вулиця	Зелена-Бічна вулиця
Землянична вулиця	Землянична вулиця
Земляничний провулок	Земляничний провулок
Зоологічна вулиця	Зоологічна вулиця
Зоологічний міст	Зоологічний міст
Зоологічний провулок	Зоологічний провулок
Зоологічний тупик	Зоологічний тупик
Зоотехнічна вулиця	Зоотехнічна вулиця
Зоотехнічний провулок	Зоотехнічний провулок
Зручний проїзд	Зручний проїзд
Зупиночний провулок	Зупиночний провулок
Зустрічна вулиця	Зустрічна вулиця
Зустрічний провулок	Зустрічний провулок
Історична вулиця	Історична вулиця
Історичний провулок	Історичний провулок
Камінна Бічна вулиця	Бічна Камінна вулиця
Квіточна вулиця	Квіточна вулиця
Керамічна вулиця	Керамічна вулиця
Керамічний провулок	Керамічний провулок
Керамічний проїзд	Керамічний проїзд
Кібернетична вулиця	Кібернетична вулиця
Кібернетичний провулок	Кібернетичний провулок
Кірпічна вулиця	Кірпічна вулиця
Класична вулиця	Класична вулиця
Класичний провулок	Класичний провулок
Клінічна вулиця	Клінічна вулиця
Клубнична вулиця	Клубнична вулиця
Клубнічна вулиця	Клубнічна вулиця
Ключний провулок	Ключний провулок
Клячковського бічна вулиця	Клячковського бічна вулиця
Коксохімічна вулиця	Коксохімічна вулиця
Колонічна вулиця	Колонічна вулиця
комуністична вулиця	комуністична вулиця
Комуністична вулиця	Комуністична вулиця
Комуністичний провулок	Комуністичний провулок
Комуністичний проспект	Комуністичний проспект
Косична вулиця	Косична вулиця
Космічна вулиця	Космічна вулиця
Космічний провулок	Космічний провулок
Космічний проїзд	Космічний проїзд
Крамнична вулиця	Крамнична вулиця
Красочна вулиця	Красочна вулиця
Кринична вулиця	Кринична вулиця
Кринична площа	Кринична площа
Криничний в’їзд	Криничний вʼїзд
Криничний провулок	Криничний провулок
Крута-Бічна вулиця	Крута-Бічна вулиця
Кузнечна вулиця	Кузнечна вулиця
Кузнечний в’їзд	Кузнечний вʼїзд
Кузнечний провулок	Кузнечний провулок
Кузнечний проїзд	Кузнечний проїзд
Кузнечний тупик	Кузнечний тупик
Кузнєчна вулиця	Кузнєчна вулиця
Кузнєчний провулок	Кузнєчний провулок
Курортна-бічна вулиця	Курортна-бічна вулиця
Латорична вулиця	Латорична вулиця
Латоричний Двір вулиця	Латоричний Двір вулиця
Лірична вулиця	Лірична вулиця
Ліричний провулок	Ліричний провулок
Лісна / Сонячна вулиця	Лісна / Сонячна вулиця
Лісна Бічна вулиця	Лісна Бічна вулиця
Лодочний провулок	Лодочний провулок
Лучна вулиця	Лучна вулиця
Малорічний провулок	Малорічний провулок
Матеріалістичний провулок	Матеріалістичний провулок
Маячна вулиця	Маячна вулиця
Маячний провулок	Маячний провулок
Медична вулиця	Медична вулиця
Медичний провулок	Медичний провулок
Медичний проїзд	Медичний проїзд
Мельнична вулиця	Мельнична вулиця
Мельничний провулок	Мельничний провулок
Металургічна вулиця	Металургічна вулиця
Метеорологічна вулиця	Метеорологічна вулиця
Метеорологічний провулок	Метеорологічний провулок
Метеорологічний проїзд	Метеорологічний проїзд
Метрологічна вулиця	Метрологічна вулиця
Микільсько-Ботанічна вулиця	Микільсько-Ботанічна вулиця
Миру бічна вулиця	Миру бічна вулиця
Міжрічний провулок	Міжрічний провулок
Місячна верхня вулиця	Місячна верхня вулиця
Місячна вулиця	Місячна вулиця
Місячна нижня вулиця	Місячна нижня вулиця
Місячний провулок	Місячний провулок
Моєчна вулиця	Моєчна вулиця
Молодої Гвардії бічна вулиця	Молодої Гвардії бічна вулиця
Молочна вулиця	Молочна вулиця
Молочний провулок	Молочний провулок
Музична вулиця	Музична вулиця
Музичний провулок	Музичний провулок
Мучна вулиця	Мучна вулиця
Мучний провулок	Мучний провулок
Надзбручна вулиця	Надзбручна вулиця
Надрічна вулиця	Надрічна вулиця
Надрічний провулок	Надрічний провулок
Надрiчна вулиця	Надрічна вулиця
Налічна вулиця	Налічна вулиця
небезпечна стежка	небезпечна стежка
Небезпечна стежка до джерела	Небезпечна стежка до джерела
Нескучна вулиця	Нескучна вулиця
Нижньо Дачна вулиця	Нижньо Дачна вулиця
Нижньопогранична вулиця	Нижньопогранична вулиця
Нижня бічна вулиця	Нижня бічна вулиця
Нижня Зарічна вулиця	Нижня Зарічна вулиця
Нижня Прирічна вулиця	Нижня Прирічна вулиця
Новодачний провулок	Новодачний провулок
Новоекономічна вулиця	Новоекономічна вулиця
Новозалізнична вулиця	Новозалізнична вулиця
Новокирпична вулиця	Новокирпична вулиця
Новокузнечна вулиця	Новокузнечна вулиця
Новопівнічна вулиця	Новопівнічна вулиця
Новопотічна вулиця	Новопотічна вулиця
Новопотічний провулок	Новопотічний провулок
Новорічна вулиця	Новорічна вулиця
Новорічний провулок	Новорічний провулок
Новосонячна вулиця	Новосонячна вулиця
Обіточна вулиця	Обіточна вулиця
Околична вулиця	Околична вулиця
Оптимістична вулиця	Оптимістична вулиця
Оптична вулиця	Оптична вулиця
Оптичний провулок	Оптичний провулок
Ортопедичний інститут	Ортопедичний інститут
Паланочна вулиця	Паланочна вулиця
Палянична вулиця	Палянична вулиця
Паляничний провулок	Паляничний провулок
Пасічна вулиця	Пасічна вулиця
Пасічний провулок	Пасічний провулок
Пасiчний провулок	Пасічний провулок
Патріотична вулиця	Патріотична вулиця
Патріотичний в’їзд	Патріотичний вʼїзд
Патріотичний провулок	Патріотичний провулок
Педагогічна вулиця	Педагогічна вулиця
Педагогічний провулок	Педагогічний провулок
Перевалочна вулиця	Перевалочна вулиця
Передаточна вулиця	Передаточна вулиця
Перемоги Бічна вулиця	Перемоги Бічна вулиця
Пересічна вулиця	Пересічна вулиця
Перехід через струмок Прелучний через міст	Перехід через струмок Прелучний через міст
Півнична вулиця	Півнична вулиця
Північна вулиця	Північна вулиця
Північна-бічна вулиця	Північна-бічна вулиця
Північний бульвар	Північний бульвар
Північний в’їзд	Північний вʼїзд
Північний вулиця	Північний вулиця
Північний квартал	Північний квартал
Північний край села	Північний край села
Північний міст	Північний міст
Північний обхід	Північний обхід
Північний провулок	Північний провулок
Північний проїзд	Північний проїзд
Північний тунель	Північний тунель
Північний тупик	Північний тупик
Підлавочна вулиця	Підлавочна вулиця
Підрічна вулиця	Підрічна вулиця
Підрічний провулок	Підрічний провулок
Пісочна вулиця	Пісочна вулиця
Пісочний в’їзд	Пісочний вʼїзд
Пісочний провулок	Пісочний провулок
Пісочний тупик	Пісочний тупик
Пластичний провулок	Пластичний провулок
Плиточний в’їзд	Плиточний вʼїзд
Плиточний провулок	Плиточний провулок
Плиточний проїзд	Плиточний проїзд
Побічна вулиця	Побічна вулиця
Погранична вулиця	Погранична вулиця
Поетична вулиця	Поетична вулиця
Поетичний провулок	Поетичний провулок
Поліграфічна вулиця	Поліграфічна вулиця
Поліграфічний провулок	Поліграфічний провулок
Поліклінічна вулиця	Поліклінічна вулиця
Політехнічна вулиця	Політехнічна вулиця
Політехнічний провулок	Політехнічний провулок
Полунична вулиця	Полунична вулиця
Полуничний в'їзд	Полуничний вʼїзд
Полуничний провулок	Полуничний провулок
Полуничний тупик	Полуничний тупик
Поперечна восьма вулиця	Поперечна восьма вулиця
Поперечна вулиця	Поперечна вулиця
Поперечна дев'ята вулиця	Поперечна девʼята вулиця
Поперечна друга вулиця	Поперечна друга вулиця
Поперечна п'ята вулиця	Поперечна пʼята вулиця
Поперечна перша вулиця	Поперечна перша вулиця
Поперечна сьома вулиця	Поперечна сьома вулиця
Поперечна третя вулиця	Поперечна третя вулиця
Поперечна четверта вулиця	Поперечна четверта вулиця
Поперечна шоста вулиця	Поперечна шоста вулиця
Поперечний провулок	Поперечний провулок
Посадочна вулиця	Посадочна вулиця
Потічна вулиця	Потічна вулиця
Поточна вулиця	Поточна вулиця
Поточний провулок	Поточний провулок
Практична вулиця	Практична вулиця
Прибалочна вулиця	Прибалочна вулиця
Призалізнична вулиця	Призалізнична вулиця
Прирічна вулиця	Прирічна вулиця
Прирічний провулок	Прирічний провулок
Проселочна вулиця	Проселочна вулиця
Просьолочна вулиця	Просьолочна вулиця
Протічна вулиця	Протічна вулиця
Проточна вулиця	Проточна вулиця
Проточний провулок	Проточний провулок
Проточний тупик	Проточний тупик
Профілактична вулиця	Профілактична вулиця
Пшенична вулиця	Пшенична вулиця
Пшеничний провулок	Пшеничний провулок
Радіотехнічна вулиця	Радіотехнічна вулиця
Радіотехнічний провулок	Радіотехнічний провулок
Ракушечний провулок	Ракушечний провулок
Риночна вулиця	Риночна вулиця
Риночний провулок	Риночний провулок
Рівна-Бічна вулиця	Рівна-Бічна вулиця
Різнична вулиця	Різнична вулиця
Річна вулиця	Річна вулиця
Річний в’їзд	Річний вʼїзд
Річний провулок	Річний провулок
Річний тупик	Річний тупик
Романтична вулиця	Романтична вулиця
Романтичний провулок	Романтичний провулок
Руднична вулиця	Руднична вулиця
Рудничний провулок	Рудничний провулок
Руднічна вулиця	Руднічна вулиця
Сагайдачна вулиця	Сагайдачна вулиця
Садівнична вулиця	Садівнична вулиця
Садово-Ботанічна вулиця	Садово-Ботанічна вулиця
Садово-Ботанічний провулок	Садово-Ботанічний провулок
Садово-Дачна вулиця	Садово-Дачна вулиця
Салінарна-Бічна вулиця	Салінарна-Бічна вулиця
Самотічна вулиця	Самотічна вулиця
Санячна вулиця	Санячна вулиця
Світлична вулиця	Світлична вулиця
Свічна вулиця	Свічна вулиця
Свічний провулок	Свічний провулок
Семирічна вулиця	Семирічна вулиця
Сердечна вулиця	Сердечна вулиця
Середня-Бічна вулиця	Середня-Бічна вулиця
Симфонічна вулиця	Симфонічна вулиця
Сільгосптехнічний провулок	Сільгосптехнічний провулок
Сіточний вулиця	Сіточний вулиця
Січових Срільців Бічна вулиця	Січових Срільців Бічна вулиця
Солнєчна вулиця	Солнєчна вулиця
Солонична вулиця	Солонична вулиця
Сонячна бічна вулиця	Сонячна бічна вулиця
Сонячна Бічна вулиця	Сонячна Бічна вулиця
Сонячна Верхня вулиця	Сонячна Верхня вулиця
Сонячна вулиця	Сонячна вулиця
Сонячна провулок	Сонячна провулок
Сонячний бульвар	Сонячний бульвар
Сонячний в’їзд	Сонячний вʼїзд
сонячний кв	сонячний кв
Сонячний кв	Сонячний кв
Сонячний кв.	Сонячний кв.
Сонячний квартал	Сонячний квартал
Сонячний мікрорайон	Сонячний мікрорайон
Сонячний провулок	Сонячний провулок
Сонячний проїзд	Сонячний проїзд
Сонячний тупик	Сонячний тупик
Сонячний Шлях вулиця	Сонячний Шлях вулиця
Соціалістична вулиця	Соціалістична вулиця
Соціалістичний провулок	Соціалістичний провулок
Сполучна вулиця	Сполучна вулиця
Ставочна вулиця	Ставочна вулиця
Станична вулиця	Станична вулиця
Станичний провулок	Станичний провулок
Станочна вулиця	Станочна вулиця
старий залізничний міст	старий залізничний міст
Старогранична вулиця	Старогранична вулиця
Старорізнична вулиця	Старорізнична вулиця
Старофортечна вулиця	Старофортечна вулиця
Столична вулиця	Столична вулиця
Столичний провулок	Столичний провулок
Стратегічний провулок	Стратегічний провулок
Стрілочна вулиця	Стрілочна вулиця
Стрільнична вулиця	Стрільнична вулиця
Сунична вулиця	Сунична вулиця
Таврична вулиця	Таврична вулиця
Тавричний провулок	Тавричний провулок
Таврічна вулиця	Таврічна вулиця
Тактична вулиця	Тактична вулиця
Ташлична вулиця	Ташлична вулиця
Телефонічна вулиця	Телефонічна вулиця
Телефонічний провулок	Телефонічний провулок
Теплична вулиця	Теплична вулиця
Тепличний провулок	Тепличний провулок
Термічна вулиця	Термічна вулиця
Технічна вулиця	Технічна вулиця
Технічний в’їзд	Технічний вʼїзд
Технічний провулок	Технічний провулок
Технічний проїзд	Технічний проїзд
Технологічна вулиця	Технологічна вулиця
Технологічний в’їзд	Технологічний вʼїзд
Типографічна вулиця	Типографічна вулиця
Топографічна вулиця	Топографічна вулиця
Транспортна-Бічна вулиця	Транспортна-Бічна вулиця
Туристична вулиця	Туристична вулиця
Туристичний провулок	Туристичний провулок
Удачна вулиця	Удачна вулиця
Фабзавучна вулиця	Фабзавучна вулиця
Фабрична вулиця	Фабрична вулиця
Фабричний провулок	Фабричний провулок
Фабрічний провулок	Фабрічний провулок
Федуска-Бічна вулиця	Федуска-Бічна вулиця
Фізична вулиця	Фізична вулиця
Фортечна вулиця	Фортечна вулиця
Фортечний провулок	Фортечний провулок
Фортечний тупик	Фортечний тупик
Фортечний узвіз	Фортечний узвіз
Хімічна вулиця	Хімічна вулиця
Хімічний провулок	Хімічний провулок
Хірургічна вулиця	Хірургічна вулиця
Цвєточна вулиця	Цвєточна вулиця
Цвєточний провулок	Цвєточний провулок
Цвіточна вулиця	Цвіточна вулиця
Цвіточний бульвар	Цвіточний бульвар
Цвіточний провулок	Цвіточний провулок
Циклічна вулиця	Циклічна вулиця
Черепична вулиця	Черепична вулиця
Чорнична вулиця	Чорнична вулиця
Шовковична вулиця	Шовковична вулиця
Шовковичний провулок	Шовковичний провулок
Штучний міст	Штучний міст
Экологічна стежка	Экологічна стежка
Яблучна вулиця	Яблучна вулиця
Яблучний провулок	Яблучний провулок
Ярмарочна вулиця	Ярмарочна вулиця
Ярмарочний провулок	Ярмарочний провулок