Аветисяна вулиця	Аветисяна вулиця
Адамяна вулиця	Адамяна вулиця
Алабяна вулиця	Алабяна вулиця
Амиряна вулиця	Амиряна вулиця
Ангуряна вулиця	Ангуряна вулиця
Бавовняний провулок	Бавовняний провулок
Багняна вулиця	Багняна вулиця
Багряна вулиця	Багряна вулиця
Багряний провулок	Багряний провулок
Березяна вулиця	Березяна вулиця
Березяний провулок	Березяний провулок
Берестяна вулиця	Берестяна вулиця
Берліяна вулиця	Берліяна вулиця
Білокам’яна вулиця	Білокамʼяна вулиця
Брайляна вулиця	Брайляна вулиця
Бур’яна вулиця	Бурʼяна вулиця
Бурназяна вулиця	Бурназяна вулиця
Буртяна вулиця	Буртяна вулиця
Вапняна вулиця	Вапняна вулиця
Вартаняна вулиця	Вартаняна вулиця
Великокамʼяна вулиця	Великокамʼяна вулиця
Верф'яна вулиця	Верфʼяна вулиця
Весняна вулиця	Весняна вулиця
Весняний (Жовтневий) провулок	Весняний (Жовтневий) провулок
Весняний в'їзд	Весняний вʼїзд
Весняний в’їзд	Весняний вʼїзд
Весняний завулок	Весняний завулок
Весняний провулок	Весняний провулок
Весняний проїзд	Весняний проїзд
Весняний тупик	Весняний тупик
Вівсяна вулиця	Вівсяна вулиця
Вівсяний провулок	Вівсяний провулок
Вітряна вулиця	Вітряна вулиця
Вітряний провулок	Вітряний провулок
Вітчизняна вулиця	Вітчизняна вулиця
Вітчизняний бульвар	Вітчизняний бульвар
Вобяна вулиця	Вобяна вулиця
Водяна вулиця	Водяна вулиця
Водяний провулок	Водяний провулок
Глиняна вулиця	Глиняна вулиця
Глиняний провулок	Глиняний провулок
Горяна вулиця	Горяна вулиця
Гуньяна вулиця	Гуньяна вулиця
Дарбіняна вулиця	Дарбіняна вулиця
Дарбіняна провулок	Дарбіняна провулок
Дем’яна Бедного вулиця	Демʼяна Бедного вулиця
Дем’яна Гладиловича вулиця	Демʼяна Гладиловича вулиця
Дерев'яний місток	Деревʼяний місток
Дерев`яний міст	Деревʼяний міст
Деревʼяний місток	Деревʼяний місток
Заводяна вулиця	Заводяна вулиця
Залікарняна вулиця	Залікарняна вулиця
Залікарняний провулок	Залікарняний провулок
Заяна вулиця	Заяна вулиця
земляна дамба	земляна дамба
Земляний провулок	Земляний провулок
Зорянa вулиця	Зоряна вулиця
Ісаханяна вулиця	Ісаханяна вулиця
Кам'яна вулиця	Камʼяна вулиця
Кам'яний кар'єр	Кам'яний карʼєр
Кам'яний провулок	Камʼяний провулок
Кам’яна вулиця	Камʼяна вулиця
Кам’яний провулок	Камʼяний провулок
Кам’яний Узвіз провулок	Камʼяний Узвіз провулок
Камʼяна вулиця	Камʼяна вулиця
Камʼяний провулок	Камʼяний провулок
Конопляна вулиця	Конопляна вулиця
Конопляний провулок	Конопляний провулок
Конопляний проїзд	Конопляний проїзд
Копальняна вулиця	Копальняна вулиця
Крейдяна вулиця	Крейдяна вулиця
Крейдяний провулок	Крейдяний провулок
Кудряна вулиця	Кудряна вулиця
Кукурудзяна вулиця	Кукурудзяна вулиця
Кукурудзяний проїзд	Кукурудзяний проїзд
Ледяний вулиця	Ледяний вулиця
Листяна вулиця	Листяна вулиця
Листяний провулок	Листяний провулок
Лікарняна вулиця	Лікарняна вулиця
Лікарняна Івулиця	Лікарняна Івулиця
Лікарняна Колона вулиця	Лікарняна Колона вулиця
Лікарняний масив	Лікарняний масив
Лікарняний провулок	Лікарняний провулок
Лікарняний проїзд	Лікарняний проїзд
Лікарняний тупик	Лікарняний тупик
Лікарняний Хутір вулиця	Лікарняний Хутір вулиця
Льняна вулиця	Льняна вулиця
Малокамʼяна вулиця	Малокамʼяна вулиця
Мар’яна Дишеля провулок	Марʼяна Дишеля провулок
Меліксетяна вулиця	Меліксетяна вулиця
Мілконяна вулиця	Мілконяна вулиця
Мурляна вулиця	Мурляна вулиця
Новоконопляний провулок	Новоконопляний провулок
Овнатаняна вулиця	Овнатаняна вулиця
Осетяна вулиця	Осетяна вулиця
Очеретяна вулиця	Очеретяна вулиця
Очеретяний провулок	Очеретяний провулок
Підвітряна вулиця	Підвітряна вулиця
Підвітряний провулок	Підвітряний провулок
Повітряна вулиця	Повітряна вулиця
Повітряний провулок	Повітряний провулок
Повстяна вулиця	Повстяна вулиця
Погасяна вулиця	Погасяна вулиця
Полтв’яна вулиця	Полтвʼяна вулиця
Різдв'яна вулиця	Різдвʼяна вулиця
Різдв’ яна вулиця	Різдвʼ яна вулиця
Різдвяна вулиця	Різдвяна вулиця
Різдвяна площа	Різдвяна площа
Різдвяний в'їзд	Різдвяний вʼїзд
Різдвяний в’їзд	Різдвяний вʼїзд
Різдвяний провулок	Різдвяний провулок
Росяна вулиця	Росяна вулиця
Севастьяна провулок	Севастьяна провулок
Серебряна вулиця	Серебряна вулиця
Скляна вулиця	Скляна вулиця
Смоляна вулиця	Смоляна вулиця
Солом'яна вулиця	Соломʼяна вулиця
Солом'яний провулок	Соломʼяний провулок
Соляна вулиця	Соляна вулиця
Соляний провулок	Соляний провулок
Спандаряна вулиця	Спандаряна вулиця
Тевосяна вулиця	Тевосяна вулиця
Торосяна вулиця	Торосяна вулиця
Торф'яний провулок	Торфʼяний провулок
Торф’ яний провулок	Торфʼ яний провулок
Торф’яна вулиця	Торфʼяна вулиця
Торф’яний провулок	Торфʼяний провулок
Торф`яна вулиця	Торфʼяна вулиця
Торфяна вулиця	Торфяна вулиця
Торфяний провулок	Торфяний провулок
Трав'яний провулок	Травʼяний провулок
Травʼяний провулок	Травʼяний провулок
Тростяна вулиця	Тростяна вулиця
Тур’ яна вулиця	Турʼ яна вулиця
Цегельняна вулиця	Цегельняна вулиця
Цегляна вулиця	Цегляна вулиця
Цегляна площа	Цегляна площа
Цегляний кар'єр	Цегляний карʼєр
Цегляний масив	Цегляний масив
Цегляний провулок	Цегляний провулок
Чепур’яна вулиця	Чепурʼяна вулиця
Червонозоряна вулиця	Червонозоряна вулиця
Червонозоряний провулок	Червонозоряний провулок
Червонозоряний проспект	Червонозоряний проспект
Шкіряна вулиця	Шкіряна вулиця