Антонівка вулиця	Антонівка вулиця
Ахманівка вулиця	Ахманівка вулиця
Базарівка вулиця	Базарівка вулиця
Баківка вулиця	Баківка вулиця
Балабанівка вулиця	Балабанівка вулиця
Балашівка вулиця	Балашівка вулиця
Бандурівка вулиця	Бандурівка вулиця
Батівка вулиця	Батівка вулиця
Бахматівка вулиця	Бахматівка вулиця
Бежівка вулиця	Бежівка вулиця
Безимівка вулиця	Безимівка вулиця
Березівка вулиця	Березівка вулиця
Берунівка вулиця	Берунівка вулиця
Бесалівка вулиця	Бесалівка вулиця
Білодідівка вулиця	Білодідівка вулиця
Бовдирівка вулиця	Бовдирівка вулиця
Богданівка вулиця	Богданівка вулиця
Богодарівка вулиця	Богодарівка вулиця
Боднарівка вулиця	Боднарівка вулиця
Бойківка вулиця	Бойківка вулиця
Борисівка вулиця	Борисівка вулиця
Боричівка вулиця	Боричівка вулиця
Бочанівка вулиця	Бочанівка вулиця
Бринівка вулиця	Бринівка вулиця
Будківка вулиця	Будківка вулиця
Буланівка вулиця	Буланівка вулиця
Бунівка вулиця	Бунівка вулиця
Буряківка вулиця	Буряківка вулиця
Вадрусівка вулиця	Вадрусівка вулиця
Валки — Пархомівка	Валки — Пархомівка
Варварівка вулиця	Варварівка вулиця
Василівка вулиця	Василівка вулиця
Веделівка вулиця	Веделівка вулиця
Велика Захватівка вулиця	Велика Захватівка вулиця
Велика Ковалівка вулиця	Велика Ковалівка вулиця
Вербівка вулиця	Вербівка вулиця
Вергонівка вулиця	Вергонівка вулиця
Верхня Антонівка вулиця	Верхня Антонівка вулиця
Веселівка вулиця	Веселівка вулиця
Вибранівка вулиця	Вибранівка вулиця
Видрівка вулиця	Видрівка вулиця
Вільхівка вулиця	Вільхівка вулиця
вулиця Бабківка	вулиця Бабківка
вулиця Голубівка	вулиця Голубівка
вулиця Задубівка	вулиця Задубівка
вулиця Прусівка	вулиця Прусівка
Гаврашівка вулиця	Гаврашівка вулиця
Гаврюківка вулиця	Гаврюківка вулиця
Гайдівка вулиця	Гайдівка вулиця
Гарбузівка вулиця	Гарбузівка вулиця
Гергелівка вулиця	Гергелівка вулиця
Глухівка вулиця	Глухівка вулиця
Голотівка вулиця	Голотівка вулиця
Голубівка вулиця	Голубівка вулиця
Гончарівка вулиця	Гончарівка вулиця
Горбівка вулиця	Горбівка вулиця
Горболівка вулиця	Горболівка вулиця
Гордіівка вулиця	Гордіівка вулиця
Горіхівка вулиця	Горіхівка вулиця
Горовівка провулок	Горовівка провулок
Гребешівка вулиця	Гребешівка вулиця
Гресівка вулиці	Гресівка вулиці
Грицівка вулиця	Грицівка вулиця
Грицулівка вулиця	Грицулівка вулиця
Гудзівка вулиця	Гудзівка вулиця
Гуменівка вулиця	Гуменівка вулиця
Дальківка вулиця	Дальківка вулиця
Дармолівка вулиця	Дармолівка вулиця
Дейнеківка - Чапаєвка - Дячкове	Дейнеківка - Чапаєвка - Дячкове
Дем’янівка вулиця	Демʼянівка вулиця
Денисівка вулиця	Денисівка вулиця
Дернівка вулиця	Дернівка вулиця
Джумаківка вулиця	Джумаківка вулиця
Диканька – Решетилівка	Диканька – Решетилівка
Дібрівка вулиця	Дібрівка вулиця
Дібрівка провулок	Дібрівка провулок
Дівухівка вулиця	Дівухівка вулиця
Дігтярівка вулиця	Дігтярівка вулиця
Довгалівка вулиця	Довгалівка вулиця
Долинівка вулиця	Долинівка вулиця
Долішнівка вулиця	Долішнівка вулиця
Дубівка вулиця	Дубівка вулиця
Дубрівка вулиця	Дубрівка вулиця
Дяченківка вулиця	Дяченківка вулиця
Дячкове - /Диканька - Решетилівка/	Дячкове - /Диканька - Решетилівка/
Жаберівка вулиця	Жаберівка вулиця
Жуківка вулиця	Жуківка вулиця
Журбівка вулиця	Журбівка вулиця
Забівка вулиця	Забівка вулиця
Заболотівка вулиця	Заболотівка вулиця
Завгородівка вулиця	Завгородівка вулиця
Замленівка вулиця	Замленівка вулиця
Замлинівка вулиця	Замлинівка вулиця
Захватівка вулиця	Захватівка вулиця
Зачепилівка - Рунівщина-Зарічне	Зачепилівка - Рунівщина-Зарічне
Зеленівка вулиця	Зеленівка вулиця
Ігорівка вулиця	Ігорівка вулиця
Йовівка вулиця	Йовівка вулиця
Кавунівка вулиця	Кавунівка вулиця
Казимирівка вулиця	Казимирівка вулиця
Кайдашівка вулиця	Кайдашівка вулиця
Калинівка вулиця	Калинівка вулиця
Капацілівка вулиця	Капацілівка вулиця
Капилівка вулиця	Капилівка вулиця
Кардашівка вулиця	Кардашівка вулиця
Кастелівка вулиця	Кастелівка вулиця
Кашталянівка вулиця	Кашталянівка вулиця
Кашубівка вулиця	Кашубівка вулиця
Киричівка вулиця	Киричівка вулиця
Кирстівка вулиця	Кирстівка вулиця
Кінчеш-Розівка автошлях	Кінчеш-Розівка автошлях
Клинівка вулиця	Клинівка вулиця
Книшівка вулиця	Книшівка вулиця
Кобзарівка вулиця	Кобзарівка вулиця
Кобзарівка провулок	Кобзарівка провулок
Ковалівка вулиця	Ковалівка вулиця
Козаківка вулиця	Козаківка вулиця
Козинівка вулиця	Козинівка вулиця
Кордулівка вулиця	Кордулівка вулиця
Коржівка вулиця	Коржівка вулиця
Королівка вулиця	Королівка вулиця
Кортумівка вулиця	Кортумівка вулиця
Котівка вулиця	Котівка вулиця
Кочержівка вулиця	Кочержівка вулиця
Крамарівка вулиця	Крамарівка вулиця
Красилівка вулиця	Красилівка вулиця
Крачківка вулиця	Крачківка вулиця
Крашенівка вулиця	Крашенівка вулиця
Крижівка вулиця	Крижівка вулиця
Крикунівка вулиця	Крикунівка вулиця
Ксаверівка вулиця	Ксаверівка вулиця
Кубалівка вулиця	Кубалівка вулиця
Кузнярівка вулиця	Кузнярівка вулиця
Куличівка вулиця	Куличівка вулиця
Кулишівка вулиця	Кулишівка вулиця
Куркудимівка вулиця	Куркудимівка вулиця
Лабівка вулиця	Лабівка вулиця
Лазьківка вулиця	Лазьківка вулиця
Лебедівка вулиця	Лебедівка вулиця
Лехманівка вулиця	Лехманівка вулиця
Липова Долина - Русанівка ( на Гадяч)	Липова Долина - Русанівка ( на Гадяч)
Лисичівка вулиця	Лисичівка вулиця
Лісничівка вулиця	Лісничівка вулиця
Логвинівка вулиця	Логвинівка вулиця
Мазурівка вулиця	Мазурівка вулиця
Майорівка вулиця	Майорівка вулиця
Мала Гончарівка вулиця	Мала Гончарівка вулиця
Мала Ковалівка вулиця	Мала Ковалівка вулиця
Мар'янівка вулиця	Марʼянівка вулиця
Мармужівка вулиця	Мармужівка вулиця
Марушківка вулиця	Марушківка вулиця
Марценівка вулиця	Марценівка вулиця
Марцинівка вулиця	Марцинівка вулиця
Маршалківка вулиця	Маршалківка вулиця
Маслівка вулиця	Маслівка вулиця
Матронівка вулиця	Матронівка вулиця
Махлунівка вулиця	Махлунівка вулиця
Медведівка вулиця	Медведівка вулиця
Мигалівка вулиця	Мигалівка вулиця
Мигринівка вулиця	Мигринівка вулиця
Мирошниківка вулиця	Мирошниківка вулиця
міст через річку Мала Тернівка	міст через річку Мала Тернівка
Млинівка вулиця	Млинівка вулиця
Морозівка вулиця	Морозівка вулиця
Мохнатівка вулиця	Мохнатівка вулиця
Мохорівка вулиця	Мохорівка вулиця
Мухівка вулиця	Мухівка вулиця
Нагірнівка вулиця	Нагірнівка вулиця
Назарівка вулиця	Назарівка вулиця
Натоківка вулиця	Натоківка вулиця
Нижня Оврамівка вулиця	Нижня Оврамівка вулиця
Ничогівка вулиця	Ничогівка вулиця
Нова Михайлівка вулиця	Нова Михайлівка вулиця
Нова Михайлівка провулок	Нова Михайлівка провулок
Новопанасівка вулиця	Новопанасівка вулиця
Новоселівка вулиця	Новоселівка вулиця
Новоселівка провулок	Новоселівка провулок
Новоселівка проїзд	Новоселівка проїзд
Ододівка вулиця	Ододівка вулиця
Осовківка вулиця	Осовківка вулиця
Осташівка вулиця	Осташівка вулиця
Острівка вулиця	Острівка вулиця
Панасівка - Московське - Синівка	Панасівка - Московське - Синівка
Панасівка вулиця	Панасівка вулиця
Паньківка вулиця	Паньківка вулиця
Папарівка вулиця	Папарівка вулиця
Пасківка вулиця	Пасківка вулиця
Перегонівка вулиця	Перегонівка вулиця
Персенківка вулиця	Персенківка вулиця
Петрівка вулиця	Петрівка вулиця
Пирогівка вулиця	Пирогівка вулиця
Підлісівка вулиця	Підлісівка вулиця
Піндзірівка вулиця	Піндзірівка вулиця
Пісківка вулиця	Пісківка вулиця
Плисівка вулиця	Плисівка вулиця
Погребнівка вулиця	Погребнівка вулиця
Покрасівка вулиця	Покрасівка вулиця
Покрівка вулиця	Покрівка вулиця
Полівка вулиця	Полівка вулиця
Поломарівка вулиця	Поломарівка вулиця
Полтава - Кротенки - Петрівка - /Суми - Полтава/	Полтава - Кротенки - Петрівка - /Суми - Полтава/
Попівка вулиця	Попівка вулиця
присілок Дженджерівка	присілок Дженджерівка
Приточилівка вулиця	Приточилівка вулиця
Причепилівка вулиця	Причепилівка вулиця
Прокопівка вулиця	Прокопівка вулиця
Раківка вулиця	Раківка вулиця
Репехівка вулиця	Репехівка вулиця
Рибалківка вулиця	Рибалківка вулиця
Романівка вулиця	Романівка вулиця
Рубанівка вулиця	Рубанівка вулиця
Рябківка вулиця	Рябківка вулиця
Рябцівка вулиця	Рябцівка вулиця
Рясківка вулиця	Рясківка вулиця
Савонівка вулиця	Савонівка вулиця
Савчуківка вулиця	Савчуківка вулиця
Самари - Жоржівка - Колодяжне	Самари - Жоржівка - Колодяжне
Самойлівка вулиця	Самойлівка вулиця
Сарнівка вулиця	Сарнівка вулиця
Селезнівка вулиця	Селезнівка вулиця
село Власівка	село Власівка
Сигнівка вулиця	Сигнівка вулиця
Сидорівка вулиця	Сидорівка вулиця
Синичівка вулиця	Синичівка вулиця
Сичівка-II вулиця	Сичівка-II вулиця
Сіталівка вулиця	Сіталівка вулиця
Смирнівка вулиця	Смирнівка вулиця
Сокурівка вулиця	Сокурівка вулиця
Солдатівка вулиця	Солдатівка вулиця
Сомівка вулиця	Сомівка вулиця
Соснівка вулиця	Соснівка вулиця
Сотниківка вулиця	Сотниківка вулиця
Софонівка вулиця	Софонівка вулиця
Степанівка вулиця	Степанівка вулиця
Стременівка вулиця	Стременівка вулиця
Стрілківка вулиця	Стрілківка вулиця
Струсівка вулиця	Струсівка вулиця
Стягайлівка вулиця	Стягайлівка вулиця
Таранівка вулиця	Таранівка вулиця
Таранухівка вулиця	Таранухівка вулиця
Терехівка вулиця	Терехівка вулиця
Терешківка вулиця	Терешківка вулиця
Тернівка вулиця	Тернівка вулиця
Тимошівка вулиця	Тимошівка вулиця
Ткачівка вулиця	Ткачівка вулиця
Токарівка вулиця	Токарівка вулиця
Тракторівка вулиця	Тракторівка вулиця
Троянівка вулиця	Троянівка вулиця
Трубачівка вулиця	Трубачівка вулиця
Туківка вулиця	Туківка вулиця
Туманівка вулиця	Туманівка вулиця
Удодівка вулиця	Удодівка вулиця
Улянівка вулиця	Улянівка вулиця
Фегонівка вулиця	Фегонівка вулиця
Хандриківка вулиця	Хандриківка вулиця
Харківка вулиця	Харківка вулиця
Хоменківка вулиця	Хоменківка вулиця
Хоробрівка вулиця	Хоробрівка вулиця
Хрящівка вулиця	Хрящівка вулиця
Хутір Анастазівка вулиця	Хутір Анастазівка вулиця
Хутір Франівка вулиця	Хутір Франівка вулиця
Хуторівка вулиця	Хуторівка вулиця
Цетнерівка вулиця	Цетнерівка вулиця
Циганівка вулиця	Циганівка вулиця
Цикалівка вулиця	Цикалівка вулиця
Чабанівка вулиця	Чабанівка вулиця
Чайківка вулиця	Чайківка вулиця
Черепівка вулиця	Черепівка вулиця
Чернишівка вулиця	Чернишівка вулиця
Чигринівка вулиця	Чигринівка вулиця
Чонгарівка вулиця	Чонгарівка вулиця
Чубівка вулиця	Чубівка вулиця
Чупівка вулиця	Чупівка вулиця
Шандарівка вулиця	Шандарівка вулиця
Шарівка вулиця	Шарівка вулиця
Шахворостівка — Трудолюб	Шахворостівка — Трудолюб
Швабівка вулиця	Швабівка вулиця
Швейцарівка вулиця	Швейцарівка вулиця
Шелестівка вулиця	Шелестівка вулиця
Шоферівка вулиця	Шоферівка вулиця
Шунівка вулиця	Шунівка вулиця
Шуптарівка вулиця	Шуптарівка вулиця
Шутрівка вулиця	Шутрівка вулиця
Юківка вулиця	Юківка вулиця
Юрківка вулиця	Юрківка вулиця
Яворівка вулиця	Яворівка вулиця
Якубівка вулиця	Якубівка вулиця
Ялинівка вулиця	Ялинівка вулиця
Янівка вулиця	Янівка вулиця
Ярмолівка вулиця	Ярмолівка вулиця
Ярошівка вулиця	Ярошівка вулиця
Яцютівка вулиця	Яцютівка вулиця
Tарасівка вулиця	Тарасівка вулиця