А. Бондаренка вулиця	А. Бондаренка вулиця
А. Головка вулиця	А. Головка вулиця
А. Горбача вулиця	А. Горбача вулиця
А. Грубого вулиця	А. Грубого вулиця
А. Добраня вулиця	А. Добраня вулиця
А. Є. Фещенко вулиця	А. Є. Фещенко вулиця
А. Затуряна вулиця	А. Затуряна вулиця
А. Й. Філя вулиця	А. Й. Філя вулиця
А. Карпюк вулиця	А. Карпюк вулиця
А. Карташова	А. Карташова
А. Кирилюка вулиця	А. Кирилюка вулиця
А. Ковбля вулиця	А. Ковбля вулиця
А. Комка вулиця	А. Комка вулиця
А. Корнєва вулиця	А. Корнєва вулиця
А. Корольова вулиця	А. Корольова вулиця
А. Кошевого	А. Кошевого
А. Кренца вулиця	А. Кренца вулиця
А. Кренца провулок	А. Кренца провулок
А. Кривуляка вулиця	А. Кривуляка вулиця
А. М. Барановського вулиця	А. М. Барановського вулиця
А. Маслакова вулиця	А. Маслакова вулиця
А. Мельника вулиця	А. Мельника вулиця
А. Мікояна вулиця	А. Мікояна вулиця
А. О. Граговського вулиця	А. О. Граговського вулиця
А. Пелладі вулиця	А. Пелладі вулиця
А. Слюсаря вулиця	А. Слюсаря вулиця
А. Солов’яненка вулиця	А. Соловʼяненка вулиця
А. Співака вулиця	А. Співака вулиця
А. Стрілка вулиця	А. Стрілка вулиця
А. Тисленка вулиця	А. Тисленка вулиця
А. Трощілової вулиця	А. Трощілової вулиця
А. Цветкова вулиця	А. Цветкова вулиця
А. Чехов вулиця	А. Чехов вулиця
А. Чубарова вулиця	А. Чубарова вулиця
А.Джусова вулиця	А.Джусова вулиця
А.Джусова провулок	А.Джусова провулок
А.І.Коваля провулок	А.І.Коваля провулок
А.Комара вулиця	А.Комара вулиця
А.Кухара вулиця	А.Кухара вулиця
А.Молодана вулиця	А.Молодана вулиця
А.П. Семенюка вулиця	А.П. Семенюка вулиця
А.Пасічника вулиця	А.Пасічника вулиця
А.Семиволоса вулиця	А.Семиволоса вулиця
А.Солов’яненка вулиця	А.Соловʼяненка вулиця
А.Шептицького вулиця	А.Шептицького вулиця
Аллея имени Л.М. Литвиненко	Аллея имени Л.М. Литвиненко
Б. Герасимовича вулиця	Б. Герасимовича вулиця
Б. Грінченка вулиця	Б. Грінченка вулиця
Б. Завади	Б. Завади
Б. Калуша вулиця	Б. Калуша вулиця
Б. Козубського вулиця	Б. Козубського вулиця
Б. Козубського провулок	Б. Козубського провулок
Б. Колесника	Б. Колесника
Б. Колодченка вулиця	Б. Колодченка вулиця
Б. Лісна вулиця	Б. Лісна вулиця
Б. Пдвальна вулиця	Б. Пдвальна вулиця
Б. Струмінського вулиця	Б. Струмінського вулиця
Б. Хмельницкого вулиця	Б. Хмельницкого вулиця
Б. Хмельницького	Б. Хмельницького
Б. Хмельницького вулиця	Б. Хмельницького вулиця
Б. Хмельницького провулок	Б. Хмельницького провулок
Б. Чуперносівська вулиця	Б. Чуперносівська вулиця
Б.Пожарських вулиця	Б.Пожарських вулиця
Б.Ружинського вулиця	Б.Ружинського вулиця
Б.Хмельницького вулиця	Б.Хмельницького вулиця
Б.Хмельницького провулок	Б.Хмельницького провулок
Б.Шуляка вулиця	Б.Шуляка вулиця
В. А. Шнуренка вулиця	В. А. Шнуренка вулиця
В. Б. Турчина вулиця	В. Б. Турчина вулиця
В. Бєлінського вулиця	В. Бєлінського вулиця
В. Білозуба вулиця	В. Білозуба вулиця
В. Бондаренка вулиця	В. Бондаренка вулиця
В. Бондаренко вулиця	В. Бондаренко вулиця
В. Букача вулиця	В. Букача вулиця
В. Великого вулиця	В. Великого вулиця
В. Винниченка вулиця	В. Винниченка вулиця
В. Володарського вулиця	В. Володарського вулиця
В. Гарбузенка вулиця	В. Гарбузенка вулиця
В. Гнатчука вулиця	В. Гнатчука вулиця
В. Григорука вулиця	В. Григорука вулиця
В. Даля	В. Даля
В. Демченка вулиця	В. Демченка вулиця
В. Дубініна вулиця	В. Дубініна вулиця
В. Євича вулиця	В. Євича вулиця
В. Жуковського вулиця	В. Жуковського вулиця
В. Земляка вулиця	В. Земляка вулиця
В. Івасюка вулиця	В. Івасюка вулиця
В. Карпішина вулиця	В. Карпішина вулиця
В. Короленка вулиця	В. Короленка вулиця
В. Котика вулиця	В. Котика вулиця
В. Котика провулок	В. Котика провулок
В. Кузьмінова вулиця	В. Кузьмінова вулиця
В. Куца вулиця	В. Куца вулиця
В. Кучерявого вулиця	В. Кучерявого вулиця
В. Лісняка вулиця	В. Лісняка вулиця
В. Лістєва вулиця	В. Лістєва вулиця
В. Лобановського вулиця	В. Лобановського вулиця
В. Лучаківського вулиця	В. Лучаківського вулиця
В. Маковейчука вулиця	В. Маковейчука вулиця
В. Масленікова вулиця	В. Масленікова вулиця
В. Мельника вулиця	В. Мельника вулиця
В. Михайловського вулиця	В. Михайловського вулиця
В. Моцака вулиця	В. Моцака вулиця
В. Наумова провулок	В. Наумова провулок
В. Нестайка вулиця	В. Нестайка вулиця
В. Ніженського вулиця	В. Ніженського вулиця
В. Олейника	В. Олейника
В. Олійника вулиця	В. Олійника вулиця
В. Пастушенко вулиця	В. Пастушенко вулиця
В. Петрова вулиця	В. Петрова вулиця
В. Приходька вулиця	В. Приходька вулиця
В. Проценка вулиця	В. Проценка вулиця
В. Райського вулиця	В. Райського вулиця
В. Розкидного вулиця	В. Розкидного вулиця
В. С. Драгомира вулиця	В. С. Драгомира вулиця
В. С. Моргуненка вулиця	В. С. Моргуненка вулиця
В. С. Ульянова вулиця	В. С. Ульянова вулиця
В. Сагайдака вулиця	В. Сагайдака вулиця
В. Семенюка вулиця	В. Семенюка вулиця
В. Сильмана вулиця	В. Сильмана вулиця
В. Симиренка вулиця	В. Симиренка вулиця
В. Слісаренко вулиця	В. Слісаренко вулиця
В. Стуса вулиця	В. Стуса вулиця
В. Стуса провулок	В. Стуса провулок
В. Сухомлинського вулиця	В. Сухомлинського вулиця
В. Терешкової вулиця	В. Терешкової вулиця
В. Трохимчука вулиця	В. Трохимчука вулиця
В. Філатова вулиця	В. Філатова вулиця
В. Фоміна вулиця	В. Фоміна вулиця
В. Хоменка та Ш. Кобера вулиця	В. Хоменка та Ш. Кобера вулиця
В. Хромых	В. Хромых
В. Циганюка вулиця	В. Циганюка вулиця
В. Чорновола вулиця	В. Чорновола вулиця
В. Швеця вулиця	В. Швеця вулиця
В. Шевалева	В. Шевалева
В. Шевченка вулиця	В. Шевченка вулиця
В.Беделя вулиця	В.Беделя вулиця
В.Бережного вулиця	В.Бережного вулиця
В.Білого вулиця	В.Білого вулиця
В.Вернадського вулиця	В.Вернадського вулиця
В.Винниченка вулиця	В.Винниченка вулиця
В.Г. Шевченка вулиця	В.Г. Шевченка вулиця
В.Гончаренко вулиця	В.Гончаренко вулиця
В.Дарди провулок	В.Дарди провулок
В.Демченка вулиця	В.Демченка вулиця
В.Дрозда вулиця	В.Дрозда вулиця
В.Жука вулиця	В.Жука вулиця
В.Загноя вулиця	В.Загноя вулиця
В.І. Дяченка вулиця	В.І. Дяченка вулиця
В.І. Дяченко вулиця	В.І. Дяченко вулиця
В.Івасюка вулиця	В.Івасюка вулиця
В.Ілика вулиця	В.Ілика вулиця
В.Інтернаціоналістів вулиця	В.Інтернаціоналістів вулиця
В.Кириченко вулиця	В.Кириченко вулиця
В.Косіянчука вулиця	В.Косіянчука вулиця
В.Лучаківського вулиця	В.Лучаківського вулиця
В.М. Філоненка вулиця	В.М. Філоненка вулиця
В.М.Кавуна вулиця	В.М.Кавуна вулиця
В.Макуха вулиця	В.Макуха вулиця
В.Матвійчука вулиця	В.Матвійчука вулиця
В.Москальця вулиця	В.Москальця вулиця
В.Нежуримі вулиця	В.Нежуримі вулиця
В.Ніколаєнка вулиця	В.Ніколаєнка вулиця
В.Семенця вулиця	В.Семенця вулиця
В.Сергієнка вулиця	В.Сергієнка вулиця
В.Соколовського вулиця	В.Соколовського вулиця
В.Стуса вулиця	В.Стуса вулиця
В.Сухомлинського вулиця	В.Сухомлинського вулиця
В.Т. Гаращука вулиця	В.Т. Гаращука вулиця
В.Чабана вулиця	В.Чабана вулиця
В.Чорновола вулиця	В.Чорновола вулиця
В.Шевченка вулиця	В.Шевченка вулиця
Воронцова О. П. вулиця	Воронцова О. П. вулиця
Вул. В. Арнаутська	Вул. В. Арнаутська
Вул. Л. Толстого	Вул. Л. Толстого
вулиця Ангеліної П.	вулиця Ангеліної П.
вулиця Б. Хмельницького	вулиця Б. Хмельницького
вулиця В. Котика	вулиця В. Котика
вулиця В. Стуса	вулиця В. Стуса
вулиця В. Фокшука	вулиця В. Фокшука
вулиця Г. Плютинського	вулиця Г. Плютинського
вулиця Д. Карвацького	вулиця Д. Карвацького
вулиця Д. Чекмака	вулиця Д. Чекмака
вулиця З. Космодемянської	вулиця З. Космодемянської
вулиця К. Галкіна	вулиця К. Галкіна
вулиця К. Савури	вулиця К. Савури
вулиця К. Спотар	вулиця К. Спотар
вулиця К.Галкіна	вулиця К.Галкіна
вулиця Кобилянської О.	вулиця Кобилянської О.
вулиця Ковалевської С.	вулиця Ковалевської С.
вулиця Космодемянської З.	вулиця Космодемянської З.
вулиця Котика В.	вулиця Котика В.
вулиця Кошевого О.	вулиця Кошевого О.
вулиця Л. Колодуба	вулиця Л. Колодуба
вулиця Л. Толстого	вулиця Л. Толстого
вулиця Л. Українки	вулиця Л. Українки
вулиця Л. Шевцової	вулиця Л. Шевцової
вулиця М. Грушевського	вулиця М. Грушевського
вулиця М. Заньковецької	вулиця М. Заньковецької
вулиця М. Козака	вулиця М. Козака
вулиця М. Торези	вулиця М. Торези
вулиця М. Черемшини	вулиця М. Черемшини
вулиця Мирного П.	вулиця Мирного П.
вулиця Н. Яремчука	вулиця Н. Яремчука
вулиця Н. Яремчука	вулиця Н. Яремчука
вулиця О. Кобилянської	вулиця О. Кобилянської
вулиця О. Кошового	вулиця О. Кошового
вулиця О. Степанової	вулиця О. Степанової
вулиця П. Малинського	вулиця П. Малинського
вулиця П. Мирного	вулиця П. Мирного
вулиця П. Могили	вулиця П. Могили
вулиця С. Ковалевської	вулиця С. Ковалевської
вулиця С. Побережника	вулиця С. Побережника
вулиця С. Руданського	вулиця С. Руданського
вулиця С. Тулуба	вулиця С. Тулуба
вулиця Степанової О.	вулиця Степанової О.
вулиця Т. Бульби-Боровця	вулиця Т. Бульби-Боровця
вулиця Т. Шевченка	вулиця Т. Шевченка
вулиця Ю. Гагаріна	вулиця Ю. Гагаріна
вулиця Ю. Федьковича	вулиця Ю. Федьковича
вулиця Я. Яловеги	вулиця Я. Яловеги
Г. Бодні вулиця	Г. Бодні вулиця
Г. Бораковського вулиця	Г. Бораковського вулиця
Г. Гордасевич вулиця	Г. Гордасевич вулиця
Г. Красного провулок	Г. Красного провулок
Г. Охман вулиця	Г. Охман вулиця
Г. Повха вулиця	Г. Повха вулиця
Г. Повха провулок	Г. Повха провулок
Г. Романюка вулиця	Г. Романюка вулиця
Г. Сидорчук вулиця	Г. Сидорчук вулиця
Г. Тютюника вулиця	Г. Тютюника вулиця
Г. Херца вулиця	Г. Херца вулиця
Г. Шинкаря вулиця	Г. Шинкаря вулиця
Г.Барвінок вулиця	Г.Барвінок вулиця
Г.Жованик вулиця	Г.Жованик вулиця
Г.Жованик провулок	Г.Жованик провулок
Г.Лисенка вулиця	Г.Лисенка вулиця
Г.Морозової вулиця	Г.Морозової вулиця
Г.Пененка вулиця	Г.Пененка вулиця
Г.Перебийноса вулиця	Г.Перебийноса вулиця
Г.С. Савчука вулиця	Г.С. Савчука вулиця
Г.Шабалдіна вулиця	Г.Шабалдіна вулиця
Г.Яременка вулиця	Г.Яременка вулиця
Гаврилюка В. вулиця	Гаврилюка В. вулиця
Галіберди В. вулиця	Галіберди В. вулиця
Гарапина В. вулиця	Гарапина В. вулиця
Гачка П. вулиця	Гачка П. вулиця
Гвардії-генерала Гавенка Л.А. вулиця	Гвардії-генерала Гавенка Л.А. вулиця
Генерал-майора С. Кульчицького вулиця	Генерал-майора С. Кульчицького вулиця
Генерала М. Тарнавського провулок	Генерала М. Тарнавського провулок
Гетьманця Ф.Д. вулиця	Гетьманця Ф.Д. вулиця
Гжицького В. вулиця	Гжицького В. вулиця
Главный учебный корпус ЧВВМУ им. П. С. Нахимова	Главный учебный корпус ЧВВМУ им. П. С. Нахимова
Гравийная велодорожка (П.Поле - Пятихатки)	Гравийная велодорожка (П.Поле - Пятихатки)
Гравійна велодоріжка (П.Поле - П'ятихатки)	Гравійна велодоріжка (П.Поле - Пʼятихатки)
Д. Вітовського вулиця	Д. Вітовського вулиця
Д. Галицького вулиця	Д. Галицького вулиця
Д. Каравацького вулиця	Д. Каравацького вулиця
Д. Каравацького провулок	Д. Каравацького провулок
Д. Коваленка вулиця	Д. Коваленка вулиця
Д. Куриленка вулиця	Д. Куриленка вулиця
Д. Нечая вулиця	Д. Нечая вулиця
Д. Синяка вулиця	Д. Синяка вулиця
Д. Туптала вулиця	Д. Туптала вулиця
Д. Харько вулиця	Д. Харько вулиця
Д. Чабана вулиця	Д. Чабана вулиця
Д.Бєдного вулиця	Д.Бєдного вулиця
Д.Бідного вулиця	Д.Бідного вулиця
Д.Клячківського вулиця	Д.Клячківського вулиця
Д.Лопатка вулиця	Д.Лопатка вулиця
Д.Скрипниченка вулиця	Д.Скрипниченка вулиця
Д.Шевенка вулиця	Д.Шевенка вулиця
Д.Шелупця вулиця	Д.Шелупця вулиця
Дивіної Г. вулиця	Дивіної Г. вулиця
Дорога на Д.О Уголек	Дорога на Д.О Уголек
Дорога на Д.О. Угольок	Дорога на Д.О. Угольок
Є. М. Редька вулиця	Є. М. Редька вулиця
З. Космодем’ янської вулиця	З. Космодемʼ янської вулиця
З. Шумчук вулиця	З. Шумчук вулиця
З.Карпинської вулиця	З.Карпинської вулиця
З.Космодем’янської в’їзд	З.Космодем’янської вʼїзд
З.Космодем’янської вулиця	З.Космодемʼянської вулиця
З.Космодем’янської провулок	З.Космодемʼянської провулок
З.Серебрякової вулиця	З.Серебрякової вулиця
Зубка П. вулиця	Зубка П. вулиця
И. М. Світличного вулиця	И. М. Світличного вулиця
им. архитектора Краснова Н.П.	им. архитектора Краснова Н.П.
имени М. Македонского	имени М. Македонского
І. А. Шевченка вулиця	І. А. Шевченка вулиця
І. В. Войтенка вулиця	І. В. Войтенка вулиця
І. М. Гулого вулиця	І. М. Гулого вулиця
І.Г. Школьника вулиця	І.Г. Школьника вулиця
І.Д. Мусієнка вулиця	І.Д. Мусієнка вулиця
І.М.Скоропадського проспект	І.М.Скоропадського проспект
І.Ф. Попова вулиця	І.Ф. Попова вулиця
І.Ф.Кузьмука вулиця	І.Ф.Кузьмука вулиця
Ілляша Г.Я. вулиця	Ілляша Г.Я. вулиця
Ім. А. Волошина	Ім. А. Волошина
Ім. В. І. Леніна площа	Ім. В. І. Леніна площа
Ім. К. Г. Алексєєва вулиця	Ім. К. Г. Алексєєва вулиця
Ім. П. Грекова вулиця	Ім. П. Грекова вулиця
ім. Т. Г. Шевченка вулиця	ім. Т. Г. Шевченка вулиця
ім.В.Живодера вулиця	ім.В.Живодера вулиця
ім.Крайтора С.П. вулиця	ім.Крайтора С.П. вулиця
імені Г.М.Зубенка вулиця	імені Г.М.Зубенка вулиця
імені Героя України В. А. Сацького вулиця	імені Героя України В. А. Сацького вулиця
імені Героя України Сацького В. А. вулиця	імені Героя України Сацького В. А. вулиця
Й. Кліща вулиця	Й. Кліща вулиця
К. Галкіна вулиця	К. Галкіна вулиця
К. Галкіна провулок	К. Галкіна провулок
К. Заслонова вулиця	К. Заслонова вулиця
К. І. Богданова вулиця	К. І. Богданова вулиця
К. Каленика вулиця	К. Каленика вулиця
К. Маркса вулиця	К. Маркса вулиця
К. Медведенка вулиця	К. Медведенка вулиця
К. Наумчука вулиця	К. Наумчука вулиця
К. Терентюк вулиця	К. Терентюк вулиця
К. Цеткін вулиця	К. Цеткін вулиця
К. Шитіва вулиця	К. Шитіва вулиця
К.Гасієва провулок	К.Гасієва провулок
К.Маркса вулиця	К.Маркса вулиця
К.Маркса провулок	К.Маркса провулок
К.Основ’яненко провулок	К.Основʼяненко провулок
К.Розумовського вулиця	К.Розумовського вулиця
К.Розумовського провулок	К.Розумовського провулок
К.Цеткін вулиця	К.Цеткін вулиця
К.Шульженко в’їзд	К.Шульженко вʼїзд
Каптованця М. вулиця	Каптованця М. вулиця
Касараба В. вулиця	Касараба В. вулиця
Квака А.Ф. вулиця	Квака А.Ф. вулиця
Кірчева Б. вулиця	Кірчева Б. вулиця
Кісенка І.Г. вулиця	Кісенка І.Г. вулиця
Кобилянської О. вулиця	Кобилянської О. вулиця
Коваля С. вулиця	Коваля С. вулиця
Комісара Санюка В.І. вулиця	Комісара Санюка В.І. вулиця
Котика В. вулиця	Котика В. вулиця
Кошевого О. вулиця	Кошевого О. вулиця
Л. Бикова вулиця	Л. Бикова вулиця
Л. Вакуловської вулиця	Л. Вакуловської вулиця
Л. Войтюк вулиця	Л. Войтюк вулиця
Л. Голікова вулиця	Л. Голікова вулиця
Л. Голiкова вулиця	Л. Голiкова вулиця
Л. Горохівського провулок	Л. Горохівського провулок
Л. Каденюка вулиця	Л. Каденюка вулиця
Л. Каденюка провулок	Л. Каденюка провулок
Л. Кадинюка вулиця	Л. Кадинюка вулиця
Л. Кобилиці вулиця	Л. Кобилиці вулиця
Л. Котельник вулиця	Л. Котельник вулиця
Л. Ольховської вулиця	Л. Ольховської вулиця
Л. Рака вулиця	Л. Рака вулиця
Л. Симеренка вулиця	Л. Симеренка вулиця
Л. Скринчука вулиця	Л. Скринчука вулиця
Л. Татаренка провулок	Л. Татаренка провулок
Л. Толстого вулиця	Л. Толстого вулиця
Л. Убийвовк вулиця	Л. Убийвовк вулиця
Л. Чайкіної вулиця	Л. Чайкіної вулиця
Л. Швецової вулиця	Л. Швецової вулиця
Л.Панкова вулиця	Л.Панкова вулиця
Л.Панкова провулок	Л.Панкова провулок
Л.Ревуцького вулиця	Л.Ревуцького вулиця
Л.Толстого вулиця	Л.Толстого вулиця
Л.Українки провулок	Л.Українки провулок
Лактіонова П.Б. вулиця	Лактіонова П.Б. вулиця
Левенця Ю. вулиця	Левенця Ю. вулиця
Лікаря О. Богаєвського вулиця	Лікаря О. Богаєвського вулиця
Лузана В.М. вулиця	Лузана В.М. вулиця
М. Березовського вулиця	М. Березовського вулиця
М. Бурака провулок	М. Бурака провулок
М. В. Світайла	М. В. Світайла
М. Вакалюк-Дорошенко вулиця	М. Вакалюк-Дорошенко вулиця
М. Галичанського вулиця	М. Галичанського вулиця
М. Гастелло вулиця	М. Гастелло вулиця
М. Гоголя вулиця	М. Гоголя вулиця
М. Гоголя провулок	М. Гоголя провулок
М. Городка вулиця	М. Городка вулиця
М. Горького вулиця	М. Горького вулиця
М. Горького провулок	М. Горького провулок
М. Грушевського вулиця	М. Грушевського вулиця
М. Драгоманова вулиця	М. Драгоманова вулиця
М. Емінеску вулиця	М. Емінеску вулиця
М. Євтушенка провулок	М. Євтушенка провулок
М. Закович вулиця	М. Закович вулиця
М. Залізняка провулок	М. Залізняка провулок
М. Заньковецької вулиця	М. Заньковецької вулиця
М. Зарудного вулиця	М. Зарудного вулиця
М. Зарудного провулок	М. Зарудного провулок
М. Іщака вулиця	М. Іщака вулиця
М. Ковальчука вулиця	М. Ковальчука вулиця
М. Козака вулиця	М. Козака вулиця
М. Козачинського вулиця	М. Козачинського вулиця
М. Коцюбинського вулиця	М. Коцюбинського вулиця
М. Кривоноса вулиця	М. Кривоноса вулиця
М. Куліша вулиця	М. Куліша вулиця
М. Куценко вулиця	М. Куценко вулиця
М. Кучерявця вулиця	М. Кучерявця вулиця
М. Ларкової вулиця	М. Ларкової вулиця
М. Лєрмонтова вулиця	М. Лєрмонтова вулиця
М. Лисенка вулиця	М. Лисенка вулиця
М. Ломоносова вулиця	М. Ломоносова вулиця
М. Людкевича вулиця	М. Людкевича вулиця
М. Максимовича вулиця	М. Максимовича вулиця
М. Міхновького провулок	М. Міхновького провулок
М. Немолота вулиця	М. Немолота вулиця
М. Овчаренка вулиця	М. Овчаренка вулиця
М. Озерного вулиця	М. Озерного вулиця
М. Онищенка вулиця	М. Онищенка вулиця
М. Орла вулиця	М. Орла вулиця
М. Остапчука вулиця	М. Остапчука вулиця
М. Островського вулиця	М. Островського вулиця
М. Павел вулиця	М. Павел вулиця
М. Павлюка вулиця	М. Павлюка вулиця
М. Павника вулиця	М. Павника вулиця
М. Пирогова вулиця	М. Пирогова вулиця
М. Плавуча - Козлів	М. Плавуча - Козлів
М. Погорілого вулиця	М. Погорілого вулиця
М. Пошедіна вулиця	М. Пошедіна вулиця
М. Процевського вулиця	М. Процевського вулиця
М. Раскової вулиця	М. Раскової вулиця
М. Рильського вулиця	М. Рильського вулиця
М. Руденка вулиця	М. Руденка вулиця
М. Руденка провулок	М. Руденка провулок
М. Світайла вулиця	М. Світайла вулиця
М. Семенця провулок	М. Семенця провулок
М. Сліпця вулиця	М. Сліпця вулиця
М. Смотрицького вулиця	М. Смотрицького вулиця
М. Стахівської вулиця	М. Стахівської вулиця
М. Стельмаха вулиця	М. Стельмаха вулиця
М. Ткаченка вулиця	М. Ткаченка вулиця
М. Хапланова провулок	М. Хапланова провулок
М. Холода вулиця	М. Холода вулиця
М. Чухрай вулиця	М. Чухрай вулиця
М. Шарика вулиця	М. Шарика вулиця
М. Швецова вулиця	М. Швецова вулиця
М. Юр’єва вулиця	М. Юрʼєва вулиця
М.Биченка вулиця	М.Биченка вулиця
М.Братана вулиця	М.Братана вулиця
М.Вершила вулиця	М.Вершила вулиця
М.Вовчка вулиця	М.Вовчка вулиця
М.Вовчка провулок	М.Вовчка провулок
М.Г. Гоженка вулиця	М.Г. Гоженка вулиця
М.Галагана вулиця	М.Галагана вулиця
М.Горького вулиця	М.Горького вулиця
М.Гребенюка вулиця	М.Гребенюка вулиця
М.Грушевського вулиця	М.Грушевського вулиця
М.Демченка вулиця	М.Демченка вулиця
М.Драгоманова вулиця	М.Драгоманова вулиця
М.Заньковецької вулиця	М.Заньковецької вулиця
М.Козіна вулиця	М.Козіна вулиця
М.Костомарова вулиця	М.Костомарова вулиця
М.Коцюбинського вулиця	М.Коцюбинського вулиця
М.Кривоноса вулиця	М.Кривоноса вулиця
М.Кропивницького вулиця	М.Кропивницького вулиця
М.Лаврова вулиця	М.Лаврова вулиця
М.Лагунової вулиця	М.Лагунової вулиця
М.М. Коцюбинського вулиця	М.М. Коцюбинського вулиця
М.М. Миклухо-Маклая вулиця	М.М. Миклухо-Маклая вулиця
М.М.Ге вулиця	М.М.Ге вулиця
М.Матеюка вулиця	М.Матеюка вулиця
М.Пирогова провулок	М.Пирогова провулок
М.Пігорєва вулиця	М.Пігорєва вулиця
М.Плавуча - Козлів	М.Плавуча - Козлів
М.Рильського вулиця	М.Рильського вулиця
М.Старицького вулиця	М.Старицького вулиця
М.Стахівської вулиця	М.Стахівської вулиця
М.Томака вулиця	М.Томака вулиця
М.Харченка вулиця	М.Харченка вулиця
М.Чурай вулиця	М.Чурай вулиця
Миколайчука В. вулиця	Миколайчука В. вулиця
Моргуна М. І. вулиця	Моргуна М. І. вулиця
МПС СТ.МАКЕЕВКА-ПСАС.	МПС СТ.МАКЕЕВКА-ПСАС.
Музики М.А. вулиця	Музики М.А. вулиця
Н. Білявської вулиця	Н. Білявської вулиця
Н. Зборовської вулиця	Н. Зборовської вулиця
Н. Крицької вулиця	Н. Крицької вулиця
Н. Курченко в'їзд	Н. Курченко вʼїзд
Н. Курченко вулиця	Н. Курченко вулиця
Н. Курченко провулок	Н. Курченко провулок
Н. Левицького вулиця	Н. Левицького вулиця
Н. Морозенка вулиця	Н. Морозенка вулиця
Н. Откаленко вулиця	Н. Откаленко вулиця
Н. Поліщук провулок	Н. Поліщук провулок
Н. Присяжнюк вулиця	Н. Присяжнюк вулиця
Н. С. Говорун вулиця	Н. С. Говорун вулиця
Н. Сагайдак вулиця	Н. Сагайдак вулиця
Н. Сосніної вулиці	Н. Сосніної вулиці
Н. Сосніної вулиця	Н. Сосніної вулиця
Н. Тамарли	Н. Тамарли
Н. Яремчука вулиця	Н. Яремчука вулиця
Н.Д.Чекмак вулиця	Н.Д.Чекмак вулиця
Н.Ужвій вулиця	Н.Ужвій вулиця
Н.Яремчука вулиця	Н.Яремчука вулиця
Набережна В.І.Леніна вулиця	Набережна В.І.Леніна вулиця
Набережная имени В. И. Ленина	Набережная имени В. И. Ленина
О. Антонова вулиця	О. Антонова вулиця
О. Атаманчука вулиця	О. Атаманчука вулиця
О. Барабан вулиця	О. Барабан вулиця
О. Беляєва вулиця	О. Беляєва вулиця
О. Богуша вулиця	О. Богуша вулиця
О. Босого вулиця	О. Босого вулиця
О. Буракова вулиця	О. Буракова вулиця
О. Вишні вулиця	О. Вишні вулиця
О. Гаруса вулиця	О. Гаруса вулиця
О. Герцена вулиця	О. Герцена вулиця
О. Гончара вулиця	О. Гончара вулиця
О. Грибоєдова вулиця	О. Грибоєдова вулиця
О. Довбуша вулиця	О. Довбуша вулиця
О. Довженка вулиця	О. Довженка вулиця
О. Домахової вулиця	О. Домахової вулиця
О. Жабинця вулиця	О. Жабинця вулиця
О. Заєць вулиця	О. Заєць вулиця
О. Ількова вулиця	О. Ількова вулиця
О. Йолтуховського вулиця	О. Йолтуховського вулиця
О. Кабалюка вулиця	О. Кабалюка вулиця
О. Кобилянської вулиця	О. Кобилянської вулиця
О. Ковча вулиця	О. Ковча вулиця
О. Комиза вулиця	О. Комиза вулиця
О. Кошевого вулиця	О. Кошевого вулиця
О. Кошового вулиця	О. Кошового вулиця
О. Кошового провулок	О. Кошового провулок
О. Кутузова вулиця	О. Кутузова вулиця
О. Ливадара вулиця	О. Ливадара вулиця
О. Лятуринської вулиця	О. Лятуринської вулиця
О. Маньківського вулиця	О. Маньківського вулиця
О. Матросова вулиця	О. Матросова вулиця
О. Методів вулиця	О. Методів вулиця
О. Морозенка вулиця	О. Морозенка вулиця
О. Мосягіна вулиця	О. Мосягіна вулиця
О. Невського бічна вулиця	О. Невського бічна вулиця
О. невського вулиця	О. невського вулиця
О. Невського вулиця	О. Невського вулиця
О. Невського-бічна вулиця	О. Невського-бічна вулиця
О. Островського вулиця	О. Островського вулиця
О. Пахучого вулиця	О. Пахучого вулиця
О. Пахучого провулок	О. Пахучого провулок
О. Паценко вулиця	О. Паценко вулиця
О. Пікула вулиця	О. Пікула вулиця
О. Пушкина вулиця	О. Пушкина вулиця
О. Пушкіна вулиця	О. Пушкіна вулиця
О. Ремінного вулиця	О. Ремінного вулиця
О. С. Шваб вулиця	О. С. Шваб вулиця
О. Степанової вулиця	О. Степанової вулиця
О. Стовби провулок	О. Стовби провулок
О. Стрелюка вулиця	О. Стрелюка вулиця
О. Тихого вулиця	О. Тихого вулиця
О. Ткача вулиця	О. Ткача вулиця
О. Холод вулиця	О. Холод вулиця
О. Цмушко вулиця	О. Цмушко вулиця
О. Чернявського вулиця	О. Чернявського вулиця
О. Шліхтера вулиця	О. Шліхтера вулиця
О.Бельдемана вулиця	О.Бельдемана вулиця
О.Бобикевича вулиця	О.Бобикевича вулиця
О.Вересая провулок	О.Вересая провулок
О.Вишні вулиця	О.Вишні вулиця
О.Г. Кулика вулиця	О.Г. Кулика вулиця
О.Гончара вулиця	О.Гончара вулиця
О.Гончара провулок	О.Гончара провулок
О.Дашкевича	О.Дашкевича
О.Довженка вулиця	О.Довженка вулиця
О.Кобилянської вулиця	О.Кобилянської вулиця
О.Кошового вулиця	О.Кошового вулиця
О.Кошовогов вулиця	О.Кошовогов вулиця
О.Леонової вулиця	О.Леонової вулиця
О.Ліфінцева вулиця	О.Ліфінцева вулиця
О.Лятуринської вулиця	О.Лятуринської вулиця
О.Мазуренка вулиця	О.Мазуренка вулиця
О.Матросова вулиця	О.Матросова вулиця
О.П. Довженка вулиця	О.П. Довженка вулиця
О.П. Сидоришина вулиця	О.П. Сидоришина вулиця
О.Розумовського вулиця	О.Розумовського вулиця
О.Сокола вулиця	О.Сокола вулиця
О.Тараненка вулиця	О.Тараненка вулиця
О.Щербака вулиця	О.Щербака вулиця
О.Щербака провулок	О.Щербака провулок
П. Ангеліної вулиця	П. Ангеліної вулиця
П. Ангеліної проспект	П. Ангеліної проспект
П. Артеменка вулиця	П. Артеменка вулиця
П. Білошицького вулиця	П. Білошицького вулиця
П. В. Балабуєва вулиця	П. В. Балабуєва вулиця
П. Голосовського вулиця	П. Голосовського вулиця
П. Гречаного вулиця	П. Гречаного вулиця
П. Гутченка вулиця	П. Гутченка вулиця
П. Зайвого вулиця	П. Зайвого вулиця
П. Кізіма провулок	П. Кізіма провулок
П. Коваленка вулиця	П. Коваленка вулиця
П. Комуни провулок	П. Комуни провулок
П. Кондратюка вулиця	П. Кондратюка вулиця
П. Косенка провулок	П. Косенка провулок
П. Мазура вулиця	П. Мазура вулиця
П. Малєєва вулиця	П. Малєєва вулиця
П. Мирного вулиця	П. Мирного вулиця
П. Морозова вулиця	П. Морозова вулиця
П. Морозова провулок	П. Морозова провулок
П. Нахімова вулиця	П. Нахімова вулиця
П. Орлика провулок	П. Орлика провулок
П. Осипенко вулиця	П. Осипенко вулиця
П. Осіпенко вулиця	П. Осіпенко вулиця
П. П. Бовсунівського вулиця	П. П. Бовсунівського вулиця
П. Пенкальського вулиця	П. Пенкальського вулиця
П. Підмирного вулиця	П. Підмирного вулиця
П. Покришева вулиця	П. Покришева вулиця
П. Поповича вулиця	П. Поповича вулиця
П. Радзіховського вулиця	П. Радзіховського вулиця
П. Савєльєвої вулиця	П. Савєльєвої вулиця
П. Сагайдачного вулиця	П. Сагайдачного вулиця
П. Сангушка вулиця	П. Сангушка вулиця
П. Сахна вулиця	П. Сахна вулиця
П. Тичини	П. Тичини
П. Тюкова	П. Тюкова
П. Ходневича вулиця	П. Ходневича вулиця
П. Чайковського вулиця	П. Чайковського вулиця
П. Чубинського вулиця	П. Чубинського вулиця
П. Шутки провулок	П. Шутки провулок
П.Биловоды	П.Биловоды
П.Каплуна вулиця	П.Каплуна вулиця
П.Кізіма вулиця	П.Кізіма вулиця
П.Куліша вулиця	П.Куліша вулиця
П.Мирного вулиця	П.Мирного вулиця
П.Орлика вулиця	П.Орлика вулиця
П.Осипенко вулиця	П.Осипенко вулиця
П.Прокоповича вулиця	П.Прокоповича вулиця
П.Рябоконя вулиця	П.Рябоконя вулиця
П.Тольятті	П.Тольятті
П.Шутки в’їзд	П.Шутки вʼїзд
парк имени К.А. Тренёва	парк имени К.А. Тренёва
Пелешко Н. вулиця	Пелешко Н. вулиця
Пендрака В.А. вулиця	Пендрака В.А. вулиця
Полонського М. вулиця	Полонського М. вулиця
Попова О.С. вулиця	Попова О.С. вулиця
Поручника УГА М.Баклащука вулиця	Поручника УГА М.Баклащука вулиця
пров. О.Кобилянської	пров. О.Кобилянської
провулок Д. Карвацького	провулок Д. Карвацького
провулок К. Галкіна	провулок К. Галкіна
провулок Н. Яремчука	провулок Н. Яремчука
провулок П. Малинського	провулок П. Малинського
провулок Ю. Федьковича	провулок Ю. Федьковича
провулок Ю. Федьковича	провулок Ю. Федьковича
Р. Бевза вулиця	Р. Бевза вулиця
Р. Дульнєва вулиця	Р. Дульнєва вулиця
Р. Кравчука вулиця	Р. Кравчука вулиця
Р. Люксембург вулиця	Р. Люксембург вулиця
Р. Ф. Льва вулиця	Р. Ф. Льва вулиця
Р. Шухевича вулиця	Р. Шухевича вулиця
Р.Люксембург вулиця	Р.Люксембург вулиця
Р.Шухевича вулиця	Р.Шухевича вулиця
Ревка П.І. вулиця	Ревка П.І. вулиця
Рибаса Т.М. вулиця	Рибаса Т.М. вулиця
Річкова - Н. Сосніної вулиця	Річкова - Н. Сосніної вулиця
Рябухи М.Л. вулиця	Рябухи М.Л. вулиця
С. Аксакова вулиця	С. Аксакова вулиця
С. Архитко вулиця	С. Архитко вулиця
С. Базильчука вулиця	С. Базильчука вулиця
С. Бойченка вулиця	С. Бойченка вулиця
С. Дворчина вулиця	С. Дворчина вулиця
С. Єсеніна вулиця	С. Єсеніна вулиця
С. Захожого провулок	С. Захожого провулок
С. Збінського вулиця	С. Збінського вулиця
С. Змачинського вулиця	С. Змачинського вулиця
С. Ковалевської вулиця	С. Ковалевської вулиця
С. Коваленка вулиця	С. Коваленка вулиця
С. Корольова вулиця	С. Корольова вулиця
С. Крушельницької вулиця	С. Крушельницької вулиця
С. Куниці вулиця	С. Куниці вулиця
С. Лялевича вулиця	С. Лялевича вулиця
С. Марченка провулок	С. Марченка провулок
С. Наливайка вулиця	С. Наливайка вулиця
С. Нігояна вулиця	С. Нігояна вулиця
С. Олійника вулиця	С. Олійника вулиця
С. Савчука вулиця	С. Савчука вулиця
С. Стецько вулиця	С. Стецько вулиця
С. Тельнюка вулиця	С. Тельнюка вулиця
С. Тюленіна вулиця	С. Тюленіна вулиця
С.Базильчука вулиця	С.Базильчука вулиця
С.В.Даневича вулиця	С.В.Даневича вулиця
С.І. Болгарина вулиця	С.І. Болгарина вулиця
С.І.Довгого вулиця	С.І.Довгого вулиця
С.Ковальчука вулиця	С.Ковальчука вулиця
С.Крушельницької вулиця	С.Крушельницької вулиця
С.Кучера вулиця	С.Кучера вулиця
С.Лазо вулиця	С.Лазо вулиця
С.Наливайка вулиця	С.Наливайка вулиця
С.Олійника вулиця	С.Олійника вулиця
С.Перовської провулок	С.Перовської провулок
С.Проволоцької вулиця	С.Проволоцької вулиця
С.Разіна вулиця	С.Разіна вулиця
С.Сурженка вулиця	С.Сурженка вулиця
С.Тулуба вулиця	С.Тулуба вулиця
С.Ф. Орлова вулиця	С.Ф. Орлова вулиця
С.Шилова вулиця	С.Шилова вулиця
Садового С. Н. вулиця	Садового С. Н. вулиця
Скаржинського Й.П. вулиця	Скаржинського Й.П. вулиця
Сквер на Вулиці В. Чорновола	Сквер на Вулиці В. Чорновола
Созанського О. вулиця	Созанського О. вулиця
Стежка до пам'ятника Т.Шевченка	Стежка до памʼятника Т.Шевченка
Т. Г. Шевченка вулиця	Т. Г. Шевченка вулиця
Т. Г. Шевченка площа	Т. Г. Шевченка площа
Т. Короля вулиця	Т. Короля вулиця
Т. Шевченка вулиця	Т. Шевченка вулиця
Т.Г. Шевченка вулиця	Т.Г. Шевченка вулиця
Т.Г. Шевченко вулиця	Т.Г. Шевченко вулиця
Т.Г.Шевченка вулиця	Т.Г.Шевченка вулиця
Т.Г.Шевченка площа	Т.Г.Шевченка площа
Т.Кралі вулиця	Т.Кралі вулиця
Т.Кралі провулок	Т.Кралі провулок
Т.Шевченка вулиця	Т.Шевченка вулиця
Толстого Л. вулиця	Толстого Л. вулиця
Томенка М.Д. вулиця	Томенка М.Д. вулиця
Труханського Р. вулиця	Труханського Р. вулиця
Труша В. вулиця	Труша В. вулиця
Турко Д. П. вулиця	Турко Д. П. вулиця
У. Клубная	У. Клубная
Узвізна вулиця - П. В. Балабуєва	Узвізна вулиця - П. В. Балабуєва
Ф. Василенка вулиця	Ф. Василенка вулиця
Ф. Горбаша вулиця	Ф. Горбаша вулиця
Ф. Енгельса вулиця	Ф. Енгельса вулиця
Ф. Лісового	Ф. Лісового
Ф. Пішеніна вулиця	Ф. Пішеніна вулиця
Ф. Приходька провулок	Ф. Приходька провулок
Ф. Хмеля вулиця	Ф. Хмеля вулиця
Ф. Шпига вулиця	Ф. Шпига вулиця
Ф.М. Кузьменка вулиця	Ф.М. Кузьменка вулиця
Ф.П. Погребенника вулиця	Ф.П. Погребенника вулиця
Ф.С.Юрченка вулиця	Ф.С.Юрченка вулиця
Холодного А. вулиця	Холодного А. вулиця
Чуйка О. вулиця	Чуйка О. вулиця
Ш. Антоновича вулиця	Ш. Антоновича вулиця
Швецова М. вулиця	Швецова М. вулиця
Шевченка Т.Г. вулиця	Шевченка Т.Г. вулиця
Шевченка/О.Кошового	Шевченка/О.Кошового
Шелудька В. вулиця	Шелудька В. вулиця
Шептицького А. вулиця	Шептицького А. вулиця
Щасливого П. вулиця	Щасливого П. вулиця
Э.Топчи	Э.Топчи
Ю. Березовського вулиця	Ю. Березовського вулиця
Ю. Бурка вулиця	Ю. Бурка вулиця
Ю. Бурка провулок	Ю. Бурка провулок
Ю. Вашка вулиця	Ю. Вашка вулиця
Ю. Гагаріна вулиця	Ю. Гагаріна вулиця
Ю. Гагаріна провулок	Ю. Гагаріна провулок
Ю. Голополосова вулиця	Ю. Голополосова вулиця
Ю. Голополосова провулок	Ю. Голополосова провулок
Ю. Гудзя вулиця	Ю. Гудзя вулиця
Ю. Жуковського вулиця	Ю. Жуковського вулиця
Ю. Ковтуна	Ю. Ковтуна
Ю. Тихомирова вулиця	Ю. Тихомирова вулиця
Ю. Федьковича вулиця	Ю. Федьковича вулиця
Ю.Бутусова вулиця	Ю.Бутусова вулиця
Ю.Курія вулиця	Ю.Курія вулиця
Ю.М.Устенко вулиця	Ю.М.Устенко вулиця
Ю.Максимчука вулиця	Ю.Максимчука вулиця
Ю.Рябчинської вулиця	Ю.Рябчинської вулиця
Ю.Смирнова вулиця	Ю.Смирнова вулиця
Ю.Смирнова провулок	Ю.Смирнова провулок
Я. Білика вулиця	Я. Білика вулиця
Я. Дем'янишина вулиця	Я. Демʼянишина вулиця
Я. Іщенка вулиця	Я. Іщенка вулиця
Я. Каменського вулиця	Я. Каменського вулиця
Я. Мудрого вулиця	Я. Мудрого вулиця
Я. Новосільського провулок	Я. Новосільського провулок
Я. Падалки провулок	Я. Падалки провулок
Я.Малишенка вулиця	Я.Малишенка вулиця
Я.Мудрого вулиця	Я.Мудрого вулиця
Я.Острозького вулиця	Я.Острозького вулиця
Янюка М. вулиця	Янюка М. вулиця