Адмірала Басистого вулиця	вулиця Адмірала Басистого
Адмірала Щасного вулиця	вулиця Адмірала Щасного
Академіка Белецького вулиця	вулиця Академіка Белецького
Андрузького вулиця	вулиця Андрузького
Архітектора Метельницького вулиця	вулиця Архітектора Метельницького
Багрицкого вулиця	вулиця Багрицкого
Безгребельного вулиця	вулиця Безгребельного
Бездворного вулиця	вулиця Бездворного
Бездільного вулиця	вулиця Бездільного
Безкаравайного вулиця	вулиця Безкаравайного
Безроднього вулиця	вулиця Безроднього
Безценного вулиця	вулиця Безценного
Белецького вулиця	вулиця Белецького
Бережницького вулиця	вулиця Бережницького
Березневого Повстання вулиця	вулиця Березневого Повстання
Блакитного вулиця	вулиця Блакитного
Блакитного провулок	провулок Блакитного
Борлуцького провулок	провулок Борлуцького
Боровіцького вулиця	вулиця Боровіцького
Броніцького вулиця	вулиця Броніцького
Брязького вулиця	вулиця Брязького
Будьоннного вулиця	вулиця Будьоннного
Будьоного вулиця	вулиця Будьоного
Будьоного провулок	провулок Будьоного
Бузького Козацтва вулиця	вулиця Бузького Козацтва
Бузького полку вулиця	вулиця Бузького полку
Бурлуцького вулиця	вулиця Бурлуцького
Бурлуцького провулок	провулок Бурлуцького
Бiлецького вулиця	вулиця Білецького
Василенького вулиця	вулиця Василенького
Великого Жовтня вулиця	вулиця Великого Жовтня
Вербовецького вулиця	вулиця Вербовецького
Вирового провулок	провулок Вирового
Висоцкого вулиця	вулиця Висоцького
Вишиваного вулиця	вулиця Вишиваного
Вишневького вулиця	вулиця Вишневького
Вишнивецького вулиця	вулиця Вишнивецького
Вільного козацтва вулиця	вулиця Вільного Козацтва
Вільного Козацтва вулиця	вулиця Вільного Козацтва
Вітряного вулиця	вулиця Вітряного
Віце-адмірала Синецького вулиця	вулиця Віце-адмірала Синецького
Вольного вулиця	вулиця Вольного
Воровского вулиця	вулиця Воровского
Воротного вулиця	вулиця Воротного
Восьмого Березня вулиця	вулиця 8 Березня
Восьмого Березня провулок	провулок 8 Березня
Восьмого з’їзду Рад вулиця	вулиця VIII Зʼїзду Рад
Вугільного Путі вулиця	вулиця Вугільного Путі
Гадяцького Договору вулиця	вулиця Гадяцького Договору
Гаевого квартал	квартал Гаевого
Гаєвого вулиця	вулиця Гаєвого
Генерала Горішного вулиця	вулиця Генерала Горішного
Генерала Грушевого вулиця	вулиця Генерала Грушевого
Героїв Зимового Походу провулок	провулок Героїв Зимового Походу
Геруцького вулиця	вулиця Геруцького
Гижицького вулиця	вулиця Гижицького
Гнідого вулиця	вулиця Гнідого
Говорецького вулиця	вулиця Говорецького
Горішного вулиця	вулиця Горішного
Горовецького вулиця	вулиця Горовецького
Горовецького провулок	провулок Горовецького
Грабовсьеого вулиця	вулиця Грабовсьеого
Грушевского вулиця	вулиця Грушевского
Грязного провулок	провулок Грязного
Далекого вулиця	вулиця Далекого
Даргомизкого вулиця	вулиця Даргомизкого
Дачі Песецького вулиця	вулиця Дачі Песецького
Двадцять Другого Січня в’їзд	вʼїзд 22 Січня
Двадцять Третього Серпня вулиця	вулиця 23 Серпня
Двадцять Третього Серпня провулок	провулок 23 Серпня
Дванадцятого Квітня вулиця	вулиця 12 Квітня
Дверницького вулиця	вулиця Дверницького
Двухбабного вулиця	вулиця Двухбабного
Дзержинcкого квартал	квартал Дзержинского
Добровольского вулиця	вулиця Добровольского
Доброго дуба вулиця	вулиця Доброго Дуба
Доброго шляху вулиця	вулиця Доброго Шляху
Добродецького вулиця	вулиця Добродецького
Добродецького перевулок	провулок Добродецького
Дражевского вулиця	вулиця Дражевского
Дробоцького алея	алея Дробоцького
Дрогобицького Повстання вулиця	вулиця Дрогобицького Повстання
Дубецького вулиця	вулиця Дубецького
Дубинецького вулиця	вулиця Дубинецького
Дубовецького вулиця	вулиця Дубовецького
Дужого вулиця	вулиця Дужого
Еміліана Невицького вулиця	вулиця Еміліана Невицького
Желєзного в'їзд	вʼїзд Желєзного
Желєзного вулиця	вулиця Желєзного
Жжоного вулиця	вулиця Жжонова
Жирного вулиця	вулиця Жирного
Заборного вулиця	вулиця Заборного
Загайного вулиця	вулиця Загайного
Загуменного вулиця	вулиця Загуменного
Загуменного провулок	провулок Загуменного
Закоршм'яного вулиця	вулиця Закоршмʼяного
Заливчого вулиця	вулиця Заливчого
Заливчого провулок	провулок Заливчого
Залозецького вулиця	вулиця Залозецького
Залозецького провулок	провулок Залозецького
Залотоцького вулиця	вулиця Залотоцького
Заможного вулиця	вулиця Заможного
Заплішнього вулиця	вулиця Заплішнього
Запорізького Козацтва вулиця	вулиця Запорізького Козацтва
Запорізького Козацтва провулок	провулок Запорізького Козацтва
Зацного вулиця	вулиця Зацного
Зачорного вулиця	вулиця Зачорного
Зенітного Полку вулиця	вулиця Зенітного Полку
Зерваницького вулиця	вулиця Зерваницького
Злоцького вулиця	вулиця Злоцького
Інтернаціонального легіону вулиця	вулиця Інтернаціонального Легіону
Камишного вулиця	вулиця Камишного
Карбівничого провулок	провулок Карбівничого
Карбулицького вулиця	вулиця Карбулицького
Карпенко-Карого вулиця	вулиця Карпенко-Карого
Кибального вулиця	вулиця Кибального
Княгиницького вулиця	вулиця Княгиницького
Ковшевацького вулиця	вулиця Ковшевацького
Кодацького вулиця	вулиця Кодацького
Комнацького вулиця	вулиця Комнацького
Коноплястого вулиця	вулиця Коноплястого
Корвацького проїзд	проїзд Корвацького
Коренецького вулиця	вулиця Коренецького
Котляревского вулиця	вулиця Котляревского
Котлярєвского вулиця	вулиця Котлярєвского
Котовского вулиця	вулиця Котовского
Котовсього вулиця	вулиця Котовсього
Кошевого вулиця	вулиця Кошевого
Красницького повіту вулиця	вулиця Красницького Повіту
Красносельского проспект	проспект Красносельского
Кудрявицького вулиця	вулиця Кудрявицького
Кузенного вулиця	вулиця Кузенного
Курячого вулиця	вулиця Курячого
Кутвицького вулиця	вулиця Кутвицького
Лавицького вулиця	вулиця Лавицького
Ланецького вулиця	вулиця Ланецького
Лейтенанта Попружного вулиця	вулиця Лейтенанта Попружного
Леуцького вулиця	вулиця Леуцького
Леуцького тупік	Леуцького тупік
Листопадового Чину вулиця	вулиця Листопадового Чину
Лихого вулиця	вулиця Лихого
Лицарів Зимового походу вулиця	вулиця Лицарів Зимового Походу
Лучицького вулиця	вулиця Лучицького
Лучного вулиця	вулиця Лучного
Любімого вулиця	вулиця Любімого
Магдебурзького Права вулиця	вулиця Магдебурзького Права
Майбутнього вулиця	вулиця Майбутнього
Маковского вулиця	вулиця Маковского
Малиновского вулиця	вулиця Малиновского
Марицького вулиця	вулиця Марицького
Мархоцького вулиця	вулиця Мархоцького
Маршала Батицького вулиця	вулиця Маршала Батицького
Маршала Будьоного вулиця	вулиця Маршала Будьоного
Маяковского вулиця	вулиця Маяковского
Маяковского провулок	провулок Маяковского
Маяковского проспект	проспект Маяковского
Медведцького вулиця	вулиця Медведцького
Мерецького вулиця	вулиця Мерецького
Милого вулиця	вулиця Милого
Михаила Грушевского вулиця	вулиця Михайла Грушевського
Могильницького вулиця	вулиця Могильницького
Молодчого вулиця	вулиця Молодчого
Морецького вулиця	вулиця Морецького
Мохового вулиця	вулиця Мохового
Мурого вулиця	вулиця Мурого
Мусорского вулиця	вулиця Мусорского
Надольного вулиця	вулиця Надольного
Наліваного вулиця	вулиця Наліваного
Нарижного вулиця	вулиця Нарижного
Наукового Містечка вулиця	вулиця Наукового Містечка
Національного Відродження вулиця	вулиця Національного Відродження
Національного Відродження площа	площа Національного Відродження
Національного Прапора вулиця	вулиця Національного Прапора
Національного Прапора провулок	провулок Національного Прапора
Невідомого Бійця вулиця	вулиця Невідомого Бійця
Невідомого Солдата вулиця	вулиця Невідомого Солдата
Новосельского вулиця	вулиця Новосельского
Ногінского вулиця	вулиця Ногінского
Норинского квартал	квартал Норинского
Одинадцятого Липня в’їзд	вʼїзд 11 Липня
Одинадцятого Липня вулиця	вулиця 11 Липня
Олеськового вулиця	вулиця Олеськового
Ольхового вулиця	вулиця Ольхового
Онезького провулок	провулок Онезького
Островского вулиця	вулиця Островського
П'ясецького вулиця	вулиця Пʼясецького
П’ятницького вулиця	вулиця Пʼятницького
П’ятого Липня вулиця	вулиця 5 Липня
Паньковецького вулиця	вулиця Паньковецького
Партизана Луб’яного вулиця	вулиця Партизана Лубʼяного
Пашницького вулиця	вулиця Пашницького
Пекельного вулиця	вулиця Пекельного
Перевозного вулиця	вулиця Перевозного
Перуцького вулиця	вулиця Перуцького
Першого Грудня вулиця	вулиця 1 Грудня
Першого Травня в’їзд	вʼїзд 1 Травня
Першого Травня вулиця	вулиця 1 Травня
Першого Травня площа	площа 1 Травня
Першого Травня провулок	провулок 1 Травня
Підгаєцького вулиця	вулиця Підгаєцького
Підколодного вулиця	вулиця Підколодного
Підлисецького вулиця	вулиця Підлисецького
Пісецького вулиця	вулиця Пісецького
Піщаного вулиця	вулиця Піщаного
Плотного вулиця	вулиця Плотного
Погорецького вулиця	вулиця Погорецького
Пожарского вулиця	вулиця Пожарского
Поповицького вулиця	вулиця Поповицького
Попового Яру вулиця	вулиця Попового Яру
Портицького вулиця	вулиця Портицького
Посмітного вулиця	вулиця Посмітного
Постного вулиця	вулиця Постного
Потужнього вулиця	вулиця Потужнього
Приблудного вулиця	вулиця Приблудного
Пригорницького вулиця	вулиця Пригорницького
Придворного вулиця	вулиця Придворного
Просужого вулиця	вулиця Просужого
Протятого Каміння вулиця	вулиця Протятого Каміння
Професора І. Храпливого вулиця	вулиця Професора І. Храпливого
Професора Коровицького вулиця	вулиця Професора Коровицького
Професора Коровицького провулок	провулок Професора Коровицького
Ремінного вулиця	вулиця Ремінного
Робочого вулиця	вулиця Робочого
Розкидного вулиця	вулиця Розкидного
Рокицького вулиця	вулиця Рокицького
Рослого вулиця	вулиця Рослого
Садовского вулиця	вулиця Садовского
Сацького вулиця	вулиця Сацького
Свислоцького вулиця	вулиця Свислоцького
Свідницького вулиця	вулиця Свідницького
Світлого Путі вулиця	вулиця Світлого Путі
Святого Капістрана вулиця	вулиця Святого Капістрана
Святого Юра вулиця	вулиця Святого Юра
Святого Юра площа	площа Святого Юра
Сєдого провулок	провулок Сєдого
Сімнадцятого партз’їзду вулиця	вулиця XVII Партзʼїзду
Сімнадцятого Партз’їзду провулок	провулок XVII Партзʼїзду
Січневого повстання вулиця	вулиця Січневого Повстання
Січневого Повстання вулиця	вулиця Січневого Повстання
Січневого Прориву вулиця	вулиця Січневого Прориву
Скопецького вулиця	вулиця Скопецького
Скорого вулиця	вулиця Скорого
Скуцького вулиця	вулиця Скуцького
Слизькоухого вулиця	вулиця Слизькоухого
Смирного вулиця	вулиця Смирного
Сненького вулиця	вулиця Сненького
Соколового Каміння вулиця	вулиця Соколового Каміння
Солом'яного провулок	провулок Соломʼяного
Сорокового вулиця	вулиця Сорокового
Соціалістичного Донбасу вулиця	вулиця Соціалістичного Донбасу
Спицького вулиця	вулиця Спицького
Справедливого вулиця	вулиця Справедливого
Старого Детюка вулиця	вулиця Старого Детюка
Старого Дніпра вулиця	вулиця Старого Дніпра
Старого Редуту вулиця	вулиця Старого Редуту
Старшого лейтенанта Кагала вулиця	вулиця Старшого лейтенанта Кагала
Старшого сержанта Кульбашного провулок	провулок Старшого сержанта Кульбашного
Стебницького вулиця	вулиця Стебницького
Стебніцького вулиця	вулиця Стебніцького
Стобецького вулиця	вулиця Стобецького
Ступницького вулиця	вулиця Ступницького
Суворого вулиця	вулиця Суворого
Суворого провулок	провулок Суворого
Сухацького вулиця	вулиця Сухацького
Тіводора Легоцького вулиця	вулиця Тіводора Легоцького
Толстрого вулиця	вулиця Толстрого
Тостого вулиця	вулиця Толстого
Трембицького вулиця	вулиця Трембицького
Уграіцкого вулиця	вулиця Уграіцкого
Уграіцкого провулок	провулок Уграіцкого
Указного вулиця	вулиця Указного
Урицкого вулиця	вулиця Урицкого
Уріцького провулок	провулок Уріцького
Хижного вулиця	вулиця Хижного
Хороброго вулиця	вулиця Хороброго
Хотовицького вулиця	вулиця Хотовицького
Храпливого вулиця	вулиця Храпливого
Цегельного Заводу вулиця	вулиця Цегельного Заводу
Червого партизана вулиця	вулиця Червого Партизана
Чернишевского вулиця	вулиця Чернишевского
Четвертного вулиця	вулиця Четвертного
Четвертного провулок	провулок Четвертного
Четвертого Універсалу провулок	провулок Четвертого Універсалу
Чорнобривого вулиця	вулиця Чорнобривого
Чорнобрового вулиця	вулиця Чорнобрового
Чубинского вулиця	вулиця Чубинского
Чумовицкого вулиця	вулиця Чумовицкого
Чумовицького вулиця	вулиця Чумовицького
Шатного вулиця	вулиця Шатного
Шелкового вулиця	вулиця Шелкового
Шептицікого вулиця	вулиця Шептицікого
Шостацького вулиця	вулиця Шостацького
Шостацького провулок	провулок Шостацького
Щирого вулиця	вулиця Щирого
Юного Ленінця вулиця	вулиця Юного Ленінця
Яковицького вулиця	вулиця Яковицького
Ярицького вулиця	вулиця Ярицького
Яруцького вулиця	вулиця Яруцького
XIX Партійного З'їзду вулиця	вулиця XIX Партійного Зʼїзду
XXI Партійного З'їзду вулиця	вулиця XXI Партійного Зʼїзду